,Player_Name,2P,2P%,2PA,3P,3P%,3PA,AST,Age,BLK,DRB,FG,FG%,FGA,FT,FT%,FTA,Games,Games_Strated,Minutes_Played,ORB,PF,PTS,Position,STL,TOV,TRB,Team,eFG%
0,Shareef Abdur-Rahim,492,.482,1020,9,.265,34,174,27,37,450,501,.475,1054,373,.869,429,85,56,2684,189,222,1384,PF,68,184,639,TOT,.480
1,Malik Allen,83,.419,198,0,,0,16,25,28,77,83,.419,198,25,.758,33,45,6,616,42,81,191,PF,12,27,119,MIA,.419
2,Ray Allen,299,.468,639,148,.392,378,268,28,11,217,447,.440,1017,245,.904,271,56,56,2152,69,132,1287,SG,71,156,286,SEA,.512
3,Rafer Alston,126,.382,330,161,.371,434,372,27,18,200,287,.376,764,103,.769,134,82,28,2581,26,212,838,PG,114,128,226,MIA,.481
4,Chris Andersen,90,.446,202,0,.000,1,35,25,114,209,90,.443,203,63,.589,107,71,0,1029,89,119,243,PF,34,48,298,DEN,.443
5,Derek Anderson,151,.428,353,79,.305,259,228,29,3,156,230,.376,612,155,.824,188,51,46,1810,26,79,694,SG,66,90,182,POR,.440
6,Kenny Anderson,112,.444,252,1,.250,4,125,33,5,62,113,.441,256,35,.729,48,44,31,905,19,73,262,PG,26,50,81,IND,.443
7,Shandon Anderson,202,.463,436,36,.281,128,122,30,17,169,238,.422,564,123,.764,161,80,37,1974,53,182,635,SG,68,118,222,NYK,.454
8,Carmelo Anthony,555,.444,1251,69,.322,214,227,19,41,315,624,.426,1465,408,.777,525,82,82,2995,183,225,1725,SF,97,247,498,DEN,.449
9,Robert Archibald,9,.273,33,0,,0,13,23,3,31,9,.273,33,14,.452,31,32,3,256,21,50,32,C-PF,14,10,52,TOT,.273
10,Gilbert Arenas,233,.401,581,125,.375,333,275,22,12,199,358,.392,914,237,.748,317,55,52,2066,55,176,1078,PG,103,226,254,WAS,.460
11,Brandon Armstrong,46,.374,123,19,.365,52,14,23,2,31,65,.371,175,2,.500,4,56,0,434,12,49,151,SG,12,24,43,NJN,.426
12,Darrell Armstrong,156,.508,307,135,.315,429,311,35,16,163,291,.395,736,123,.854,144,79,22,2247,63,148,840,PG,133,155,226,NOH,.487
13,Carlos Arroyo,301,.462,651,38,.325,117,355,24,5,144,339,.441,768,181,.804,225,71,71,2008,41,165,897,PG,63,156,185,UTA,.466
14,Chucky Atkins,111,.457,243,81,.336,241,223,29,2,84,192,.397,484,73,.753,97,64,24,1544,9,102,538,PG,45,92,93,TOT,.480
15,Stacey Augmon,142,.418,340,1,.143,7,85,35,15,122,143,.412,347,110,.791,139,69,24,1416,52,114,397,SF,55,76,174,NOH,.414
16,Vin Baker,207,.483,429,1,.333,3,66,32,32,168,208,.481,432,114,.726,157,54,33,1313,112,160,531,PF,29,77,280,TOT,.483
17,Marcus Banks,150,.421,356,27,.314,86,175,22,13,103,177,.400,442,99,.756,131,81,2,1385,30,171,480,PG,88,125,133,BOS,.431
18,Leandro Barbosa,127,.488,260,83,.395,210,165,21,7,100,210,.447,470,47,.770,61,70,46,1500,23,184,550,PG,93,120,123,PHO,.535
19,Matt Barnes,61,.488,125,2,.154,13,48,23,3,98,63,.457,138,43,.705,61,38,9,724,53,76,171,SF,27,44,151,LAC,.464
20,Dana Barros,2,.667,3,0,,0,0,36,0,0,2,.667,3,2,1.000,2,1,0,11,0,2,6,SG,0,0,0,BOS,.667
21,Brent Barry,101,.577,175,114,.452,252,342,32,16,183,215,.504,427,91,.827,110,59,53,1803,21,121,635,SG,85,139,204,SEA,.637
22,Jon Barry,69,.434,159,51,.370,138,147,34,8,98,120,.404,297,60,.845,71,57,9,1101,25,66,351,SG,57,53,123,DEN,.490
23,Mengke Bateer,4,.571,7,0,,0,1,28,0,3,4,.571,7,0,,0,7,0,40,5,10,8,C,1,2,8,TOR,.571
24,Tony Battie,168,.448,375,2,.222,9,58,27,67,241,170,.443,384,66,.742,89,73,7,1478,118,159,408,C,26,63,359,TOT,.445
25,Shane Battier,177,.496,357,65,.349,186,101,25,58,201,242,.446,543,120,.732,164,79,1,1947,102,187,669,SF,101,56,303,MEM,.506
26,Lonny Baxter,102,.495,206,1,.333,3,20,25,29,123,103,.493,209,44,.579,76,62,5,766,64,123,251,C-PF,17,38,187,TOT,.495
27,Jerome Beasley,1,.333,3,0,,0,0,23,0,1,1,.333,3,0,,0,2,0,5,0,0,2,PF,0,0,1,MIA,.333
28,Raja Bell,267,.418,639,62,.373,166,107,27,13,181,329,.409,805,195,.786,248,82,4,2020,60,262,915,SG,63,111,241,UTA,.447
29,Troy Bell,4,.286,14,0,.000,4,4,23,0,1,4,.222,18,3,1.000,3,6,0,34,3,6,11,PG,1,6,4,MEM,.222
30,Jonathan Bender,41,.488,84,9,.409,22,9,23,11,31,50,.472,106,39,.830,47,21,0,271,9,23,148,SF,5,33,40,IND,.514
31,Travis Best,61,.401,152,3,.150,20,112,31,4,51,64,.372,172,40,.870,46,61,1,762,17,66,171,PG,31,33,68,DAL,.381
32,Mike Bibby,379,.479,792,148,.392,378,444,25,18,210,527,.450,1170,304,.815,373,82,82,2980,67,146,1506,PG,112,175,277,SAC,.514
33,Chauncey Billups,262,.396,661,130,.388,335,446,27,8,241,392,.394,996,404,.878,460,78,78,2758,35,177,1318,PG,84,189,276,DET,.459
34,Steve Blake,82,.400,205,75,.371,202,209,23,7,99,157,.386,407,55,.821,67,75,14,1392,18,100,444,PG,57,128,117,WAS,.478
35,Corie Blount,115,.460,250,0,.000,3,55,35,24,177,115,.455,253,15,.556,27,62,3,1050,98,135,245,PF-C,49,43,275,TOT,.455
36,Mark Blount,342,.566,604,0,,0,75,28,106,382,342,.566,604,159,.719,221,82,73,2402,207,253,843,C,80,150,589,BOS,.566
37,Keith Bogans,116,.434,267,67,.358,187,98,23,10,211,183,.403,454,65,.631,103,73,36,1787,106,128,498,SF,46,75,317,ORL,.477
38,Calvin Booth,135,.469,288,0,.000,2,28,27,101,194,135,.466,290,75,.798,94,71,35,1206,86,150,345,C,17,45,280,SEA,.466
39,Carlos Boozer,470,.526,894,1,.167,6,148,22,55,627,471,.523,900,219,.768,285,75,75,2592,230,199,1162,PF,74,134,857,CLE,.524
40,Curtis Borchardt,22,.400,55,0,.000,1,15,23,14,41,22,.393,56,14,.778,18,16,0,258,13,40,58,C,4,18,54,UTA,.393
41,Chris Bosh,322,.461,698,5,.357,14,78,19,106,366,327,.459,712,202,.701,288,75,63,2510,191,215,861,C,59,107,557,TOR,.463
42,Ruben Boumtje-Boumtje,1,.200,5,0,,0,1,25,1,1,1,.200,5,2,1.000,2,9,0,26,0,2,4,C,0,0,1,POR,.200
43,Bruce Bowen,134,.462,290,77,.363,212,113,32,33,208,211,.420,502,66,.579,114,82,82,2624,45,166,565,SF,84,90,253,SAS,.497
44,Ryan Bowen,18,.340,53,0,,0,18,28,16,48,18,.340,53,10,.833,12,52,1,392,39,47,46,PF,18,6,87,DEN,.340
45,Earl Boykins,266,.447,595,55,.322,171,295,27,3,101,321,.419,766,142,.877,162,82,3,1849,42,84,839,SG,51,100,143,DEN,.455
46,Michael Bradley,7,.467,15,0,,0,1,24,0,17,7,.467,15,1,.500,2,16,1,98,6,14,15,C-PF,3,7,23,TOT,.467
47,Shawn Bradley,89,.476,187,0,.000,1,20,31,74,101,89,.473,188,41,.837,49,66,5,773,72,130,219,C,33,17,173,DAL,.473
48,Torraye Braggs,16,.485,33,0,,0,7,27,2,21,16,.485,33,8,.667,12,15,0,154,18,29,40,PF,4,13,39,TOT,.485
49,Elton Brand,484,.493,981,0,.000,1,227,24,154,445,484,.493,982,411,.773,532,69,68,2670,269,229,1379,PF,64,193,714,LAC,.493
50,J.R. Bremer,24,.286,84,19,.257,74,51,23,4,27,43,.272,158,13,.650,20,36,2,443,9,32,118,PG,18,24,36,TOT,.332
51,Jamison Brewer,8,.381,21,5,.357,14,17,23,0,9,13,.371,35,1,.167,6,13,1,160,2,9,32,PG,7,10,11,IND,.443
52,Primoz Brezec,12,.462,26,0,,0,3,24,3,10,12,.462,26,4,.667,6,18,0,72,5,13,28,C,0,6,15,IND,.462
53,Damone Brown,1,.100,10,0,,0,0,24,0,2,1,.100,10,1,.500,2,3,0,17,3,2,3,PF,2,1,5,NJN,.100
54,Devin Brown,81,.445,182,4,.286,14,33,25,4,92,85,.434,196,60,.811,74,58,0,627,38,61,234,SG,15,38,130,SAS,.444
55,Kedrick Brown,79,.510,155,38,.384,99,64,22,7,105,117,.461,254,17,.630,27,55,26,969,41,80,289,SF,30,29,146,TOT,.535
56,Kwame Brown,287,.489,587,1,.500,2,112,21,52,372,288,.489,589,228,.683,334,74,57,2239,178,144,805,PF,66,140,550,WAS,.490
57,P.J. Brown,339,.477,711,0,.000,1,155,34,73,453,339,.476,712,158,.854,185,80,80,2753,237,203,836,PF,78,101,690,NOH,.476
58,Tierre Brown,2,.500,4,0,,0,2,24,0,1,2,.500,4,2,.500,4,3,0,17,0,1,6,PG,0,7,1,NOH,.500
59,Rick Brunson,29,.354,82,11,.478,23,82,31,3,28,40,.381,105,27,.871,31,40,0,412,9,44,118,PG,25,33,37,TOT,.433
60,Kobe Bryant,445,.463,961,71,.327,217,330,25,28,256,516,.438,1178,454,.852,533,65,64,2447,103,176,1557,SG,112,171,359,LAL,.468
61,Greg Buckner,54,.412,131,12,.273,44,45,27,4,75,66,.377,175,20,.741,27,53,3,703,28,77,164,SG,21,34,103,PHI,.411
62,Rodney Buford,19,.352,54,0,.000,2,7,26,1,9,19,.339,56,3,.500,6,22,0,141,6,9,41,SF,6,4,15,SAC,.339
63,Caron Butler,230,.390,589,10,.238,42,126,23,13,234,240,.380,631,133,.756,176,68,56,2030,92,162,623,SF,75,91,326,MIA,.388
64,Mitchell Butler,43,.457,94,11,.367,30,32,33,4,47,54,.435,124,15,.625,24,41,4,552,24,54,134,SG,22,24,71,WAS,.480
65,Rasual Butler,69,.486,142,50,.463,108,23,24,13,57,119,.476,250,16,.762,21,45,0,675,4,72,304,SF,10,28,61,MIA,.576
66,Zarko Cabarkapa,75,.455,165,6,.188,32,40,22,13,73,81,.411,197,35,.660,53,49,4,570,26,75,203,PF,10,54,99,PHO,.426
67,Marcus Camby,262,.479,547,0,.000,2,132,29,187,516,262,.477,549,98,.721,136,72,72,2162,211,239,622,C,86,98,727,DEN,.477
68,Elden Campbell,138,.439,314,0,,0,45,35,50,157,138,.439,314,85,.685,124,65,27,892,52,137,361,C,21,63,209,DET,.439
69,Brian Cardinal,165,.482,342,55,.444,124,103,26,20,217,220,.472,466,238,.878,271,76,11,1634,100,206,733,PF,66,84,317,GSW,.531
70,Matt Carroll,6,.462,13,1,.333,3,2,23,0,5,7,.438,16,4,.667,6,16,0,70,1,8,19,SG,1,6,6,TOT,.469
71,Anthony Carter,11,.324,34,0,.000,3,12,28,0,9,11,.297,37,0,,0,5,2,87,2,9,22,PG,4,12,11,SAS,.297
72,Maurice Carter,7,.292,24,4,.364,11,4,27,0,9,11,.314,35,16,.800,20,10,0,110,2,10,42,SG,0,9,11,TOT,.371
73,Vince Carter,515,.424,1214,93,.383,243,348,27,65,254,608,.417,1457,336,.806,417,73,73,2785,95,212,1645,SG,88,223,349,TOR,.449
74,Sam Cassell,546,.504,1084,74,.398,186,592,34,18,227,620,.488,1270,289,.873,331,81,81,2838,44,247,1603,PG,102,220,271,MIN,.517
75,Kelvin Cato,161,.447,360,0,,0,72,29,96,319,161,.447,360,96,.676,142,69,67,1743,153,203,418,PF,52,84,472,HOU,.447
76,Tyson Chandler,67,.427,157,0,.000,1,23,21,43,188,67,.424,158,79,.669,118,35,8,782,82,87,213,PF,17,38,270,CHI,.424
77,Calbert Cheaney,278,.489,568,0,.000,10,136,32,12,183,278,.481,578,47,.610,77,79,7,2067,77,184,603,SF,60,85,260,GSW,.481
78,Doug Christie,268,.491,546,49,.345,142,347,33,41,260,317,.461,688,148,.860,172,82,82,2780,69,186,831,SG,151,155,329,SAC,.496
79,Keon Clark,2,.333,6,0,,0,1,28,0,6,2,.333,6,0,,0,2,0,27,1,1,4,PF,1,0,7,UTA,.333
80,Speedy Claxton,220,.438,502,4,.182,22,267,25,9,118,224,.427,524,182,.813,224,60,29,1595,38,146,634,PG,97,102,156,GSW,.431
81,Mateen Cleaves,7,.318,22,0,.000,1,19,26,2,6,7,.304,23,1,.500,2,4,2,92,1,13,15,PG,4,5,7,CLE,.304
82,Derrick Coleman,99,.444,223,8,.222,36,46,36,26,147,107,.413,259,49,.754,65,34,30,843,45,79,271,C,23,57,192,PHI,.429
83,Bimbo Coles,12,.353,34,0,,0,15,35,0,8,12,.353,34,4,.667,6,22,1,170,2,27,28,PG,3,9,10,MIA,.353
84,Jason Collier,78,.484,161,1,.250,4,17,26,11,75,79,.479,165,67,.788,85,20,16,545,36,71,226,C,11,31,111,ATL,.482
85,Jarron Collins,147,.500,294,0,.000,1,77,25,18,199,147,.498,295,188,.718,262,81,31,1732,117,255,482,C,26,79,316,UTA,.498
86,Jason Collins,163,.427,382,0,.000,2,153,25,56,257,163,.424,384,136,.739,184,78,78,2220,143,251,462,C,67,97,400,NJN,.424
87,Brian Cook,67,.493,136,0,.000,5,20,23,16,70,67,.475,141,21,.750,28,35,2,442,31,64,155,C,16,17,101,LAL,.475
88,Omar Cook,7,.269,26,0,.000,1,24,22,0,3,7,.259,27,0,,0,17,0,139,3,14,14,PG,10,10,6,POR,.259
89,Chris Crawford,167,.466,358,44,.389,113,45,28,20,117,211,.448,471,103,.866,119,56,25,1207,58,131,569,PF,37,55,175,ATL,.495
90,Jamal Crawford,344,.432,797,165,.317,521,405,23,29,237,509,.386,1318,200,.833,240,80,73,2811,46,161,1383,SG,111,193,283,CHI,.449
91,Austin Croshere,63,.387,163,56,.389,144,52,28,14,183,119,.388,307,93,.894,104,77,0,1051,60,101,387,PF,24,55,243,IND,.479
92,Eddy Curry,416,.496,839,1,1.000,1,68,21,83,308,417,.496,840,235,.671,350,73,63,2154,143,258,1070,PF,24,177,451,CHI,.497
93,Michael Curry,73,.403,181,3,.200,15,53,35,5,65,76,.388,196,49,.845,58,70,15,1229,22,153,204,SF,23,48,87,TOR,.395
94,Samuel Dalembert,270,.542,498,0,.000,1,21,22,189,432,270,.541,499,112,.644,174,82,53,2197,194,273,652,C,44,86,626,PHI,.541
95,Erick Dampier,348,.537,648,0,.000,2,60,28,137,543,348,.535,650,217,.654,332,74,74,2403,344,227,913,C,33,131,887,GSW,.535
96,Antonio Daniels,145,.514,282,42,.362,116,298,28,6,119,187,.470,398,155,.842,184,71,32,1512,23,64,571,PG,45,61,142,SEA,.523
97,Marquis Daniels,192,.512,375,11,.306,36,116,23,12,80,203,.494,411,60,.769,78,56,15,1039,66,51,477,SG,53,44,146,DAL,.507
98,Antonio Davis,266,.403,660,0,,0,137,35,65,464,266,.403,660,176,.765,230,80,79,2570,207,206,708,C,37,114,671,TOT,.403
99,Baron Davis,367,.448,820,187,.321,582,501,24,27,221,554,.395,1402,237,.673,352,67,66,2686,66,178,1532,PG,158,215,287,NOH,.462
100,Dale Davis,133,.473,281,0,,0,72,34,62,240,133,.473,281,65,.613,106,76,37,1682,158,154,331,C,43,40,398,POR,.473
101,Hubert Davis,1,.100,10,0,.000,1,4,33,0,6,1,.091,11,2,1.000,2,17,0,78,2,12,4,SG,2,3,8,TOT,.091
102,Josh Davis,2,.667,3,0,.000,2,0,23,0,4,2,.400,5,1,1.000,1,4,1,23,1,3,5,PF,0,2,5,ATL,.400
103,Ricky Davis,394,.486,810,52,.371,140,259,24,22,281,446,.469,950,196,.718,273,79,27,2474,77,171,1140,SF-SG,96,189,358,TOT,.497
104,Andrew DeClercq,93,.477,195,0,,0,44,30,32,186,93,.477,195,44,.815,54,71,53,1211,131,217,230,C,47,54,317,ORL,.477
105,Tony Delk,50,.424,118,20,.303,66,28,30,7,43,70,.380,184,37,.841,44,33,11,509,16,46,197,SG,27,17,59,DAL,.435
106,Derrick Dial,7,.368,19,2,.222,9,2,28,0,8,9,.321,28,6,.750,8,9,0,86,5,6,26,SG,6,1,13,ORL,.357
107,Boris Diaw,134,.467,287,6,.231,26,182,21,37,231,140,.447,313,56,.602,93,76,37,1919,111,191,342,SG,59,126,342,ATL,.457
108,Dan Dickau,27,.397,68,10,.333,30,38,25,0,19,37,.378,98,11,.786,14,43,0,294,7,44,95,PG,17,26,26,TOT,.429
109,Kaniel Dickens,3,1.000,3,0,,0,0,25,0,0,3,1.000,3,1,.500,2,3,0,12,2,3,7,PF,0,1,2,POR,1.000
110,DeSagana Diop,57,.388,147,0,,0,34,22,51,127,57,.388,147,12,.600,20,56,3,730,72,116,126,C,26,29,199,CLE,.388
111,Vlade Divac,312,.476,655,2,.154,13,432,35,77,327,314,.470,668,170,.654,260,81,81,2317,136,222,800,C,57,173,463,SAC,.472
112,Juan Dixon,188,.428,439,59,.298,198,137,25,4,118,247,.388,637,111,.799,139,71,16,1478,30,111,664,SG,82,104,148,WAS,.434
113,Michael Doleac,140,.435,322,0,,0,44,26,36,177,140,.435,322,45,.865,52,72,0,1029,88,142,325,C,23,48,265,TOT,.435
114,Keyon Dooling,129,.422,306,8,.174,46,130,23,6,62,137,.389,352,78,.830,94,58,24,1137,17,108,360,PG,45,65,79,LAC,.401
115,Bryce Drew,3,.273,11,1,.143,7,13,29,0,6,4,.222,18,3,1.000,3,15,0,78,0,1,12,PG,4,8,6,NOH,.250
116,Predrag Drobnjak,138,.402,343,11,.306,36,39,28,24,142,149,.393,379,73,.849,86,61,14,949,54,85,382,C,22,48,196,LAC,.408
117,Tim Duncan,590,.505,1169,2,.167,12,213,27,185,632,592,.501,1181,352,.599,588,69,68,2527,227,164,1538,PF,62,183,859,SAS,.502
118,Mike Dunleavy,229,.491,466,94,.370,254,220,23,13,355,323,.449,720,137,.741,185,75,69,2336,87,169,877,SF,68,143,442,GSW,.514
119,Ronald Dupree,107,.392,273,4,.444,9,55,23,18,112,111,.394,282,66,.629,105,47,8,893,55,134,292,SF,32,51,167,CHI,.401
120,Ndudi Ebi,6,.429,14,0,,0,3,19,4,1,6,.429,14,1,.250,4,17,0,32,2,6,13,SF,0,3,3,MIN,.429
121,Howard Eisley,114,.396,288,52,.319,163,273,31,5,109,166,.368,451,76,.854,89,67,23,1457,20,137,460,PG,56,98,129,TOT,.426
122,Francisco Elson,94,.475,198,0,.000,1,32,27,39,138,94,.472,199,30,.667,45,62,14,875,65,145,218,C,35,35,203,DEN,.472
123,Melvin Ely,66,.434,152,0,.000,1,22,25,17,53,66,.431,153,25,.595,42,42,2,510,48,68,157,PF,9,20,101,LAC,.431
124,Reggie Evans,67,.414,162,0,.000,3,33,23,10,252,67,.406,165,83,.561,148,75,27,1280,156,176,217,PF,54,65,408,SEA,.406
125,Desmond Ferguson,2,.500,4,3,.375,8,1,26,0,4,5,.417,12,0,.000,2,7,0,32,0,0,13,SF,0,1,4,POR,.542
126,Michael Finley,364,.461,789,150,.405,370,212,30,39,247,514,.443,1159,164,.850,193,72,72,2778,78,118,1342,SG,84,83,325,DAL,.508
127,Derek Fisher,151,.380,397,52,.291,179,187,29,4,122,203,.352,576,122,.797,153,82,3,1769,30,115,580,SG,103,79,152,LAL,.398
128,Marcus Fizer,132,.396,333,2,.118,17,43,25,8,141,134,.383,350,90,.750,120,46,2,738,61,97,360,SF,16,51,202,CHI,.386
129,Alton Ford,6,.545,11,0,,0,3,22,1,8,6,.545,11,3,.500,6,9,0,41,3,9,15,PF,0,3,11,HOU,.545
130,T.J. Ford,148,.393,377,5,.238,21,356,20,3,140,153,.384,398,80,.816,98,55,55,1472,37,123,391,PG,60,139,177,MIL,.391
131,Danny Fortson,71,.511,139,0,,0,9,27,11,136,71,.511,139,75,.815,92,56,20,625,114,148,217,C,12,37,250,DAL,.511
132,Jeff Foster,197,.550,358,0,.000,4,64,27,27,362,197,.544,362,103,.669,154,82,79,1961,248,189,497,C,71,60,610,IND,.544
133,Tremaine Fowlkes,14,.350,40,1,.125,8,14,27,3,35,15,.313,48,13,.722,18,36,0,261,18,37,44,SF,9,12,53,DET,.323
134,Rick Fox,58,.464,125,15,.246,61,98,34,4,73,73,.392,186,22,.733,30,38,34,846,29,99,183,SF,29,48,102,LAL,.433
135,Adonal Foyle,59,.454,130,0,,0,17,28,46,113,59,.454,130,19,.543,35,44,8,572,54,68,137,C,6,21,167,GSW,.454
136,Richie Frahm,29,.617,47,34,.370,92,24,26,4,44,63,.453,139,23,.885,26,54,0,469,12,50,183,SF,16,7,56,SEA,.576
137,Steve Francis,377,.435,867,73,.292,250,493,26,35,317,450,.403,1117,337,.775,435,79,79,3194,116,257,1310,PG,139,294,433,HOU,.436
138,Hiram Fuller,3,.375,8,0,,0,2,22,1,7,3,.375,8,2,.333,6,4,0,43,4,5,8,PF,0,4,11,ATL,.375
139,Dan Gadzuric,183,.526,348,0,.000,1,28,25,105,220,183,.524,349,58,.492,118,75,0,1260,126,186,424,C,51,45,346,MIL,.524
140,Reece Gaines,22,.289,76,3,.300,10,40,23,2,31,25,.291,86,16,.640,25,38,1,364,8,22,69,PG,11,18,39,ORL,.308
141,Alex Garcia,1,.143,7,0,,0,0,23,0,0,1,.143,7,1,.500,2,2,0,13,0,0,3,SG,2,1,0,SAS,.143
142,Kevin Garnett,793,.506,1568,11,.256,43,409,27,178,894,804,.499,1611,368,.791,465,82,82,3231,245,202,1987,PF,120,212,1139,MIN,.502
143,Pat Garrity,1,.333,3,0,,0,1,27,0,0,1,.333,3,0,,0,2,0,22,0,2,2,PF,0,0,0,ORL,.333
144,Pau Gasol,502,.485,1034,4,.267,15,198,23,132,394,506,.482,1049,365,.714,511,78,78,2458,206,185,1381,PF,44,187,600,MEM,.484
145,Devean George,168,.436,385,65,.349,186,112,26,38,245,233,.408,571,73,.760,96,82,48,1951,87,189,604,SF,81,88,332,LAL,.465
146,Eddie Gill,12,.429,28,3,.375,8,16,25,1,13,15,.417,36,17,.850,20,22,0,157,4,16,50,PG,9,12,17,POR,.458
147,Kendall Gill,206,.404,510,9,.237,38,89,35,16,129,215,.392,548,100,.735,136,56,35,1411,61,107,539,SG,65,83,190,CHI,.401
148,Manu Ginobili,242,.445,544,88,.359,245,291,26,16,258,330,.418,789,239,.802,298,77,38,2260,86,181,987,SG,136,161,344,SAS,.474
149,Gordan Giricek,256,.448,572,60,.395,152,122,26,15,175,316,.436,724,135,.854,158,73,43,2041,51,144,827,SF-SG,56,103,226,TOT,.478
150,Dion Glover,190,.404,470,40,.336,119,130,25,19,208,230,.390,589,120,.769,156,69,30,1643,58,123,620,SG,50,102,266,TOT,.424
151,Anthony Goldwire,5,.357,14,2,.250,8,11,32,0,6,7,.318,22,1,1.000,1,11,0,85,1,5,17,PG,5,3,7,TOT,.364
152,Drew Gooden,360,.457,787,9,.214,42,89,22,72,356,369,.445,829,167,.637,262,79,17,2134,160,196,914,PF,62,126,516,ORL,.451
153,Brian Grant,289,.472,612,0,.000,1,69,31,35,350,289,.471,613,86,.782,110,76,76,2303,174,254,664,C,51,82,524,MIA,.471
154,Horace Grant,92,.413,223,0,.000,1,71,38,21,154,92,.411,224,39,.722,54,55,10,1106,79,70,223,PF,24,29,233,LAL,.411
155,Paul Grant,11,.478,23,0,,0,3,30,1,10,11,.478,23,3,.375,8,10,0,98,7,17,25,C,1,7,17,UTA,.478
156,Willie Green,124,.419,296,19,.311,61,53,22,5,49,143,.401,357,59,.728,81,53,0,767,16,83,364,SG,26,59,65,PHI,.427
157,Adrian Griffin,4,.250,16,1,.500,2,10,29,2,18,5,.278,18,0,.000,4,19,1,133,1,17,11,SG,7,3,19,HOU,.306
158,Tom Gugliotta,69,.347,199,1,.250,4,63,34,12,122,70,.345,203,20,.714,28,55,27,819,65,81,161,PF,31,39,187,TOT,.347
159,Marcus Haislip,35,.486,72,1,.500,2,4,23,12,32,36,.486,74,20,.714,28,31,0,263,21,25,93,PF,6,9,53,MIL,.493
160,Darvin Ham,36,.493,73,1,.500,2,16,30,8,46,37,.493,75,21,.600,35,54,2,484,47,63,96,SF,13,31,93,DET,.500
161,Richard Hamilton,512,.466,1098,18,.265,68,310,25,17,201,530,.455,1166,297,.868,342,78,78,2772,78,222,1375,SG,103,210,279,DET,.462
162,Zendon Hamilton,51,.537,95,0,,0,13,28,8,97,51,.537,95,67,.698,96,46,0,473,49,74,169,C,8,27,146,PHI,.537
163,Ben Handlogten,25,.532,47,0,,0,6,30,4,33,25,.532,47,18,.667,27,17,0,172,22,32,68,C,3,10,55,UTA,.532
164,Travis Hansen,37,.370,100,9,.300,30,19,25,9,40,46,.354,130,22,.815,27,41,4,507,30,67,123,SF,10,15,70,ATL,.388
165,Anfernee Hardaway,249,.415,600,30,.380,79,176,32,20,218,279,.411,679,111,.804,138,76,14,2095,69,146,699,SG,70,107,287,TOT,.433
166,Matt Harpring,185,.491,377,8,.242,33,63,27,2,156,193,.471,410,108,.688,157,31,31,1134,91,102,502,SF,22,65,247,UTA,.480
167,Al Harrington,400,.481,832,21,.273,77,131,23,22,345,421,.463,909,185,.734,252,79,15,2441,163,250,1048,PF,80,163,508,IND,.475
168,Othella Harrington,100,.495,202,0,,0,29,30,14,119,100,.495,202,58,.744,78,56,3,872,58,134,258,PF,12,65,177,NYK,.495
169,Lucious Harris,149,.412,362,38,.376,101,135,33,2,101,187,.404,463,66,.846,78,69,15,1504,39,74,478,PG,41,53,140,NJN,.445
170,Jason Hart,69,.460,150,2,.222,9,81,25,5,69,71,.447,159,33,.767,43,53,5,660,10,59,177,PG,28,29,79,SAS,.453
171,Donnell Harvey,89,.449,198,0,.000,3,21,23,27,116,89,.443,201,61,.735,83,60,8,783,48,129,239,PF,24,45,164,TOT,.443
172,Udonis Haslem,205,.462,444,0,.000,3,51,23,24,284,205,.459,447,140,.765,183,75,24,1795,189,197,550,PF,33,74,473,MIA,.459
173,Trenton Hassell,173,.470,368,4,.308,13,133,24,54,189,177,.465,381,48,.787,61,81,74,2264,68,200,406,SG,36,46,257,MIN,.470
174,Jarvis Hayes,238,.422,564,40,.305,131,106,22,11,193,278,.400,695,77,.786,98,70,42,2044,71,157,673,SF,71,110,264,WAS,.429
175,Brendan Haywood,200,.517,387,0,.000,1,43,24,100,201,200,.515,388,137,.585,234,77,59,1484,186,154,537,C,32,80,387,WAS,.515
176,Shane Heal,3,.500,6,4,.222,18,5,33,0,3,7,.292,24,4,.800,5,6,0,72,1,2,22,PG,1,5,4,SAS,.375
177,Alan Henderson,10,.476,21,0,,0,2,31,2,10,10,.476,21,4,.667,6,6,0,68,11,1,24,PF,1,3,21,ATL,.476
178,Nene Hilario,334,.532,628,0,.000,2,168,21,41,349,334,.530,630,240,.682,352,77,77,2504,154,280,908,PF,116,183,503,DEN,.530
179,Tyrone Hill,3,.600,5,0,,0,0,35,1,3,3,.600,5,3,.750,4,5,0,38,5,10,9,PF,0,2,8,MIA,.600
180,Kirk Hinrich,174,.383,454,144,.390,369,517,23,21,217,318,.386,823,135,.804,168,76,66,2706,42,276,915,PG,101,204,259,CHI,.474
181,Fred Hoiberg,102,.483,211,76,.442,172,109,31,10,247,178,.465,383,98,.845,116,79,3,1804,21,136,530,SG,66,44,268,MIN,.564
182,Robert Horry,100,.417,240,41,.380,108,101,33,49,164,141,.405,348,69,.645,107,81,1,1290,108,165,392,PF,48,55,272,SAS,.464
183,Eddie House,110,.351,313,51,.375,136,148,25,4,110,161,.359,449,36,.800,45,60,10,1188,28,92,409,SG,65,63,138,LAC,.415
184,Allan Houston,253,.437,579,87,.431,202,99,32,2,101,340,.435,781,157,.913,172,50,50,1799,20,105,924,SG,38,102,121,NYK,.491
185,Josh Howard,209,.448,466,20,.303,66,97,23,54,219,229,.430,532,97,.703,138,67,29,1589,149,168,575,SF,69,67,368,DAL,.449
186,Juwan Howard,529,.453,1168,0,.000,1,158,30,22,399,529,.453,1169,318,.809,393,81,77,2877,171,284,1376,PF,54,178,570,ORL,.453
187,Troy Hudson,49,.377,130,31,.403,77,70,27,0,31,80,.386,207,27,.818,33,29,1,503,4,32,218,PG,7,34,35,MIN,.461
188,Larry Hughes,322,.414,777,79,.341,232,148,25,26,230,401,.397,1009,267,.797,335,61,61,2061,96,147,1148,SG,95,152,326,WAS,.437
189,Ryan Humphrey,1,.333,3,0,.000,1,1,24,0,1,1,.250,4,0,,0,2,0,11,2,3,2,PF,1,2,3,MEM,.250
190,Brandon Hunter,53,.469,113,0,.000,3,19,23,1,68,53,.457,116,19,.442,43,36,12,406,50,40,125,PF,13,22,118,BOS,.457
191,Lindsey Hunter,35,.376,93,14,.280,50,85,33,6,54,49,.343,143,5,.625,8,33,8,661,13,45,117,SG,39,34,67,DET,.392
192,Steven Hunter,82,.529,155,0,,0,12,22,73,116,82,.529,155,23,.333,69,59,23,789,54,101,187,C,5,29,170,ORL,.529
193,Zydrunas Ilgauskas,464,.484,958,2,.286,7,109,28,201,374,466,.483,965,303,.746,406,81,81,2539,279,277,1237,C,39,163,653,CLE,.484
194,Allen Iverson*,378,.408,926,57,.286,199,324,28,5,144,435,.387,1125,339,.745,455,48,47,2040,34,87,1266,SG,115,209,178,PHI,.412
195,Bobby Jackson,182,.488,373,81,.370,219,105,30,8,119,263,.444,592,82,.752,109,50,0,1185,55,106,689,SG,49,63,174,SAC,.513
196,Jim Jackson,220,.444,495,162,.400,405,226,33,23,435,382,.424,900,107,.843,127,80,80,3119,52,227,1033,SF,86,175,487,HOU,.514
197,Marc Jackson,71,.418,170,0,.000,1,18,29,6,81,71,.415,171,64,.790,81,22,13,598,45,45,206,PF,12,24,126,PHI,.415
198,Mark Jackson,27,.458,59,7,.171,41,119,38,1,60,34,.340,100,28,.718,39,42,3,577,10,41,103,PG,17,53,70,HOU,.375
199,Stephen Jackson,391,.469,834,145,.340,427,244,25,20,273,536,.425,1261,233,.785,297,80,78,2940,97,216,1450,SF,142,223,370,ATL,.483
200,Casey Jacobsen,75,.417,180,75,.417,180,98,22,9,159,150,.417,360,91,.820,111,78,13,1828,42,144,466,SF,48,68,201,PHO,.521
201,Jerome James,129,.498,259,0,,0,32,28,60,152,129,.498,259,66,.660,100,65,24,990,78,180,324,C,20,82,230,SEA,.498
202,LeBron James,559,.438,1275,63,.290,217,465,19,58,333,622,.417,1492,347,.754,460,79,79,3122,99,149,1654,SG,130,273,432,CLE,.438
203,Mike James,166,.441,376,106,.377,281,339,28,3,206,272,.414,657,103,.811,127,81,55,2196,28,156,753,PG,96,124,234,TOT,.495
204,Antawn Jamison,472,.541,873,16,.400,40,70,27,30,287,488,.535,913,220,.748,294,82,2,2376,233,174,1212,SF,83,81,520,DAL,.543
205,Marko Jaric,134,.410,327,51,.340,150,281,25,20,131,185,.388,477,74,.733,101,58,50,1760,44,132,495,PG,93,115,175,LAC,.441
206,Chris Jefferies,10,.333,30,17,.405,42,7,23,7,24,27,.375,72,13,.650,20,21,2,195,5,36,84,SF-SG,4,19,29,TOT,.493
207,Richard Jefferson,507,.516,983,48,.364,132,315,23,28,355,555,.498,1115,357,.763,468,82,82,3133,109,224,1515,SF,92,198,464,NJN,.519
208,Jared Jeffries,172,.392,439,5,.167,30,93,22,28,244,177,.377,469,105,.614,171,82,38,1913,180,212,464,PF,48,107,424,WAS,.383
209,Britton Johnsen,16,.340,47,1,.083,12,12,24,1,30,17,.288,59,7,.438,16,20,4,290,15,28,42,C,7,14,45,ORL,.297
210,Anthony Johnson,126,.436,289,41,.336,122,202,29,8,102,167,.406,411,75,.798,94,73,7,1598,28,138,450,PG,64,75,130,IND,.456
211,Avery Johnson,80,.408,196,0,.000,3,111,38,3,30,80,.402,199,52,.667,78,46,1,637,3,34,212,PG,26,51,33,GSW,.402
212,DerMarr Johnson,23,.377,61,13,.361,36,11,23,7,34,36,.371,97,28,.903,31,21,1,287,5,32,113,SF,8,16,39,NYK,.438
213,Ervin Johnson,55,.539,102,0,.000,1,24,36,43,171,55,.534,103,17,.607,28,66,47,965,61,156,127,C,27,30,232,MIN,.534
214,Joe Johnson,472,.463,1019,83,.305,272,362,22,26,305,555,.430,1291,174,.750,232,82,77,3331,80,177,1367,SG,93,199,385,PHO,.462
215,Linton Johnson,65,.382,170,7,.212,33,27,23,32,124,72,.355,203,22,.595,37,41,20,734,59,90,173,SF,37,37,183,CHI,.372
216,Dahntay Jones,14,.286,49,1,.250,4,12,23,6,16,15,.283,53,5,.455,11,20,0,154,7,23,36,SG,5,12,23,MEM,.292
217,Damon Jones,112,.446,251,98,.359,273,478,27,4,155,210,.401,524,55,.764,72,82,26,2016,15,92,573,PG,30,103,170,MIL,.494
218,Eddie Jones,296,.437,677,177,.370,479,258,32,34,270,473,.409,1156,278,.835,333,81,81,2998,38,226,1401,SG,92,129,308,MIA,.486
219,Fred Jones,96,.432,222,27,.303,89,173,24,18,101,123,.395,311,124,.832,149,81,2,1508,25,132,397,SG,65,73,126,IND,.439
220,James Jones,1,.200,5,1,.250,4,0,23,0,2,2,.222,9,2,1.000,2,6,0,26,0,1,7,SF,1,0,2,IND,.278
221,Jumaine Jones,20,.385,52,13,.295,44,14,24,9,44,33,.344,96,14,.609,23,42,2,373,24,48,93,SG,12,19,68,BOS,.411
222,Popeye Jones,0,.000,2,0,,0,0,33,0,0,0,.000,2,0,,0,5,0,10,1,2,0,PF,0,0,1,GSW,.000
223,Chris Kaman,200,.462,433,0,.000,2,85,21,73,335,200,.460,435,99,.697,142,82,61,1843,126,211,499,C,23,155,461,LAC,.460
224,Jason Kapono,31,.365,85,21,.477,44,14,22,2,36,52,.403,129,20,.833,24,41,3,427,19,41,145,SF,13,21,55,CLE,.484
225,Jason Kidd,274,.411,666,94,.321,293,618,30,14,343,368,.384,959,206,.827,249,67,66,2450,85,110,1036,PG,122,214,428,NJN,.433
226,Andrei Kirilenko,344,.471,730,68,.338,201,244,22,215,403,412,.443,931,392,.790,496,78,78,2895,226,174,1284,PF,150,215,629,UTA,.479
227,Kerry Kittles,337,.493,683,97,.351,276,206,29,40,271,434,.453,959,107,.787,136,82,82,2842,56,144,1072,SG,125,95,327,NJN,.503
228,Brevin Knight,103,.433,238,2,.250,8,204,28,1,98,105,.427,246,49,.754,65,56,13,1037,14,107,261,PG,84,72,112,TOT,.431
229,Kyle Korver,34,.283,120,81,.391,207,40,22,8,81,115,.352,327,19,.792,24,74,0,882,30,102,330,SF,25,41,111,PHI,.476
230,Toni Kukoc,162,.479,338,49,.292,168,200,35,21,211,211,.417,506,145,.729,199,73,0,1522,60,110,616,PF,59,110,271,MIL,.465
231,Christian Laettner,113,.481,235,6,.286,21,89,34,28,182,119,.465,256,40,.800,50,48,18,984,50,102,284,PF,37,42,232,WAS,.477
232,Raef LaFrentz,49,.583,84,8,.200,40,24,27,13,49,57,.460,124,10,.769,13,17,1,328,30,47,132,C,8,11,79,BOS,.492
233,Maciej Lampe,43,.512,84,0,.000,4,9,18,3,35,43,.489,88,10,.769,13,21,0,224,9,28,96,C,3,15,44,PHO,.489
234,Sean Lampley,13,.650,20,0,,0,2,24,1,9,13,.650,20,8,.667,12,10,0,63,2,2,34,SF,0,3,11,GSW,.650
235,Dan Langhi,4,.333,12,1,.500,2,0,26,0,4,5,.357,14,2,1.000,2,6,0,37,0,7,13,SF,0,2,4,TOT,.393
236,Rusty LaRue,0,.000,2,1,1.000,1,2,30,0,3,1,.333,3,1,.500,2,4,0,22,0,2,4,PG,2,4,3,GSW,.500
237,Voshon Lenard,288,.447,644,106,.367,289,151,30,12,154,394,.422,933,144,.791,182,73,70,2233,46,177,1038,SG,61,101,200,DEN,.479
238,Quincy Lewis,5,.333,15,2,.400,5,2,26,2,6,7,.350,20,0,,0,14,0,65,1,10,16,SF,2,3,7,MIN,.400
239,Rashard Lewis,390,.463,843,145,.376,386,175,24,54,385,535,.435,1229,206,.763,270,80,80,2931,133,233,1421,SF,99,135,518,SEA,.494
240,Randy Livingston,2,.286,7,0,.000,3,4,28,0,5,2,.200,10,4,.667,6,4,0,48,2,7,8,PG,2,4,7,LAC,.200
241,Raul Lopez,198,.458,432,25,.294,85,305,23,2,131,223,.431,517,101,.863,117,82,11,1617,24,200,572,PG,62,174,155,UTA,.456
242,Tyronn Lue,229,.453,505,80,.383,209,317,26,5,161,309,.433,714,101,.771,131,76,69,2332,26,185,799,PG,61,124,187,ORL,.489
243,George Lynch,106,.449,236,43,.309,139,117,33,18,216,149,.397,375,34,.667,51,78,51,1701,96,159,375,SF,48,64,312,NOH,.455
244,Mark Madsen,101,.510,198,0,.000,6,28,28,18,138,101,.495,204,57,.483,118,72,12,1246,134,175,259,C,33,47,272,MIN,.495
245,Corey Maggette,377,.482,782,76,.329,231,224,24,16,334,453,.447,1013,526,.848,620,73,72,2628,96,217,1508,SF,65,207,430,LAC,.485
246,Jamaal Magloire,383,.474,808,0,.000,1,86,25,101,579,383,.473,809,353,.751,470,82,82,2777,268,278,1119,C,43,201,847,NOH,.473
247,Karl Malone*,193,.484,399,0,.000,1,163,40,20,306,193,.483,400,168,.747,225,42,42,1373,61,116,554,PF,50,103,367,LAL,.483
248,Stephon Marbury,511,.460,1112,87,.318,274,719,26,9,205,598,.431,1386,356,.817,436,81,81,3254,58,172,1639,PG,129,249,263,TOT,.463
249,Shawn Marion,500,.465,1076,90,.340,265,214,25,104,525,590,.440,1341,228,.851,268,79,79,3217,212,203,1498,SF,167,156,737,PHO,.474
250,Donyell Marshall,339,.488,695,131,.403,325,122,30,124,598,470,.461,1020,134,.736,182,82,74,2988,210,247,1205,PF,93,117,808,TOT,.525
251,Darrick Martin,14,.341,41,6,.231,26,23,32,1,5,20,.299,67,9,1.000,9,16,0,172,2,23,55,PG,2,7,7,MIN,.343
252,Kenyon Martin,432,.494,875,7,.280,25,160,26,82,484,439,.488,900,201,.684,294,65,62,2252,133,230,1086,PF,95,168,617,NJN,.492
253,Jamal Mashburn,137,.414,331,19,.284,67,47,31,5,98,156,.392,398,65,.813,80,19,18,730,19,42,396,SF,14,37,117,NOH,.416
254,Desmond Mason,400,.483,828,9,.231,39,152,26,24,266,409,.472,867,356,.769,463,82,31,2534,93,191,1183,SF,60,148,359,MIL,.477
255,Roger Mason,19,.322,59,13,.333,39,26,23,6,30,32,.327,98,19,.864,22,26,3,328,1,36,96,SG,11,20,31,TOT,.393
256,Tony Massenburg,104,.477,218,0,.000,1,29,36,18,131,104,.475,219,43,.683,63,59,0,789,57,144,251,PF,14,45,188,SAC,.475
257,Walter McCarty,66,.420,157,137,.374,366,124,29,22,211,203,.388,523,62,.756,82,77,23,1900,28,179,605,PF,72,91,239,BOS,.519
258,Amal McCaskill,47,.405,116,0,.000,1,20,30,20,85,47,.402,117,19,.704,27,59,3,636,48,89,113,C,12,25,133,PHI,.402
259,Jelani McCoy,0,,0,0,,0,0,26,0,3,0,,0,0,,0,2,0,12,1,4,0,C,0,1,4,CLE,
260,Antonio McDyess,126,.470,268,0,,0,36,29,24,187,126,.470,268,38,.551,69,42,20,927,70,117,290,PF,37,57,257,TOT,.470
261,Tracy McGrady*,479,.455,1053,174,.339,513,370,24,42,307,653,.417,1566,398,.796,500,67,67,2675,95,129,1878,SG,93,179,402,ORL,.473
262,Jeff McInnis,288,.465,620,46,.362,127,430,29,6,143,334,.447,747,114,.797,143,70,57,2365,33,163,828,SG-PG,72,120,176,TOT,.478
263,Aaron McKie,190,.469,405,75,.436,172,195,31,23,208,265,.459,577,84,.757,111,75,41,2112,45,142,689,SF,85,103,253,PHI,.524
264,Keith McLeod,26,.361,72,1,.100,10,59,24,1,29,27,.329,82,33,.767,43,33,0,391,5,39,88,PG,16,29,34,MIN,.335
265,Stanislav Medvedenko,237,.444,534,0,.000,3,57,24,18,195,237,.441,537,89,.767,116,68,38,1442,148,191,563,PF,38,59,343,LAL,.441
266,Ron Mercer,88,.431,204,2,.286,7,22,27,5,39,90,.427,211,13,.765,17,39,0,516,10,37,195,SG,14,26,49,SAS,.431
267,Chris Mihm,186,.488,381,0,,0,21,24,63,257,186,.488,381,110,.663,166,76,17,1330,156,208,482,C-PF,37,90,413,TOT,.488
268,Darius Miles,358,.502,713,7,.175,40,162,22,61,247,365,.485,753,124,.642,193,79,56,2079,112,168,861,SF,67,130,359,TOT,.489
269,Darko Milicic,17,.266,64,0,.000,1,7,18,15,32,17,.262,65,14,.583,24,34,0,159,11,33,48,C,7,13,43,DET,.262
270,Andre Miller,418,.477,876,12,.185,65,501,27,25,239,430,.457,941,342,.832,411,82,82,2838,127,194,1214,PG,142,215,366,DEN,.463
271,Brad Miller,361,.521,693,12,.316,38,312,27,86,552,373,.510,731,256,.778,329,72,53,2621,191,247,1014,PF,68,144,743,SAC,.518
272,Mike Miller,190,.474,401,80,.372,215,232,23,14,174,270,.438,616,102,.723,141,65,65,1770,42,162,722,SF,59,107,216,MEM,.503
273,Oliver Miller,53,.535,99,0,.000,1,36,33,26,84,53,.530,100,15,.652,23,48,1,506,46,91,121,C,19,33,130,MIN,.530
274,Reggie Miller*,126,.485,260,134,.401,334,249,38,11,170,260,.438,594,146,.885,165,80,80,2254,18,96,800,SG,65,68,188,IND,.551
275,Yao Ming*,535,.523,1023,0,.000,2,122,23,156,538,535,.522,1025,361,.809,446,82,82,2692,197,273,1431,C,22,204,735,HOU,.522
276,Cuttino Mobley,296,.448,661,164,.390,420,258,28,33,322,460,.426,1081,176,.811,217,80,80,3229,40,179,1260,SG,107,180,362,HOU,.501
277,Nazr Mohammed,246,.521,472,0,,0,36,26,52,296,246,.521,472,100,.592,169,80,24,1611,178,195,592,C,55,96,474,TOT,.521
278,Jerome Moiso,40,.482,83,0,.000,1,8,25,12,72,40,.476,84,22,.579,38,35,1,417,41,42,102,PF,17,25,113,TOR,.476
279,Mikki Moore,50,.505,99,0,,0,19,28,13,55,50,.505,99,30,.857,35,32,0,395,29,65,130,PF-C,7,22,84,TOT,.505
280,Alonzo Mourning*,33,.465,71,0,,0,8,33,6,19,33,.465,71,30,.882,34,12,0,215,8,32,96,C,2,10,27,NJN,.465
281,Troy Murphy,102,.451,226,5,.294,17,20,23,17,125,107,.440,243,60,.750,80,28,0,610,48,58,279,PF,12,34,173,GSW,.451
282,Lamond Murray,55,.355,155,21,.350,60,28,30,7,76,76,.353,215,24,.686,35,33,4,518,14,47,197,SF,15,38,90,TOR,.402
283,Ronald Murray,322,.469,686,67,.293,229,205,24,28,159,389,.425,915,168,.715,235,82,18,2021,45,158,1013,PG,81,149,204,SEA,.462
284,Tracy Murray,1,.143,7,2,.400,5,1,32,0,2,3,.250,12,0,.000,1,7,0,35,3,3,8,SF,1,2,5,POR,.333
285,Dikembe Mutombo*,141,.478,295,0,,0,25,37,123,292,141,.478,295,81,.681,119,65,56,1494,145,141,363,C,17,54,437,NYK,.478
286,Mamadou N'Diaye,27,.391,69,0,,0,0,28,25,69,27,.391,69,44,.746,59,28,1,366,43,59,98,C,8,18,112,TOT,.391
287,Bostjan Nachbar,24,.348,69,23,.365,63,30,23,14,62,47,.356,132,21,.724,29,45,3,516,8,72,138,SF,14,23,70,HOU,.443
288,Lee Nailon,147,.454,324,0,.000,3,38,28,8,79,147,.450,327,47,.810,58,57,4,780,64,93,341,PF-SF,15,45,143,TOT,.450
289,Eduardo Najera,70,.443,158,2,.500,4,25,27,19,89,72,.444,162,30,.652,46,58,7,720,67,90,176,SF,35,29,156,DAL,.451
290,Steve Nash,293,.498,588,104,.405,257,687,29,8,173,397,.470,845,230,.916,251,78,78,2612,59,139,1128,PG,67,209,232,DAL,.531
291,Rasho Nesterovic,328,.469,700,0,,0,114,27,165,376,328,.469,700,54,.474,114,82,82,2353,257,247,710,C,51,107,633,SAS,.469
292,Ira Newble,106,.412,257,2,.105,19,72,29,19,90,108,.391,276,36,.783,46,64,25,1245,65,109,254,SF,25,54,155,CLE,.395
293,Moochie Norris,60,.377,159,20,.345,58,121,30,5,55,80,.369,217,54,.761,71,66,0,847,10,51,234,PG,44,64,65,TOT,.415
294,Dirk Nowitzki,506,.496,1020,99,.341,290,207,25,104,580,605,.462,1310,371,.877,423,77,77,2915,90,216,1680,C,92,135,670,DAL,.500
295,Jermaine O'Neal,606,.438,1382,2,.111,18,164,25,199,585,608,.434,1400,348,.757,460,78,78,2788,193,248,1566,PF,59,181,778,IND,.435
296,Shaquille O'Neal*,554,.584,948,0,,0,196,31,166,523,554,.584,948,331,.490,676,67,67,2464,246,225,1439,C,34,195,769,LAL,.584
297,Charles Oakley,2,.333,6,0,,0,2,40,0,5,2,.333,6,5,.833,6,7,0,25,0,8,9,PF,0,1,5,HOU,.333
298,Lamar Odom,424,.460,922,61,.298,205,327,24,71,616,485,.430,1127,340,.742,458,80,80,3003,160,273,1371,PF,85,236,776,MIA,.457
299,Mehmet Okur,233,.472,494,18,.375,48,69,24,63,261,251,.463,542,162,.775,209,71,33,1580,160,138,682,PF,36,101,421,DET,.480
300,Kevin Ollie,91,.367,248,4,.444,9,234,31,8,147,95,.370,257,147,.835,176,82,7,1401,23,119,341,PG,51,81,170,CLE,.377
301,Michael Olowokandi,121,.425,285,0,,0,24,28,68,167,121,.425,285,36,.590,61,43,25,925,78,137,278,C,16,54,245,MIN,.425
302,Greg Ostertag,208,.477,436,0,.000,1,123,30,139,357,208,.476,437,113,.579,195,78,51,2153,221,228,529,C,30,99,578,UTA,.476
303,Bo Outlaw,159,.516,308,0,.000,4,90,32,70,217,159,.510,312,61,.526,116,82,1,1606,125,170,379,PF,73,69,342,MEM,.510
304,Travis Outlaw,3,.429,7,0,,0,1,19,0,2,3,.429,7,2,.500,4,8,0,19,2,1,8,PF,1,1,4,POR,.429
305,Doug Overton,96,.432,222,3,.130,23,138,34,2,70,99,.404,245,23,.742,31,61,11,1033,16,89,224,PG,26,58,86,TOT,.410
306,Zaza Pachulia,68,.389,175,0,,0,13,19,12,105,68,.389,175,58,.644,90,59,2,664,69,87,194,C,21,34,174,ORL,.389
307,Robert Pack,22,.423,52,0,,0,27,34,1,14,22,.423,52,5,.833,6,26,0,220,4,20,49,PG,12,16,18,NJN,.423
308,Scott Padgett,46,.451,102,28,.431,65,23,27,13,93,74,.443,167,24,.750,32,58,5,547,46,73,200,PF,12,22,139,HOU,.527
309,Milt Palacio,100,.368,272,4,.154,26,184,25,11,87,104,.349,298,45,.662,68,59,13,1211,15,90,257,PG,41,87,102,TOR,.356
310,Jannero Pargo,59,.431,137,22,.355,62,70,24,6,29,81,.407,199,23,.852,27,31,1,479,8,50,207,PG,13,47,37,TOT,.462
311,Tony Parker,361,.483,747,62,.312,199,411,21,7,194,423,.447,946,191,.702,272,75,75,2577,43,148,1099,PG,61,179,237,SAS,.480
312,Cherokee Parks,4,.400,10,0,,0,1,31,3,6,4,.400,10,4,.667,6,12,0,64,4,7,12,C,0,2,10,GSW,.400
313,Ruben Patterson,198,.517,383,2,.167,12,139,28,21,139,200,.506,395,105,.553,190,73,1,1651,129,152,507,SF,84,105,268,POR,.509
314,Sasha Pavlovic,130,.425,306,19,.271,70,60,20,16,115,149,.396,376,65,.774,84,79,14,1144,44,187,382,SF,41,67,159,UTA,.422
315,Gary Payton*,427,.497,859,55,.333,165,449,35,19,270,482,.471,1024,180,.714,252,82,82,2825,72,169,1199,PG,96,151,342,LAL,.498
316,Anthony Peeler,88,.425,207,68,.482,141,120,34,10,122,156,.448,348,51,.836,61,75,0,1391,31,103,431,SG,56,77,153,SAC,.546
317,Desmond Penigar,14,.500,28,0,,0,3,22,2,18,14,.500,28,4,1.000,4,10,0,89,6,14,32,PF,2,6,24,ORL,.500
318,Kirk Penney,0,.000,3,1,.333,3,1,23,0,1,1,.167,6,0,,0,2,0,18,0,1,3,SG,1,3,1,MIA,.250
319,Kendrick Perkins,8,.533,15,0,,0,3,19,2,9,8,.533,15,6,.667,9,10,0,35,5,6,22,C,0,5,14,BOS,.533
320,Wesley Person,71,.403,176,55,.399,138,66,32,9,101,126,.401,314,31,.795,39,58,0,1037,16,38,338,SG,19,38,117,TOT,.489
321,Morris Peterson,112,.453,247,126,.371,340,113,26,14,226,238,.405,587,76,.809,94,82,29,2148,35,206,678,SF,88,69,261,TOR,.513
322,Eric Piatkowski,29,.420,69,43,.352,122,26,33,5,63,72,.377,191,14,.875,16,49,0,703,10,42,201,SF,16,29,73,HOU,.490
323,Paul Pierce,487,.438,1113,115,.299,384,410,26,52,453,602,.402,1497,517,.819,631,80,80,3099,69,234,1836,SG,131,303,522,BOS,.441
324,Mickael Pietrus,61,.484,126,35,.333,105,27,21,12,71,96,.416,231,52,.693,75,53,22,748,48,100,279,PG,32,40,119,GSW,.491
325,Scottie Pippen*,40,.435,92,13,.271,48,50,38,9,48,53,.379,140,17,.630,27,23,6,412,20,38,136,SF,21,29,68,CHI,.425
326,Zoran Planinic,44,.454,97,9,.281,32,68,21,3,41,53,.411,129,38,.633,60,49,1,473,14,70,153,SG,13,36,55,NJN,.446
327,Scot Pollard,47,.412,114,0,,0,10,28,26,97,47,.412,114,12,.571,21,61,3,678,67,110,106,C,23,22,164,IND,.412
328,Olden Polynice,0,,0,0,,0,1,39,0,1,0,,0,0,,0,2,0,12,1,2,0,C,1,4,2,LAC,
329,Mark Pope,1,.500,2,0,,0,0,31,0,3,1,.500,2,0,.000,1,4,0,20,0,8,2,PF,1,3,3,DEN,.500
330,James Posey,256,.533,480,112,.386,290,122,27,40,311,368,.478,770,278,.830,335,82,82,2451,92,248,1126,SG,137,112,403,MEM,.551
331,Vitaly Potapenko,200,.489,409,0,,0,53,28,28,188,200,.489,409,59,.641,92,65,39,1419,101,161,459,C,22,77,289,SEA,.489
332,Tayshaun Prince,281,.496,566,57,.363,157,191,23,69,297,338,.467,723,108,.766,141,82,80,2701,93,149,841,SF,63,119,390,DET,.507
333,Joel Przybilla,18,.360,50,0,,0,7,24,17,79,18,.360,50,13,.419,31,17,12,347,32,53,49,C,5,18,111,TOT,.360
334,Vladimir Radmanovic,205,.471,435,140,.371,377,142,23,42,302,345,.425,812,95,.748,127,77,38,2321,104,187,925,PF,80,109,406,SEA,.511
335,Zach Randolph,662,.486,1363,1,.200,5,163,22,41,609,663,.485,1368,299,.761,393,81,80,3067,242,227,1626,PF,68,247,851,POR,.485
336,Theo Ratliff,266,.485,549,0,,0,71,30,307,419,266,.485,549,140,.645,217,85,83,2664,195,300,672,C,54,120,614,TOT,.485
337,Zeljko Rebraca,34,.442,77,0,,0,6,31,11,35,34,.442,77,23,.767,30,24,2,273,23,52,91,C,5,17,58,TOT,.442
338,Michael Redd,506,.470,1076,127,.350,363,185,24,6,289,633,.440,1439,383,.868,441,82,82,3021,118,152,1776,SG,81,116,407,MIL,.484
339,Glen Rice,17,.354,48,5,.179,28,24,36,0,32,22,.289,76,17,1.000,17,18,0,262,9,22,66,SF,6,13,41,LAC,.322
340,Jason Richardson,486,.481,1011,77,.282,273,226,23,41,400,563,.438,1284,258,.684,377,78,78,2936,124,182,1461,SG,86,196,524,GSW,.468
341,Quentin Richardson,305,.420,727,120,.352,341,139,23,19,268,425,.398,1068,151,.740,204,65,64,2338,146,130,1121,SG,67,141,414,LAC,.454
342,Luke Ridnour,118,.437,270,27,.338,80,163,22,7,73,145,.414,350,65,.823,79,69,6,1114,35,105,382,PG,52,80,108,SEA,.453
343,Clifford Robinson,254,.403,631,112,.357,314,271,37,73,268,366,.387,945,123,.711,173,82,82,2846,54,237,967,PF,68,173,322,GSW,.447
344,Eddie Robinson,156,.486,321,1,.200,5,58,27,10,77,157,.482,326,28,.651,43,51,4,1024,27,57,343,SF,33,45,104,CHI,.483
345,Glenn Robinson,241,.469,514,34,.340,100,57,31,9,143,275,.448,614,114,.832,137,42,42,1336,46,96,698,SF,42,106,189,PHI,.476
346,Rodney Rogers,157,.445,353,50,.329,152,137,32,27,207,207,.410,505,75,.765,98,69,15,1409,100,183,539,PF,59,98,307,NJN,.459
347,Sean Rooks,54,.360,150,0,.000,1,29,34,10,73,54,.358,151,33,.892,37,55,0,595,24,89,141,C,14,22,97,TOT,.358
348,Jalen Rose,314,.419,750,69,.342,202,329,31,22,232,383,.402,952,187,.810,231,66,64,2497,34,184,1022,PG-SF,51,208,266,TOT,.439
349,Malik Rose,173,.431,401,0,.000,3,69,29,24,210,173,.428,404,183,.813,225,67,13,1256,110,164,529,PF,36,112,320,SAS,.428
350,Michael Ruffin,38,.325,117,0,,0,41,27,21,129,38,.325,117,16,.421,38,41,23,733,78,103,92,PF,22,42,207,UTA,.325
351,Kareem Rush,142,.483,294,48,.348,138,59,23,20,77,190,.440,432,31,.596,52,72,15,1244,20,109,459,SG,33,48,97,LAL,.495
352,Bryon Russell,55,.417,132,43,.384,112,71,33,12,114,98,.402,244,50,.769,65,72,1,945,32,110,289,SF,32,37,146,LAL,.490
353,John Salmons,111,.413,269,50,.340,147,134,24,16,158,161,.387,416,71,.772,92,77,24,1603,38,122,443,SG,62,77,196,PHI,.447
354,Jamal Sampson,11,.478,23,0,,0,7,20,4,29,11,.478,23,7,.583,12,10,2,130,23,16,29,C,2,6,52,LAL,.478
355,Daniel Santiago,78,.479,163,0,,0,24,27,21,97,78,.479,163,61,.678,90,54,28,708,35,98,217,C,19,32,132,MIL,.479
356,Brian Scalabrine,76,.429,177,10,.244,41,65,25,14,131,86,.394,218,58,.829,70,69,2,928,42,113,240,PF,21,42,173,NJN,.417
357,Ansu Sesay,75,.478,157,6,.286,21,19,27,20,49,81,.455,178,32,.696,46,57,2,583,43,66,200,SF,19,23,92,SEA,.472
358,Paul Shirley,10,.455,22,0,.000,1,4,26,1,8,10,.435,23,1,.333,3,7,0,86,8,9,21,PF,1,9,16,CHI,.435
359,Bobby Simmons,145,.402,361,2,.167,12,96,23,17,147,147,.394,373,141,.834,169,56,8,1376,115,169,437,SF,51,73,262,LAC,.397
360,Brian Skinner,255,.497,513,0,,0,49,27,61,292,255,.497,513,79,.572,138,56,54,1577,119,165,589,C,30,78,411,MIL,.497
361,Tamar Slay,17,.354,48,4,.333,12,14,23,1,15,21,.350,60,7,.500,14,22,0,165,10,20,53,SG,7,11,25,NJN,.383
362,Jabari Smith,26,.388,67,0,.000,3,11,26,6,20,26,.371,70,12,.600,20,31,0,168,11,25,64,C,2,7,31,SAC,.371
363,Joe Smith,310,.441,703,1,.200,5,78,28,94,413,311,.439,708,207,.859,241,76,76,2254,230,209,830,PF,47,82,643,MIL,.440
364,Leon Smith,1,.500,2,0,,0,0,23,0,1,1,.500,2,0,,0,1,0,4,1,1,2,C,0,0,2,SEA,.500
365,Steve Smith,76,.409,186,43,.402,107,56,34,6,54,119,.406,293,77,.928,83,71,4,929,27,91,358,SG,15,42,81,NOH,.480
366,Theron Smith,10,.323,31,6,.500,12,7,23,5,28,16,.372,43,6,.750,8,20,0,178,13,18,44,SF,5,14,41,MEM,.442
367,Eric Snow,293,.420,697,2,.111,18,563,30,6,219,295,.413,715,252,.797,316,82,82,2966,62,213,844,PG,97,187,281,PHI,.414
368,Darius Songaila,133,.487,273,0,,0,48,25,12,134,133,.487,273,71,.807,88,73,7,976,91,126,337,PF,42,43,225,SAC,.487
369,Latrell Sprewell,419,.433,967,99,.331,299,286,33,21,254,518,.409,1266,240,.814,295,82,82,3100,56,101,1375,SF,88,158,310,MIN,.448
370,Jerry Stackhouse,105,.410,256,23,.354,65,103,29,3,78,128,.399,321,83,.806,103,26,17,774,16,49,362,SF,24,88,94,WAS,.435
371,Vladimir Stepania,43,.417,103,0,,0,23,27,15,75,43,.417,103,22,.611,36,42,2,453,50,61,108,C,11,19,125,POR,.417
372,DeShawn Stevenson,357,.446,800,19,.268,71,158,22,17,219,376,.432,871,138,.676,204,80,78,2444,79,140,909,SG-SF,52,120,298,TOT,.443
373,Michael Stewart,5,.417,12,0,,0,0,28,10,21,5,.417,12,3,.750,4,25,2,147,8,34,13,C-PF,2,3,29,TOT,.417
374,Peja Stojakovic,425,.511,832,240,.433,554,173,26,14,417,665,.480,1386,394,.927,425,81,81,3264,91,159,1964,SF,108,153,508,SAC,.566
375,Damon Stoudamire,252,.426,591,156,.365,427,500,30,9,256,408,.401,1018,127,.876,145,82,82,3118,52,173,1099,PG,99,180,308,POR,.477
376,Amar'e Stoudemire,410,.477,860,1,.200,5,78,21,89,339,411,.475,865,310,.713,435,55,53,2025,157,188,1133,PF,64,177,496,PHO,.476
377,Erick Strickland,50,.385,130,29,.439,66,90,30,2,58,79,.403,196,44,.863,51,43,0,571,13,63,231,PG,26,54,71,MIL,.477
378,Rod Strickland,140,.442,317,10,.278,36,244,37,11,121,150,.425,353,72,.735,98,61,10,1197,34,76,382,PG,35,85,155,TOT,.439
379,Bruno Sundov,4,.400,10,0,,0,1,23,0,8,4,.400,10,3,.500,6,5,0,33,2,9,11,C,0,3,10,TOT,.400
380,Bob Sura,181,.446,406,21,.266,79,233,30,14,226,202,.416,485,171,.757,226,80,18,1663,100,158,596,SG,62,105,326,TOT,.438
381,Mike Sweetney,69,.496,139,0,.000,1,14,21,12,89,69,.493,140,42,.724,58,42,1,494,68,57,180,PF,18,32,157,NYK,.493
382,Stromile Swift,267,.471,567,1,.250,4,38,24,118,237,268,.469,571,190,.725,262,77,10,1528,141,188,727,PF,56,88,378,MEM,.470
383,Wally Szczerbiak,86,.453,190,20,.435,46,33,26,1,64,106,.449,236,53,.828,64,28,0,622,24,42,285,SF,12,28,88,MIN,.492
384,Maurice Taylor,367,.481,763,0,.000,2,107,27,47,253,367,.480,765,128,.736,174,75,10,2081,131,253,862,PF,43,149,384,HOU,.480
385,Jason Terry,353,.455,775,146,.347,421,437,26,16,287,499,.417,1196,215,.827,260,81,78,3018,49,192,1359,PG,124,229,336,ATL,.478
386,Etan Thomas,257,.489,526,0,,0,68,25,123,345,257,.489,526,191,.647,295,79,15,1901,183,219,705,C,36,113,528,WAS,.489
387,Kenny Thomas,380,.470,808,1,.200,5,111,26,33,489,381,.469,813,243,.752,323,74,72,2699,261,219,1006,PF,82,172,750,PHI,.469
388,Kurt Thomas,392,.475,826,0,.000,3,149,31,80,517,392,.473,829,106,.835,127,80,75,2548,145,298,890,PF,56,132,662,NYK,.473
389,Tim Thomas,290,.468,619,73,.376,194,124,26,20,256,363,.446,813,171,.784,218,66,65,2089,64,196,970,SF,64,116,320,TOT,.491
390,Jamaal Tinsley,76,.466,163,77,.372,207,303,25,17,108,153,.414,370,49,.731,67,52,43,1378,28,132,432,PG,84,110,136,IND,.518
391,Robert Traylor,143,.507,282,2,.400,5,43,26,37,156,145,.505,287,70,.547,128,71,0,942,106,161,362,C,39,62,262,NOH,.509
392,Gary Trent,155,.481,322,0,.000,6,49,29,17,133,155,.473,328,69,.758,91,68,2,1025,83,129,379,C,12,54,216,MIN,.473
393,Jeff Trepagnier,8,.235,34,2,.500,4,4,24,0,9,10,.263,38,3,.500,6,11,0,96,6,7,25,SG,3,6,15,DEN,.289
394,Cezary Trybanski,0,.000,4,0,,0,0,24,1,1,0,.000,4,1,.500,2,7,0,15,0,3,1,C,1,2,1,TOT,.000
395,Jake Tsakalidis,67,.504,133,0,,0,18,24,22,91,67,.504,133,36,.590,61,40,28,533,37,79,170,C,9,23,128,MEM,.504
396,Nikoloz Tskitishvili,37,.333,111,3,.273,11,10,20,8,39,40,.328,122,23,.793,29,39,0,307,24,50,106,PF,6,17,63,DEN,.340
397,Hedo Turkoglu,161,.399,404,101,.419,241,154,24,32,306,262,.406,645,114,.708,161,80,44,2073,52,165,739,SF,80,94,358,SAS,.484
398,Ime Udoka,3,.375,8,0,.000,1,2,26,1,4,3,.333,9,2,.500,4,4,0,28,1,3,8,SF,2,3,5,LAL,.333
399,Nick Van Exel,141,.429,329,46,.307,150,206,32,2,88,187,.390,479,70,.707,99,39,29,1255,16,57,490,PG,20,78,104,GSW,.438
400,Keith Van Horn,317,.473,670,93,.399,233,120,28,33,352,410,.454,903,249,.859,290,72,62,2340,149,215,1162,SF,68,169,501,TOT,.506
401,Jacque Vaughn,104,.405,257,3,.150,20,195,28,2,104,107,.386,277,53,.779,68,71,6,1271,12,126,270,PG,44,84,116,ATL,.392
402,Jake Voskuhl,152,.507,300,0,,0,57,26,25,220,152,.507,300,134,.740,181,66,43,1606,123,258,438,C,42,77,343,PHO,.507
403,Slavko Vranes,0,.000,1,0,,0,0,21,0,0,0,.000,1,0,,0,1,0,3,0,1,0,C,0,0,0,POR,.000
404,Dwyane Wade,355,.477,745,16,.302,53,275,22,34,162,371,.465,798,233,.747,312,61,56,2126,85,140,991,PG,86,196,247,MIA,.475
405,Dajuan Wagner,81,.368,220,31,.360,86,51,20,7,49,112,.366,306,32,.681,47,44,4,708,9,89,287,SG,26,41,58,CLE,.417
406,Antoine Walker,401,.487,824,82,.269,305,369,27,65,486,483,.428,1129,103,.554,186,82,82,2840,198,212,1151,PF,65,202,684,DAL,.464
407,Samaki Walker,38,.392,97,0,.000,2,6,27,11,70,38,.384,99,29,.659,44,33,0,418,42,54,105,PF,9,15,112,MIA,.384
408,Ben Wallace,314,.424,740,1,.125,8,138,29,246,682,315,.421,748,142,.490,290,81,81,3050,324,162,773,C,143,123,1006,DET,.422
409,Gerald Wallace,32,.368,87,0,.000,2,19,21,14,39,32,.360,89,11,.458,24,37,1,337,35,37,75,SF,14,8,74,SAC,.360
410,John Wallace,56,.424,132,5,.385,13,14,29,8,47,61,.421,145,31,.775,40,37,0,368,12,38,158,SF,5,24,59,MIA,.438
411,Rasheed Wallace,343,.472,726,82,.331,248,156,29,122,357,425,.436,974,156,.736,212,68,66,2390,102,190,1088,PF,61,119,459,TOT,.478
412,Luke Walton,52,.456,114,13,.333,39,113,23,8,88,65,.425,153,31,.705,44,72,2,730,39,70,174,PF,28,44,127,LAL,.467
413,Charlie Ward,76,.413,184,84,.408,206,215,33,11,132,160,.410,390,20,.741,27,71,10,1252,12,107,424,PG,64,96,144,TOT,.518
414,Earl Watson,146,.408,358,26,.245,106,402,24,19,129,172,.371,464,90,.652,138,81,14,1669,49,175,460,PG,91,146,178,MEM,.399
415,Clarence Weatherspoon,104,.495,210,0,.000,1,30,33,15,130,104,.493,211,53,.736,72,52,1,868,74,75,261,PF,30,35,204,TOT,.493
416,Chris Webber,173,.416,416,1,.200,5,105,30,20,152,174,.413,421,81,.711,114,23,23,831,48,76,430,PF,31,60,200,SAC,.414
417,Bonzi Wells,341,.437,781,22,.319,69,139,27,19,182,363,.427,850,138,.754,183,72,27,1872,78,197,886,SG,91,161,260,TOT,.440
418,Jiri Welsch,193,.448,431,69,.381,181,183,24,7,236,262,.428,612,153,.743,206,81,68,2179,60,176,746,SG,101,129,296,BOS,.484
419,David Wesley,219,.425,515,92,.323,285,175,33,14,106,311,.389,800,137,.753,182,61,60,2001,28,147,851,SG,71,100,134,NOH,.446
420,David West,108,.478,226,0,.000,2,60,23,28,180,108,.474,228,57,.713,80,71,1,930,117,117,273,PF,27,48,297,NOH,.474
421,Jahidi White,99,.521,190,0,,0,7,27,51,164,99,.521,190,63,.500,126,62,17,865,97,176,261,C,25,66,261,TOT,.521
422,Rodney White,182,.478,381,33,.379,87,60,23,20,121,215,.459,468,78,.750,104,72,0,985,44,105,541,SF,32,78,165,DEN,.495
423,Chris Whitney,9,.333,27,8,.444,18,14,32,2,12,17,.378,45,5,1.000,5,16,5,186,3,6,47,PG,6,6,15,WAS,.467
424,Chris Wilcox,227,.522,435,0,.000,1,51,21,20,180,227,.521,436,105,.700,150,65,17,1340,125,183,559,C,29,80,305,LAC,.521
425,Mike Wilks,11,.423,26,6,.600,10,17,24,0,13,17,.472,36,10,.833,12,26,0,145,3,15,50,PG,3,7,16,HOU,.556
426,Aaron Williams,171,.504,339,1,.333,3,81,32,46,193,172,.503,342,105,.677,155,72,7,1337,101,187,450,C,34,89,294,NJN,.504
427,Alvin Williams,175,.430,407,26,.292,89,224,29,10,132,201,.405,496,66,.776,85,56,54,1730,18,114,494,SG,55,78,150,TOR,.431
428,Eric Williams,196,.416,471,35,.276,127,120,31,9,221,231,.386,598,215,.760,283,71,36,1886,65,180,712,SF,70,88,286,TOT,.416
429,Frank Williams,62,.419,148,18,.300,60,121,23,6,45,80,.385,208,41,.854,48,56,3,714,8,58,219,PG,25,63,53,NYK,.428
430,Jason Williams,170,.487,349,120,.330,364,492,28,5,122,290,.407,713,82,.837,98,72,68,2115,25,97,782,PG,92,136,147,MEM,.491
431,Jerome Williams,158,.482,328,0,.000,8,72,30,8,298,158,.470,336,106,.684,155,68,44,1637,177,134,422,PF,90,74,475,TOT,.470
432,Mo Williams,105,.398,264,10,.256,39,76,21,2,49,115,.380,303,44,.786,56,57,0,772,23,87,284,SG,28,51,72,UTA,.396
433,Scott Williams,88,.481,183,2,.667,3,17,35,16,94,90,.484,186,16,.593,27,43,21,527,38,95,198,C,20,16,132,TOT,.489
434,Shammond Williams,57,.432,132,30,.300,100,116,28,2,51,87,.375,232,51,.879,58,53,4,763,9,62,255,SG-PG,37,47,60,TOT,.440
435,Corliss Williamson,304,.505,602,0,,0,57,30,20,168,304,.505,602,144,.731,197,79,0,1574,88,204,752,PF,30,113,256,DET,.505
436,Kevin Willis,70,.470,149,0,.000,1,11,41,9,61,70,.467,150,24,.615,39,48,0,373,37,61,164,C,21,32,98,SAS,.467
437,Loren Woods,44,.458,96,0,,0,10,25,19,69,44,.458,96,33,.600,55,38,2,506,65,52,121,C,11,26,134,MIA,.458
438,Qyntel Woods,78,.375,208,10,.345,29,46,22,14,90,88,.371,237,38,.633,60,62,8,673,46,88,224,SF,20,52,136,POR,.392
439,Metta World Peace,393,.452,870,75,.310,242,272,24,50,285,468,.421,1112,322,.733,439,73,71,2714,100,194,1333,SF,152,202,385,IND,.455
440,Lorenzen Wright,257,.442,581,0,.000,5,71,28,58,301,257,.439,586,96,.733,131,65,46,1674,144,192,610,C,45,77,445,MEM,.439
441,Wang Zhizhi,13,.406,32,4,.286,14,2,26,5,14,17,.370,46,9,.900,10,16,0,114,4,13,47,C,3,6,18,TOT,.413
