,Player_Name,2P,2P%,2PA,3P,3P%,3PA,AST,Age,BLK,DRB,FG,FG%,FGA,FT,FT%,FTA,Games,Games_Strated,Minutes_Played,ORB,PF,PTS,Position,STL,TOV,TRB,Team,eFG%
0,Shareef Abdur-Rahim,322,.510,631,15,.385,39,111,28,26,269,337,.503,670,220,.866,254,54,49,1867,123,150,909,PF,49,117,392,POR,.514
1,Cory Alexander,8,.267,30,8,.421,19,37,31,1,21,16,.327,49,9,.750,12,16,1,201,8,29,49,SG,9,19,29,CHA,.408
2,Malik Allen,84,.475,177,0,,0,18,26,22,59,84,.475,177,26,.929,28,36,1,519,40,53,194,PF,9,18,99,TOT,.475
3,Ray Allen,431,.459,938,209,.376,556,289,29,5,268,640,.428,1494,378,.883,428,78,78,3064,79,167,1867,SG,84,171,347,SEA,.498
4,Tony Allen,172,.483,356,12,.387,31,64,23,24,136,184,.475,387,112,.737,152,77,34,1262,85,156,492,SG,76,77,221,BOS,.491
5,Rafer Alston,264,.451,585,139,.357,389,514,28,7,237,403,.414,974,191,.740,258,80,78,2717,42,212,1136,PG,118,170,279,TOR,.485
6,Chris Andersen,191,.538,355,0,.000,3,71,26,100,273,191,.534,358,131,.689,190,67,2,1430,137,144,513,C,14,64,410,NOH,.534
7,Derek Anderson,94,.392,240,58,.384,151,143,30,4,103,152,.389,391,70,.805,87,47,32,1239,25,89,432,SG,36,70,128,POR,.463
8,Kenny Anderson,79,.420,188,6,.462,13,103,34,0,64,85,.423,201,27,.730,37,43,20,743,24,87,203,PG,33,49,88,TOT,.438
9,Shandon Anderson,93,.495,188,5,.172,29,70,31,14,150,98,.452,217,54,.818,66,66,5,1171,41,138,255,SF-SG,40,50,191,TOT,.463
10,Carmelo Anthony,488,.455,1072,42,.266,158,194,20,30,285,530,.431,1230,456,.796,573,75,75,2608,141,229,1558,SF,68,224,426,DEN,.448
11,Rafael Araujo,75,.436,172,1,.333,3,16,24,8,126,76,.434,175,43,.782,55,59,41,736,59,157,196,C,21,52,185,TOR,.437
12,Gilbert Arenas,451,.469,961,205,.365,562,411,23,23,295,656,.431,1523,521,.814,640,80,80,3274,83,245,2038,PG,139,242,378,WAS,.498
13,Trevor Ariza,169,.449,376,3,.231,13,85,19,18,153,172,.442,389,121,.695,174,80,12,1382,89,150,468,SF,70,73,242,NYK,.446
14,Darrell Armstrong,61,.367,166,28,.252,111,178,36,8,80,89,.321,277,58,.853,68,66,16,988,35,92,264,PG,45,67,115,TOT,.372
15,Carlos Arroyo,159,.398,399,8,.267,30,280,25,4,78,167,.389,429,119,.799,149,70,16,1448,26,143,461,PG,44,107,104,TOT,.399
16,Chucky Atkins,212,.466,455,176,.387,455,358,30,2,166,388,.426,910,163,.803,203,82,82,2903,31,181,1115,PG,73,151,197,LAL,.523
17,Stacey Augmon,68,.407,167,0,,0,36,36,8,54,68,.407,167,57,.740,77,55,7,663,45,83,193,SF,23,31,99,ORL,.407
18,Maurice Baker,0,.000,1,0,,0,1,25,0,1,0,.000,1,0,,0,5,0,19,1,3,0,PG,1,1,2,TOT,.000
19,Vin Baker,13,.317,41,0,.000,1,10,33,4,22,13,.310,42,9,.529,17,27,0,204,17,38,35,PF-C,2,17,39,TOT,.310
20,Marcus Banks,94,.414,227,21,.356,59,155,23,13,97,115,.402,286,121,.742,163,81,2,1145,29,146,372,PG,63,79,126,BOS,.439
21,Leandro Barbosa,117,.544,215,51,.367,139,126,22,7,98,168,.475,354,55,.797,69,63,6,1087,32,127,442,PG,30,87,130,PHO,.547
22,Matt Barnes,57,.442,129,5,.227,22,57,24,7,84,62,.411,151,35,.603,58,43,9,715,49,80,164,SF,30,45,133,SAC,.427
23,Andre Barrett,31,.431,72,14,.269,52,69,22,1,29,45,.363,124,14,.737,19,38,1,483,11,51,118,PG,19,27,40,TOT,.419
24,Brent Barry,94,.525,179,100,.357,280,178,33,20,161,194,.423,459,113,.837,135,81,8,1742,29,123,601,SG,39,64,190,SAS,.532
25,Jon Barry,90,.443,203,71,.430,165,167,35,9,133,161,.438,368,62,.873,71,69,2,1505,26,95,455,SG,60,67,159,TOT,.534
26,Tony Battie,163,.468,348,0,.000,6,42,28,81,343,163,.460,354,68,.723,94,81,32,1894,109,244,394,C,30,81,452,ORL,.460
27,Shane Battier,201,.461,436,70,.395,177,126,26,77,255,271,.442,613,180,.789,228,80,72,2516,158,201,792,SG,91,75,413,MEM,.499
28,Lonny Baxter,3,.273,11,0,,0,0,26,0,4,3,.273,11,0,.000,2,4,0,36,4,10,6,PF,0,4,8,NOH,.273
29,Raja Bell,249,.467,533,54,.403,134,91,28,8,153,303,.454,667,112,.747,150,63,32,1790,48,205,772,SG,44,79,201,UTA,.495
30,Jonathan Bender,15,.429,35,1,.200,5,4,24,2,9,16,.400,40,3,.500,6,7,0,93,5,9,36,SF,1,10,14,IND,.413
31,Travis Best,164,.447,367,26,.306,85,143,32,9,88,190,.420,452,108,.885,122,76,6,1461,19,148,514,PG,66,67,107,NJN,.449
32,Mike Bibby,429,.477,900,131,.360,364,541,26,30,255,560,.443,1264,320,.775,413,80,80,3084,77,191,1571,PG,124,203,332,SAC,.495
33,Andris Biedrins,45,.584,77,0,.000,1,12,18,24,71,45,.577,78,19,.475,40,30,1,384,47,87,109,C,12,12,118,GSW,.577
34,Chauncey Billups,239,.454,526,165,.426,387,464,28,9,223,404,.442,913,343,.898,382,80,80,2866,48,194,1316,PG,81,180,271,DET,.533
35,Steve Blake,25,.269,93,36,.387,93,69,24,0,53,61,.328,186,33,.805,41,44,1,648,18,47,191,PG,13,39,71,WAS,.425
36,Mark Blount,327,.530,617,0,.000,1,129,29,64,254,327,.529,618,117,.713,164,82,57,2130,143,229,771,C,33,158,397,BOS,.529
37,Tony Bobbitt,1,.333,3,1,.500,2,0,25,0,3,2,.400,5,0,,0,2,0,12,0,1,5,SG,0,0,3,LAL,.500
38,Keith Bogans,205,.398,515,57,.329,173,135,24,8,150,262,.381,688,133,.727,183,74,42,1791,76,167,714,SG,68,122,226,CHA,.422
39,Matt Bonner,208,.561,371,39,.424,92,48,24,19,177,247,.533,463,56,.789,71,82,0,1553,108,220,589,C,39,40,285,TOR,.576
40,Calvin Booth,49,.458,107,0,.000,1,8,28,28,78,49,.454,108,26,.813,32,51,1,451,29,78,124,C,15,16,107,TOT,.454
41,Carlos Boozer,361,.522,692,0,.000,1,144,23,24,316,361,.521,693,187,.698,268,51,51,1772,141,179,909,PF,41,137,457,UTA,.521
42,Curtis Borchardt,74,.430,172,0,,0,49,24,32,138,74,.430,172,52,.732,71,67,23,859,86,160,200,C,10,52,224,UTA,.430
43,Chris Bosh,470,.472,995,3,.300,10,153,20,113,524,473,.471,1005,412,.760,542,81,81,3017,194,226,1361,PF,76,187,718,TOR,.472
44,Bruce Bowen,149,.432,345,102,.403,253,126,33,39,235,251,.420,598,71,.634,112,82,82,2627,50,175,675,SF,55,57,285,SAS,.505
45,Ryan Bowen,44,.419,105,3,.500,6,18,29,5,55,47,.423,111,14,.667,21,66,6,604,21,61,111,SF,23,7,76,HOU,.437
46,Earl Boykins,284,.432,658,56,.337,166,372,28,12,106,340,.413,824,279,.921,303,82,5,2162,37,122,1015,PG,78,121,143,DEN,.447
47,Michael Bradley,15,.652,23,0,.000,1,5,25,2,20,15,.625,24,3,.375,8,18,0,119,8,12,33,PF,1,5,28,TOT,.625
48,Shawn Bradley,84,.452,186,0,,0,15,32,63,144,84,.452,186,43,.683,63,77,14,885,70,153,211,C,25,33,214,DAL,.452
49,Torraye Braggs,3,.429,7,0,,0,0,28,0,5,3,.429,7,0,,0,7,0,24,7,4,6,PF,0,2,12,HOU,.429
50,Elton Brand,629,.504,1248,0,.000,3,208,25,169,474,629,.503,1251,364,.752,484,81,81,3001,296,240,1622,PF,62,183,770,LAC,.503
51,Jamison Brewer,8,.364,22,3,.200,15,12,24,1,16,11,.297,37,6,.462,13,18,0,185,6,11,31,PG,8,13,22,NYK,.338
52,Primoz Brezec,387,.512,756,0,,0,86,25,55,305,387,.512,756,164,.745,220,72,72,2276,226,183,938,C,33,106,531,CHA,.512
53,Damone Brown,19,.373,51,4,.364,11,14,25,6,18,23,.371,62,4,.444,9,14,0,152,10,17,54,SF,1,15,28,WAS,.403
54,Devin Brown,128,.444,288,45,.372,121,92,26,12,139,173,.423,409,103,.792,130,67,0,1238,37,83,494,SG,39,53,176,SAS,.478
55,Kedrick Brown,2,.667,3,0,.000,3,4,23,1,10,2,.333,6,8,.800,10,8,0,55,1,4,12,SF,3,5,11,PHI,.333
56,Kwame Brown,109,.460,237,0,,0,39,22,15,134,109,.460,237,74,.574,129,42,14,908,72,112,292,PF,25,67,206,WAS,.460
57,P.J. Brown,338,.446,758,0,,0,178,35,50,471,338,.446,758,210,.864,243,82,78,2817,266,233,886,PF,74,101,737,NOH,.446
58,Tierre Brown,98,.355,276,26,.361,72,155,25,1,72,124,.356,348,59,.787,75,76,0,1066,21,59,333,PG,32,74,93,LAL,.394
59,Rick Brunson,118,.378,312,48,.369,130,410,32,7,164,166,.376,442,57,.770,74,80,39,1945,23,106,437,PG,82,125,187,LAC,.430
60,Kobe Bryant,442,.472,937,131,.339,387,398,26,53,297,573,.433,1324,542,.816,664,66,66,2689,95,174,1819,SG,86,270,392,LAL,.482
61,Greg Buckner,111,.610,182,49,.405,121,133,28,6,142,160,.528,303,63,.778,81,70,41,1522,66,169,432,SG,75,49,208,DEN,.609
62,Rodney Buford,153,.402,381,34,.315,108,63,27,4,156,187,.382,489,37,.822,45,64,17,1313,33,101,445,SF,40,35,189,NJN,.417
63,Antonio Burks,25,.510,49,3,.273,11,28,24,1,11,28,.467,60,14,.737,19,24,0,219,1,25,73,PG,13,12,12,MEM,.492
64,Caron Butler,403,.465,866,38,.304,125,146,24,23,304,441,.445,991,275,.862,319,77,77,2746,146,213,1195,SF,110,125,450,LAL,.464
65,Jackie Butler,4,1.000,4,0,,0,0,19,0,0,4,1.000,4,2,1.000,2,3,0,5,0,0,10,C,1,1,0,NYK,1.000
66,Rasual Butler,106,.414,256,57,.373,153,62,25,29,136,163,.399,409,37,.771,48,65,15,1203,15,104,420,SF,18,37,151,MIA,.468
67,Zarko Cabarkapa,73,.518,141,13,.361,36,25,23,5,67,86,.486,177,53,.815,65,40,0,475,35,59,238,PF,10,30,102,TOT,.523
68,Marcus Camby,279,.468,596,0,.000,4,152,30,199,530,279,.465,600,125,.723,173,66,66,2015,131,177,683,C,61,103,661,DEN,.465
69,Elden Campbell,39,.322,121,0,.000,2,19,36,7,65,39,.317,123,42,.764,55,40,1,390,28,57,120,C,8,29,93,TOT,.317
70,Brian Cardinal,116,.378,307,44,.352,125,114,27,19,162,160,.370,432,158,.873,181,58,16,1433,63,172,522,PF,88,83,225,MEM,.421
71,Geno Carlisle,2,.667,3,0,,0,1,28,0,0,2,.667,3,4,.667,6,6,0,16,1,1,8,SG,0,1,1,POR,.667
72,Matt Carroll,57,.404,141,13,.333,39,17,24,2,47,70,.389,180,71,.855,83,25,0,430,13,37,224,SG,17,25,60,CHA,.425
73,Anthony Carter,70,.438,160,2,.118,17,161,29,18,57,72,.407,177,35,.686,51,66,12,742,12,88,181,PG,35,62,69,MIN,.412
74,Vince Carter,569,.463,1228,127,.406,313,327,28,48,295,696,.452,1541,367,.798,460,77,76,2828,106,243,1886,SF-SG,109,168,401,TOT,.493
75,Sam Cassell,292,.500,584,27,.262,103,301,35,14,132,319,.464,687,134,.865,155,59,38,1522,25,160,799,PG,36,109,157,MIN,.484
76,Kelvin Cato,160,.539,297,0,,0,40,30,82,314,160,.539,297,112,.783,143,62,50,1525,102,170,432,C,55,64,416,ORL,.539
77,Lionel Chalmers,30,.395,76,12,.245,49,51,24,0,27,42,.336,125,15,.625,24,36,0,433,4,30,111,PG,13,24,31,LAC,.384
78,Tyson Chandler,207,.496,417,0,.000,2,65,22,141,514,207,.494,419,226,.673,336,80,10,2189,261,268,640,C,69,118,775,CHI,.494
79,Calbert Cheaney,113,.431,262,0,.000,3,64,33,15,92,113,.426,265,24,.649,37,55,5,951,32,95,250,SG,17,35,124,GSW,.426
80,Josh Childress,289,.493,586,13,.232,56,151,21,35,287,302,.470,642,190,.823,231,80,44,2376,195,184,807,SG,74,106,482,ATL,.481
81,Doug Christie,115,.426,270,15,.242,62,199,34,18,139,130,.392,332,70,.897,78,52,44,1525,38,106,345,SG,80,104,177,TOT,.414
82,Speedy Claxton,246,.447,550,11,.180,61,374,26,8,147,257,.421,611,187,.736,254,62,47,1866,37,184,712,PG,109,119,184,TOT,.430
83,Mateen Cleaves,5,.417,12,0,.000,2,7,27,0,4,5,.357,14,3,.750,4,14,0,65,2,2,13,PG,2,2,6,SEA,.357
84,Derrick Coleman,3,.250,12,0,.000,2,0,37,0,12,3,.214,14,3,1.000,3,5,0,50,3,6,9,C,0,2,15,DET,.214
85,Jason Collier,168,.464,362,6,.429,14,18,27,13,100,174,.463,376,48,.676,71,70,44,942,84,147,402,C,15,63,184,ATL,.471
86,Jarron Collins,65,.417,156,0,.000,1,61,26,6,107,65,.414,157,83,.697,119,50,38,961,57,146,213,C,11,34,164,UTA,.414
87,Jason Collins,184,.413,445,2,.333,6,105,26,71,335,186,.412,451,137,.656,209,80,80,2542,153,322,511,C,71,91,488,NJN,.415
88,Nick Collison,190,.541,351,0,.000,3,32,24,50,220,190,.537,354,83,.703,118,82,4,1396,156,252,463,C,34,62,376,SEA,.537
89,Brian Cook,98,.439,223,78,.392,199,35,24,26,153,176,.417,422,28,.757,37,72,0,1087,63,139,458,C,23,29,216,LAL,.509
90,Omar Cook,10,.500,20,0,.000,4,22,23,1,5,10,.417,24,3,.500,6,5,0,74,2,6,23,PG,6,6,7,TOR,.417
91,Jamal Crawford,252,.431,585,185,.361,512,302,24,19,170,437,.398,1097,182,.843,216,70,67,2688,33,135,1241,SG,92,148,203,NYK,.483
92,Austin Croshere,143,.443,323,45,.259,174,98,29,17,272,188,.378,497,226,.883,256,73,22,1827,103,154,647,PF,48,104,375,IND,.424
93,Eddy Curry,393,.538,730,0,,0,37,22,58,222,393,.538,730,226,.720,314,63,60,1808,116,202,1012,C,21,163,338,CHI,.538
94,Michael Curry,13,.448,29,0,,0,15,36,4,19,13,.448,29,4,.500,8,18,7,249,8,39,30,SF,5,5,27,IND,.448
95,Samuel Dalembert,250,.524,477,0,,0,35,23,121,355,250,.524,477,89,.601,148,72,60,1785,187,241,589,C,46,114,542,PHI,.524
96,Erick Dampier,202,.555,364,0,.000,3,51,29,80,318,202,.550,367,138,.605,228,59,56,1609,183,205,542,C,15,102,501,DAL,.550
97,Antonio Daniels,224,.489,458,49,.297,165,309,29,3,149,273,.438,623,248,.816,304,75,2,2026,20,78,843,PG,51,78,169,SEA,.478
98,Erik Daniels,5,.313,16,1,.500,2,4,22,0,11,6,.333,18,0,,0,21,0,72,7,7,13,SF,2,6,18,SAC,.361
99,Marquis Daniels,213,.454,469,7,.200,35,128,24,14,129,220,.437,504,98,.737,133,60,17,1412,87,124,545,SG,83,86,216,DAL,.443
100,Antonio Davis,193,.461,419,0,,0,80,36,41,276,193,.461,419,115,.757,152,72,62,1843,152,147,501,PF,27,96,428,CHI,.461
101,Baron Davis,173,.435,398,118,.333,354,362,25,14,143,291,.387,752,185,.761,243,46,32,1581,32,126,885,PG,81,131,175,TOT,.465
102,Dale Davis,112,.479,234,0,,0,47,35,65,223,112,.479,234,60,.606,99,61,28,1307,152,162,284,C,32,43,375,TOT,.479
103,Josh Davis,23,.397,58,19,.358,53,12,24,4,50,42,.378,111,14,.824,17,42,5,328,29,45,117,PF,8,15,79,PHI,.464
104,Ricky Davis,420,.488,861,61,.339,180,246,25,27,183,481,.462,1041,286,.815,351,82,11,2696,66,174,1309,SG,89,205,249,BOS,.491
105,Andrew DeClercq,4,.444,9,0,,0,0,31,0,3,4,.444,9,1,.333,3,8,0,49,7,14,9,C,2,1,10,ORL,.444
106,Carlos Delfino,33,.402,82,9,.257,35,38,22,6,42,42,.359,117,23,.575,40,30,4,459,13,44,116,SG,22,23,55,DET,.397
107,Tony Delk,174,.447,389,72,.356,202,104,31,3,102,246,.416,591,103,.757,136,56,1,1340,28,123,667,SG,47,54,130,ATL,.477
108,Luol Deng,249,.472,528,31,.265,117,135,19,27,230,280,.434,645,120,.741,162,61,45,1663,92,98,711,SF,48,118,322,CHI,.458
109,Boris Diaw,115,.471,244,9,.180,50,149,22,18,116,124,.422,294,57,.740,77,66,25,1201,54,123,314,SG,37,87,170,ATL,.437
110,Dan Dickau,221,.432,511,85,.347,245,347,26,4,146,306,.405,756,190,.833,228,71,46,2090,34,201,887,PG,76,145,180,TOT,.461
111,Kaniel Dickens,1,.200,5,3,.333,9,1,26,1,6,4,.286,14,2,1.000,2,11,0,61,3,5,13,SF,2,2,9,NJN,.393
112,DeSagana Diop,20,.299,67,0,.000,2,15,23,27,40,20,.290,69,0,.000,5,39,0,306,30,53,40,C,8,12,70,CLE,.290
113,Vlade Divac,13,.419,31,0,,0,19,36,1,14,13,.419,31,8,.667,12,15,0,130,18,25,34,C,4,14,32,LAL,.419
114,Juan Dixon,138,.460,300,48,.327,147,111,26,4,87,186,.416,447,87,.897,97,63,4,1054,32,98,507,SG,43,68,119,WAS,.470
115,Michael Doleac,148,.450,329,0,.000,2,47,27,22,185,148,.447,331,25,.610,41,80,8,1175,74,160,321,C,23,36,259,MIA,.447
116,Keyon Dooling,120,.444,270,19,.253,75,132,24,11,79,139,.403,345,85,.780,109,74,0,1184,11,120,382,PG,39,65,90,MIA,.430
117,Predrag Drobnjak,213,.451,472,25,.352,71,49,29,24,165,238,.438,543,96,.800,120,71,1,1435,73,138,597,C,42,78,238,ATL,.461
118,Chris Duhon,78,.350,223,94,.355,265,398,22,3,190,172,.352,488,49,.731,67,82,73,2177,23,205,487,PG,82,119,213,CHI,.449
119,Tim Duncan,514,.498,1033,3,.333,9,179,28,174,530,517,.496,1042,305,.670,455,66,66,2203,202,144,1342,PF,45,127,732,SAS,.498
120,Mike Dunleavy,301,.479,629,107,.388,276,203,24,26,338,408,.451,905,134,.779,172,79,79,2570,97,198,1057,SF,79,132,435,GSW,.510
121,Ronald Dupree,60,.480,125,1,.500,2,24,24,10,61,61,.480,127,29,.617,47,47,0,472,34,60,152,SF,7,22,95,DET,.484
122,Ndudi Ebi,11,.550,20,0,.000,1,1,20,1,10,11,.524,21,5,.556,9,2,0,54,6,7,27,SG,1,3,16,MIN,.524
123,Corsley Edwards,10,.323,31,0,,0,3,25,4,13,10,.323,31,7,.583,12,10,0,110,12,19,27,C,3,2,25,NOH,.323
124,John Edwards,11,.367,30,0,,0,3,23,4,11,11,.367,30,7,.500,14,25,1,139,8,12,29,C,3,8,19,IND,.367
125,Howard Eisley,134,.444,302,27,.262,103,250,32,9,75,161,.398,405,66,.795,83,74,1,1428,15,156,415,PG,45,111,90,UTA,.431
126,Obinna Ekezie,79,.436,181,0,.000,1,11,29,12,110,79,.434,182,72,.774,93,42,31,732,69,129,230,C,22,45,179,ATL,.434
127,Francisco Elson,100,.469,213,1,.333,3,34,28,41,140,101,.468,216,45,.570,79,67,11,939,61,129,248,C,34,40,201,DEN,.470
128,Melvin Ely,227,.432,526,0,,0,76,26,69,184,227,.432,526,122,.575,212,79,17,1649,142,199,576,PF,32,115,326,CHA,.432
129,Andre Emmett,2,.333,6,0,,0,0,22,0,2,2,.333,6,3,.600,5,8,0,28,0,4,7,SG,0,1,2,MEM,.333
130,Maurice Evans,138,.474,291,27,.329,82,45,26,8,113,165,.442,373,59,.756,78,65,11,1233,88,104,416,SG,37,34,201,SAC,.479
131,Reggie Evans,131,.480,273,0,.000,2,58,24,15,482,131,.476,275,125,.534,234,79,79,1881,254,202,387,PF,58,104,736,SEA,.476
132,Michael Finley,271,.436,622,116,.407,285,169,31,18,217,387,.427,907,113,.831,136,64,64,2358,45,123,1003,SG,48,60,262,DAL,.491
133,Derek Fisher,189,.407,464,108,.371,291,301,30,4,180,297,.393,755,175,.862,203,74,32,2222,38,176,877,PG,76,129,218,GSW,.465
134,Marcus Fizer,133,.465,286,0,.000,6,64,26,13,146,133,.455,292,70,.680,103,54,0,903,29,96,336,PF,25,63,175,MIL,.455
135,Luis Flores,9,.474,19,5,.500,10,11,23,0,2,14,.483,29,2,1.000,2,16,0,77,1,9,35,PG,2,11,3,TOT,.569
136,Danny Fortson,118,.522,226,0,,0,8,28,7,191,118,.522,226,227,.880,258,62,0,1047,157,265,463,C,15,91,348,SEA,.522
137,Jeff Foster,168,.527,319,0,.000,5,43,28,12,345,168,.519,324,90,.634,142,61,43,1594,205,186,426,C,46,55,550,IND,.519
138,Tremaine Fowlkes,8,.571,14,1,.333,3,0,28,0,5,9,.529,17,0,.000,2,8,0,56,3,7,19,SF,2,5,8,IND,.559
139,Adonal Foyle,156,.502,311,0,,0,56,29,159,264,156,.502,311,40,.556,72,78,50,1700,165,201,352,C,26,58,429,GSW,.502
140,Richie Frahm,25,.417,60,31,.388,80,30,27,4,44,56,.400,140,21,.840,25,43,0,499,17,35,164,SG,15,14,61,POR,.511
141,Steve Francis,525,.436,1203,38,.299,127,547,27,28,324,563,.423,1330,499,.823,606,78,78,2978,126,273,1663,PG,112,317,450,ORL,.438
142,Matt Freije,23,.315,73,14,.259,54,20,23,2,45,37,.291,127,5,.625,8,23,11,441,16,40,93,PF,13,17,61,NOH,.346
143,Lawrence Funderburke,3,.500,6,0,,0,0,34,0,2,3,.500,6,3,.600,5,2,0,21,1,2,9,PF,0,0,3,CHI,.500
144,Dan Gadzuric,243,.539,451,0,,0,30,26,106,413,243,.539,451,107,.538,199,81,81,1783,261,224,593,C,47,81,674,MIL,.539
145,Reece Gaines,13,.361,36,4,.286,14,7,24,1,13,17,.340,50,3,.750,4,21,0,187,1,17,41,PG,5,7,14,TOT,.380
146,Alex Garcia,13,.382,34,5,.278,18,18,24,1,8,18,.346,52,3,.750,4,8,3,146,7,15,44,SG,4,8,15,NOH,.394
147,Kevin Garnett,677,.507,1335,6,.240,25,466,28,112,861,683,.502,1360,445,.811,549,82,82,3121,247,207,1817,PF,121,222,1108,MIN,.504
148,Pat Garrity,74,.465,159,49,.333,147,30,28,9,103,123,.402,306,29,.879,33,71,0,955,21,107,324,PF,19,30,124,ORL,.482
149,Pau Gasol,356,.517,689,1,.167,6,135,24,93,280,357,.514,695,282,.768,367,56,53,1790,130,146,997,PF,37,137,410,MEM,.514
150,Devean George,16,.348,46,21,.362,58,14,27,2,40,37,.356,104,15,.750,20,15,3,306,13,32,110,SF,8,12,53,LAL,.457
151,Eddie Gill,45,.360,125,36,.308,117,83,26,5,96,81,.335,242,71,.877,81,73,3,1021,16,105,269,PG,59,60,112,IND,.409
152,Kendall Gill,29,.408,71,3,.333,9,27,36,4,26,32,.400,80,18,.900,20,14,0,284,11,37,85,SG,14,9,37,MIL,.419
153,Manu Ginobili,270,.517,522,97,.376,258,288,27,27,254,367,.471,780,355,.803,442,74,74,2193,75,190,1186,SG,119,172,329,SAS,.533
154,Gordan Giricek,245,.465,527,38,.362,105,137,27,11,157,283,.448,632,111,.810,137,81,44,1660,25,155,715,SG,46,90,182,UTA,.478
155,Dion Glover,7,.500,14,1,.125,8,4,26,3,8,8,.364,22,8,.800,10,7,0,68,3,9,25,SG,3,2,11,SAS,.386
156,Anthony Goldwire,25,.446,56,32,.400,80,78,33,0,49,57,.419,136,26,.839,31,33,2,537,10,32,172,PG,15,15,59,TOT,.537
157,Drew Gooden,459,.502,915,5,.179,28,130,23,76,546,464,.492,943,251,.810,310,82,80,2523,207,233,1184,PF,77,133,753,CLE,.495
158,Ben Gordon,300,.414,725,134,.405,331,164,21,10,160,434,.411,1056,233,.863,270,82,3,2002,55,224,1235,SG,53,186,215,CHI,.474
159,Brian Grant,103,.493,209,0,,0,34,32,23,156,103,.493,209,57,.722,79,69,8,1136,101,175,263,C,23,43,257,LAL,.493
160,Willie Green,125,.393,318,30,.286,105,100,23,6,111,155,.366,423,97,.776,125,57,21,1066,22,121,437,SG,34,75,133,PHI,.402
161,Adrian Griffin,56,.368,152,2,.222,9,53,30,4,94,58,.360,161,33,.750,44,69,1,667,52,78,151,SF,43,30,146,CHI,.366
162,Eddie Griffin,135,.425,318,67,.328,204,53,22,118,325,202,.387,522,56,.718,78,70,0,1492,128,120,527,PF,23,55,453,MIN,.451
163,Tom Gugliotta,91,.423,215,8,.308,26,68,35,17,135,99,.411,241,33,.767,43,47,9,966,56,104,239,PF,41,57,191,TOT,.427
164,Marcus Haislip,13,.351,37,0,.000,1,3,24,2,10,13,.342,38,6,.545,11,9,0,106,5,15,32,PF,2,6,15,IND,.342
165,Darvin Ham,17,.459,37,0,,0,5,31,7,16,17,.459,37,12,.387,31,47,0,275,19,39,46,SF,6,8,35,DET,.459
166,Richard Hamilton,474,.455,1042,36,.305,118,372,26,13,221,510,.440,1160,368,.858,429,76,76,2926,74,232,1424,SG,77,217,295,DET,.455
167,Zendon Hamilton,11,.344,32,0,,0,6,29,2,24,11,.344,32,29,.604,48,16,0,159,18,26,51,C,5,12,42,MIL,.344
168,Ben Handlogten,43,.524,82,0,.000,1,13,31,5,42,43,.518,83,9,.529,17,21,5,297,23,55,95,C,7,18,65,UTA,.518
169,Anfernee Hardaway,95,.452,210,15,.300,50,74,33,3,70,110,.423,260,34,.739,46,37,0,894,19,79,269,SF,28,50,89,NYK,.452
170,Matt Harpring,409,.504,812,9,.209,43,142,28,16,284,418,.489,855,245,.778,315,78,55,2584,196,250,1090,SF,70,133,480,UTA,.494
171,Al Harrington,437,.479,912,16,.216,74,208,24,16,316,453,.459,986,236,.672,351,66,66,2550,145,249,1158,SF,85,204,461,ATL,.468
172,Junior Harrington,58,.365,159,6,.316,19,62,24,5,50,64,.360,178,29,.829,35,29,7,550,13,72,163,SG,25,41,63,NOH,.376
173,Othella Harrington,217,.512,424,0,,0,56,31,18,186,217,.512,424,127,.718,177,70,28,1271,106,188,561,PF,24,84,292,CHI,.512
174,Devin Harris,113,.481,235,44,.336,131,169,21,19,74,157,.429,366,78,.757,103,76,19,1173,28,139,436,PG,77,82,102,DAL,.489
175,Lucious Harris,97,.415,234,21,.323,65,49,34,6,82,118,.395,299,56,.812,69,73,4,1128,39,68,313,SG,27,29,121,CLE,.430
176,David Harrison,106,.576,184,0,,0,13,22,55,87,106,.576,184,52,.571,91,43,14,760,48,134,264,C,16,53,135,IND,.576
177,Jason Hart,222,.464,478,35,.368,95,367,26,14,185,257,.449,573,157,.785,200,74,27,1887,18,167,706,PG,99,102,203,CHA,.479
178,Donnell Harvey,2,1.000,2,0,,0,1,24,1,5,2,1.000,2,4,1.000,4,3,0,16,2,2,8,PF,1,1,7,NJN,1.000
179,Udonis Haslem,346,.543,637,0,.000,4,108,24,41,487,346,.540,641,178,.791,225,80,80,2675,239,260,870,PF,63,113,726,MIA,.540
180,Trenton Hassell,224,.483,464,1,.091,11,128,25,30,139,225,.474,475,90,.789,114,82,51,2068,80,200,541,SG,30,64,219,MIN,.475
181,Jarvis Hayes,164,.403,407,42,.341,123,90,23,9,186,206,.389,530,99,.839,118,54,22,1560,41,107,553,SF,49,62,227,WAS,.428
182,Brendan Haywood,239,.560,427,0,,0,57,25,114,262,239,.560,427,159,.609,261,68,68,1865,202,218,637,C,52,96,464,WAS,.560
183,Alan Henderson,116,.532,218,0,.000,2,21,32,37,184,116,.527,220,41,.539,76,78,10,1203,164,149,273,PF,29,49,348,DAL,.527
184,Nene Hilario,194,.505,384,0,.000,2,84,22,48,221,194,.503,386,140,.660,212,55,18,1317,104,167,528,C,50,94,325,DEN,.503
185,Grant Hill,514,.513,1002,3,.231,13,220,32,28,241,517,.509,1015,280,.821,341,67,67,2338,77,144,1317,SF,97,161,318,ORL,.511
186,Kirk Hinrich,300,.420,714,145,.355,408,494,24,21,272,445,.397,1122,171,.792,216,77,77,2800,32,244,1206,PG,122,176,304,CHI,.461
187,Fred Hoiberg,69,.496,139,70,.483,145,85,32,15,149,139,.489,284,89,.873,102,76,0,1272,32,105,437,SG,50,20,181,MIN,.613
188,Robert Horry,106,.447,237,51,.370,138,80,34,60,177,157,.419,375,86,.789,109,75,16,1396,91,138,451,PF,67,69,268,SAS,.487
189,Eddie House,121,.450,269,44,.454,97,96,26,6,67,165,.451,366,23,.852,27,68,7,891,16,65,397,PG-SG,44,35,83,TOT,.511
190,Allan Houston,54,.432,125,31,.388,80,42,33,2,19,85,.415,205,36,.837,43,20,11,532,4,40,237,SG,8,21,23,NYK,.490
191,Dwight Howard,352,.521,675,0,.000,2,75,19,136,536,352,.520,677,277,.671,413,82,82,2670,287,232,981,PF,77,165,823,ORL,.520
192,Josh Howard,343,.506,678,34,.296,115,109,24,49,315,377,.475,793,170,.733,232,76,76,2446,169,211,958,SF,116,122,484,DAL,.497
193,Juwan Howard,244,.452,540,0,.000,1,94,31,5,220,244,.451,541,97,.843,115,61,47,1624,126,143,585,PF,32,79,346,HOU,.451
194,Troy Hudson,177,.436,406,89,.345,258,283,28,6,86,266,.401,664,70,.778,90,79,32,1729,19,121,691,PG,27,113,105,MIN,.468
195,Larry Hughes,408,.465,877,59,.282,209,285,26,18,308,467,.430,1086,352,.777,453,61,61,2358,74,168,1345,SG,176,153,382,WAS,.457
196,Ryan Humphrey,42,.416,101,0,.000,2,6,25,1,37,42,.408,103,18,.486,37,35,0,317,50,35,102,SF,10,23,87,MEM,.408
197,Kris Humphries,114,.406,281,2,.333,6,43,19,18,124,116,.404,287,44,.436,101,67,4,873,73,96,278,PF,25,52,197,UTA,.408
198,Brandon Hunter,37,.507,73,0,,0,3,24,7,44,37,.507,73,21,.538,39,31,0,224,25,42,95,PF,4,22,69,ORL,.507
199,Lindsey Hunter,85,.390,218,23,.274,84,130,34,13,85,108,.358,302,46,.793,58,76,3,1144,38,125,285,SG,68,68,123,DET,.396
200,Steven Hunter,135,.616,219,0,.000,1,13,23,102,129,135,.614,220,78,.479,163,76,3,1046,98,131,348,C,4,44,227,PHO,.614
201,Andre Iguodala,222,.550,404,47,.331,142,246,21,48,375,269,.493,546,156,.743,210,82,82,2686,89,204,741,SG,138,139,464,PHI,.536
202,Zydrunas Ilgauskas,456,.469,972,2,.286,7,100,29,165,373,458,.468,979,402,.799,503,78,78,2615,299,313,1320,C,53,191,672,CLE,.469
203,Didier Ilunga-Mbenga,6,.429,14,0,,0,0,24,5,5,6,.429,14,3,.750,4,15,1,58,3,13,15,C,0,5,8,DAL,.429
204,Allen Iverson*,667,.451,1480,104,.308,338,596,29,9,248,771,.424,1818,656,.835,786,75,75,3174,51,140,2302,PG,180,344,299,PHI,.453
205,Royal Ivey,82,.434,189,3,.333,9,103,23,7,65,85,.429,198,47,.701,67,62,5,809,19,140,220,PG,39,58,84,ATL,.437
206,Bobby Jackson,76,.478,159,33,.344,96,59,31,2,62,109,.427,255,50,.862,58,25,0,536,23,58,301,SG,14,28,85,SAC,.492
207,Jermaine Jackson,17,.548,31,0,.000,2,24,28,1,20,17,.515,33,8,.615,13,21,0,230,3,26,42,SG,7,10,23,NYK,.515
208,Jim Jackson,126,.439,287,122,.414,295,183,34,5,236,248,.426,582,54,.931,58,64,27,1987,33,153,672,SF,35,115,269,TOT,.531
209,Luke Jackson,6,.286,21,4,.667,6,3,23,0,4,10,.370,27,5,.833,6,10,0,43,2,4,29,SF,0,2,6,CLE,.444
210,Marc Jackson,340,.466,729,0,.000,2,81,30,18,222,340,.465,731,289,.828,349,81,23,1976,184,171,969,C,32,131,406,PHI,.465
211,Stephen Jackson,227,.426,533,103,.360,286,119,26,14,206,330,.403,819,190,.830,229,51,49,1806,44,154,953,SF,64,123,250,IND,.466
212,Casey Jacobsen,99,.429,231,66,.373,177,113,23,8,132,165,.404,408,151,.786,192,84,1,1798,35,104,547,SG-SF,33,71,167,TOT,.485
213,Jerome James,174,.512,340,0,.000,2,19,29,111,160,174,.509,342,47,.723,65,80,80,1330,81,279,395,C,23,88,241,SEA,.509
214,LeBron James,687,.499,1376,108,.351,308,577,20,52,477,795,.472,1684,477,.750,636,80,80,3388,111,146,2175,SF,177,262,588,CLE,.504
215,Mike James,231,.470,492,100,.386,259,263,29,6,173,331,.441,751,109,.752,145,74,5,1859,35,174,871,PG,65,106,208,TOT,.507
216,Antawn Jamison,448,.457,981,71,.341,208,154,28,16,359,519,.437,1189,225,.760,296,68,68,2605,160,151,1334,PF,55,118,519,WAS,.466
217,Marko Jaric,133,.435,306,56,.371,151,303,26,17,141,189,.414,457,59,.720,82,50,41,1656,20,107,493,PG,84,98,161,LAC,.475
218,Al Jefferson,195,.533,366,0,.000,3,24,20,55,193,195,.528,369,85,.630,135,71,1,1051,119,195,475,PF,22,66,312,BOS,.528
219,Richard Jefferson,208,.438,475,30,.337,89,133,24,17,191,238,.422,564,227,.844,269,33,33,1355,49,109,733,SF,33,132,240,NJN,.449
220,Jared Jeffries,187,.488,383,16,.314,51,151,23,35,222,203,.468,434,101,.584,173,77,71,2007,152,206,523,SF,66,114,374,WAS,.486
221,Horace Jenkins,15,.417,36,0,.000,9,9,30,1,6,15,.333,45,12,.923,13,15,0,104,3,6,42,PG,5,7,9,DET,.333
222,Britton Johnsen,6,.333,18,0,.000,4,4,25,0,5,6,.273,22,0,,0,6,1,87,5,10,12,SF,1,3,10,IND,.273
223,Anthony Johnson,162,.466,348,41,.380,108,302,30,15,147,203,.445,456,85,.752,113,63,36,1747,32,144,532,PG,59,96,179,IND,.490
224,DerMarr Johnson,132,.592,223,53,.358,148,75,24,18,108,185,.499,371,80,.792,101,71,40,1232,43,140,503,SG,43,65,151,DEN,.570
225,Ervin Johnson,27,.509,53,1,1.000,1,6,37,13,70,28,.519,54,16,.640,25,46,23,410,43,86,73,C,7,18,113,MIN,.528
226,Joe Johnson,367,.454,809,177,.478,370,291,23,24,302,544,.461,1179,135,.750,180,82,82,3240,120,167,1400,SF,79,148,422,PHO,.536
227,Linton Johnson,0,.000,1,0,.000,1,0,24,0,3,0,.000,2,0,,0,2,0,15,0,1,0,SF,1,1,3,SAS,.000
228,Dahntay Jones,60,.462,130,23,.383,60,21,24,11,58,83,.437,190,44,.688,64,52,7,649,11,81,233,SG,13,29,69,MEM,.497
229,Damon Jones,106,.517,205,225,.432,521,350,28,5,217,331,.456,726,68,.791,86,82,66,2576,14,121,955,PG,44,98,231,MIA,.611
230,Eddie Jones,209,.477,438,142,.372,382,212,33,38,367,351,.428,820,174,.806,216,80,80,2839,38,251,1018,SF,86,99,405,MIA,.515
231,Fred Jones,188,.450,418,87,.380,229,196,25,31,208,275,.425,647,176,.850,207,77,14,2268,34,171,813,SG,61,114,242,IND,.492
232,James Jones,60,.395,152,66,.398,166,57,24,28,135,126,.396,318,53,.855,62,75,24,1330,39,123,371,SF,31,43,174,IND,.500
233,Jumaine Jones,108,.480,225,102,.391,261,65,25,24,291,210,.432,486,55,.733,75,76,23,1830,107,165,577,SF,44,49,398,LAL,.537
234,Mark Jones,9,.333,27,0,.000,4,6,29,2,7,9,.290,31,5,.500,10,10,0,116,6,16,23,SF,5,3,13,ORL,.290
235,Chris Kaman,246,.498,494,0,.000,1,73,22,68,288,246,.497,495,80,.661,121,63,50,1632,135,182,572,C,26,115,423,LAC,.497
236,Jason Kapono,189,.396,477,80,.412,194,61,23,6,132,269,.401,671,70,.824,85,81,14,1491,32,132,688,SF,40,46,164,CHA,.461
237,Mario Kasun,47,.485,97,0,.000,1,8,24,13,76,47,.480,98,24,.558,43,45,0,356,52,86,118,C,8,26,128,ORL,.480
238,Viktor Khryapa,50,.442,113,4,.364,11,25,22,18,80,54,.435,124,23,.548,42,32,5,523,28,80,135,SF,20,33,108,POR,.452
239,Jason Kidd,211,.425,497,129,.360,358,545,31,9,394,340,.398,855,142,.740,192,66,65,2435,94,110,951,PG,123,167,488,NJN,.473
240,Andrei Kirilenko,184,.536,343,23,.299,77,132,23,136,166,207,.493,420,203,.784,259,41,37,1349,89,101,640,PF,67,90,255,UTA,.520
241,Kerry Kittles,21,.404,52,7,.333,21,20,30,3,31,28,.384,73,6,.600,10,11,0,243,1,12,69,SG,8,7,32,LAC,.432
242,Brandin Knight,0,.000,1,0,,0,1,23,0,0,0,.000,1,0,,0,1,0,3,0,0,0,PG,0,0,0,HOU,.000
243,Brevin Knight,245,.432,567,3,.150,20,591,29,5,149,248,.422,587,167,.852,196,66,61,1944,21,192,666,PG,131,147,170,CHA,.425
244,Kyle Korver,91,.453,201,226,.405,558,182,23,33,339,317,.418,759,82,.854,96,82,57,2667,40,265,942,SF,103,106,379,PHI,.567
245,Nenad Krstic,281,.495,568,0,.000,2,77,21,63,240,281,.493,570,185,.725,255,75,57,1965,161,280,747,PF,32,112,401,NJN,.493
246,Toni Kukoc,63,.450,140,42,.362,116,160,36,13,129,105,.410,256,44,.721,61,53,6,1099,31,70,296,SF,39,64,160,MIL,.492
247,Ibo Kutluay,0,.000,1,0,,0,0,30,0,1,0,.000,1,0,,0,5,0,12,0,1,0,SG,0,2,1,SEA,.000
248,Christian Laettner,106,.599,177,1,.143,7,41,35,15,95,107,.582,184,45,.763,59,49,0,739,36,78,260,PF,32,29,131,MIA,.584
249,Raef LaFrentz,259,.559,463,82,.364,225,98,28,99,399,341,.496,688,120,.811,148,80,80,2196,154,262,884,PF,42,70,553,BOS,.555
250,Maciej Lampe,47,.367,128,2,.500,4,11,19,7,65,49,.371,132,15,.682,22,37,0,380,24,51,115,C,5,17,89,TOT,.379
251,Voshon Lenard,6,.429,14,4,.333,12,6,31,0,6,10,.385,26,5,.625,8,3,1,54,0,2,29,SG,1,2,6,DEN,.462
252,Rashard Lewis,359,.499,719,173,.400,432,94,25,62,278,532,.462,1151,220,.777,283,71,71,2697,110,158,1457,SF,75,123,388,SEA,.537
253,Randy Livingston,17,.386,44,5,.625,8,45,29,2,9,22,.423,52,15,.882,17,17,4,227,3,28,64,PG,12,14,12,UTA,.471
254,Shaun Livingston,89,.418,213,0,.000,2,151,19,11,67,89,.414,215,44,.746,59,30,15,814,22,82,222,PG,32,75,89,LAC,.414
255,Raul Lopez,37,.411,90,20,.444,45,123,24,3,32,57,.422,135,27,.818,33,31,15,518,7,78,161,PG,22,47,39,UTA,.496
256,Tyronn Lue,240,.481,499,55,.355,155,322,27,0,135,295,.451,654,142,.861,165,70,49,2007,14,168,787,PG,33,105,149,TOT,.493
257,George Lynch,57,.375,152,11,.297,37,88,34,12,119,68,.360,189,17,.739,23,44,27,933,55,83,164,SF,32,57,174,NOH,.389
258,Mark Madsen,34,.515,66,0,,0,18,29,14,65,34,.515,66,20,.500,40,41,14,601,63,103,88,C,7,24,128,MIN,.515
259,Corey Maggette,374,.457,818,51,.304,168,225,25,8,324,425,.431,986,563,.857,657,66,60,2436,70,191,1464,SG,70,195,394,LAC,.457
260,Jamaal Magloire,98,.432,227,0,,0,29,26,23,126,98,.432,227,74,.602,123,23,22,703,79,74,270,C,8,59,205,NOH,.432
261,Stephon Marbury,489,.497,983,115,.354,325,668,27,6,198,604,.462,1308,458,.834,549,82,82,3281,50,186,1781,PG,122,233,248,NYK,.506
262,Shawn Marion,499,.526,948,114,.334,341,154,26,119,680,613,.476,1289,229,.833,275,81,81,3146,235,199,1569,PF,163,125,915,PHO,.520
263,Sean Marks,27,.351,77,0,.000,3,8,29,11,38,27,.338,80,22,.786,28,23,0,244,18,29,76,PF,3,14,56,SAS,.338
264,Donyell Marshall,111,.485,229,151,.416,363,81,31,46,333,262,.443,592,72,.791,91,65,2,1645,95,136,747,PF,57,42,428,TOR,.570
265,Darrick Martin,11,.344,32,5,.278,18,28,33,0,7,16,.320,50,5,.625,8,11,0,190,3,19,42,PG,6,6,10,LAC,.370
266,Kenyon Martin,444,.496,895,0,.000,12,170,27,78,365,444,.490,907,199,.646,308,70,67,2272,146,228,1087,PF,100,149,511,DEN,.490
267,Kevin Martin,40,.435,92,5,.200,25,22,21,3,29,45,.385,117,36,.655,55,45,0,455,29,35,131,PG,16,24,58,SAC,.406
268,Desmond Mason,477,.445,1071,1,.125,8,217,27,27,227,478,.443,1079,420,.802,524,80,71,2893,85,198,1377,SF,58,164,312,MIL,.443
269,Tony Massenburg,74,.407,182,0,,0,14,37,20,109,74,.407,182,48,.762,63,61,6,699,54,122,196,PF,18,40,163,SAS,.407
270,Walter McCarty,40,.500,80,55,.355,155,37,30,15,109,95,.404,235,15,.517,29,72,0,906,29,144,260,PF,25,36,138,TOT,.521
271,Jelani McCoy,7,.538,13,0,,0,0,27,8,14,7,.538,13,1,.200,5,10,0,88,7,24,15,C,3,6,21,ATL,.538
272,Antonio McDyess,307,.514,597,0,.000,1,71,30,52,305,307,.513,598,126,.656,192,77,8,1797,177,204,740,PF,46,93,482,DET,.513
273,Tracy McGrady*,573,.468,1225,142,.326,435,448,25,52,413,715,.431,1660,431,.774,557,78,78,3182,71,167,2003,SF,135,201,484,HOU,.473
274,Jeff McInnis,286,.439,651,91,.345,264,391,30,1,125,377,.412,915,130,.813,160,76,69,2651,32,177,975,PG,56,117,157,CLE,.462
275,Aaron McKie,41,.513,80,20,.323,62,103,32,17,152,61,.430,142,10,.625,16,68,3,1118,20,116,152,SG,48,31,172,PHI,.500
276,Keith McLeod,125,.372,336,18,.250,72,236,25,12,93,143,.350,408,112,.767,146,53,47,1382,20,138,416,PG,63,99,113,UTA,.373
277,Stanislav Medvedenko,71,.458,155,0,.000,1,13,25,2,48,71,.455,156,23,.821,28,43,4,423,31,64,165,PF,9,13,79,LAL,.455
278,Ron Mercer,65,.419,155,0,.000,3,20,28,2,31,65,.411,158,7,.700,10,18,3,390,9,20,137,SF,16,14,40,NJN,.411
279,Chris Mihm,280,.509,550,0,.000,2,50,25,108,305,280,.507,552,175,.678,258,75,75,1870,197,237,735,C,14,110,502,LAL,.507
280,Darius Miles,328,.487,674,8,.348,23,129,23,78,228,336,.482,697,129,.600,215,63,22,1699,71,189,809,SF,75,157,299,POR,.488
281,Darko Milicic,25,.329,76,0,,0,7,19,17,40,25,.329,76,17,.708,24,37,2,254,3,31,67,C,2,16,43,DET,.329
282,Andre Miller,421,.492,856,6,.154,39,569,28,8,238,427,.477,895,253,.838,302,82,82,2852,100,204,1113,PG,121,220,338,DEN,.480
283,Anthony Miller,2,.667,3,0,,0,1,33,0,1,2,.667,3,0,,0,2,0,9,0,2,4,PF,1,1,1,ATL,.667
284,Brad Miller,314,.532,590,5,.263,19,220,28,68,382,319,.524,609,233,.812,287,56,56,2089,139,181,876,C,69,82,521,SAC,.528
285,Mike Miller,247,.558,443,140,.433,323,220,24,23,264,387,.505,766,108,.720,150,76,51,2278,36,197,1022,SF,54,127,300,MEM,.597
286,Reggie Miller*,218,.518,421,96,.322,298,146,39,5,138,314,.437,719,250,.933,268,66,66,2105,18,109,974,SG,50,77,156,IND,.503
287,Yao Ming*,538,.552,975,0,,0,61,24,160,461,538,.552,975,389,.783,497,80,80,2447,208,298,1465,C,34,196,669,HOU,.552
288,Cuttino Mobley,258,.437,590,150,.439,342,188,29,30,184,408,.438,932,168,.820,205,66,64,2388,45,152,1134,SG,74,133,229,TOT,.518
289,Nazr Mohammed,289,.481,601,0,.000,1,34,27,86,339,289,.480,602,153,.674,227,77,59,1933,247,236,731,C,58,108,586,TOT,.480
290,Jerome Moiso,9,.529,17,0,.000,1,1,26,6,27,9,.500,18,10,.769,13,20,1,120,10,13,28,C-PF,3,7,37,TOT,.500
291,Mikki Moore,143,.507,282,1,.200,5,47,29,32,149,144,.502,287,107,.787,136,74,4,1178,97,173,396,PF,19,63,246,LAC,.503
292,Alonzo Mourning*,100,.472,212,0,,0,18,34,74,145,100,.472,212,82,.582,141,37,17,702,53,82,282,C-PF,8,57,198,TOT,.472
293,Troy Murphy,333,.417,799,59,.399,148,97,24,33,505,392,.414,947,233,.730,319,70,69,2375,251,190,1076,PF,53,108,756,GSW,.445
294,Lamond Murray,86,.420,205,46,.438,105,47,31,16,120,132,.426,310,61,.763,80,62,1,918,44,85,371,SF,32,54,164,TOR,.500
295,Ronald Murray,107,.399,268,24,.253,95,65,25,11,83,131,.361,363,59,.738,80,49,6,883,15,59,345,SG,30,57,98,SEA,.394
296,Dikembe Mutombo*,108,.498,217,0,,0,10,38,101,276,108,.498,217,106,.741,143,80,2,1212,150,135,322,C,16,51,426,HOU,.498
297,Mamadou N'Diaye,8,.421,19,0,.000,1,1,29,5,9,8,.400,20,4,.571,7,11,0,72,9,20,20,C,1,0,18,LAC,.400
298,Bostjan Nachbar,86,.400,215,75,.383,196,74,24,16,158,161,.392,411,97,.829,117,71,6,1341,24,183,494,PF-SF,29,73,182,TOT,.483
299,Lee Nailon,415,.479,867,0,.000,2,109,29,16,170,415,.478,869,133,.806,165,68,51,2017,128,190,963,SF,36,110,298,NOH,.478
300,Eduardo Najera,139,.462,301,6,.286,21,65,28,24,141,145,.450,322,58,.637,91,68,4,1185,102,148,354,PF,41,61,243,TOT,.460
301,Steve Nash,336,.526,639,94,.431,218,861,30,6,192,430,.502,857,211,.887,238,75,75,2573,57,136,1165,PG,74,245,249,PHO,.557
302,Jameer Nelson,242,.497,487,44,.312,141,237,22,3,141,286,.455,628,73,.682,107,79,21,1612,52,199,689,PG,78,117,193,ORL,.490
303,Rasho Nesterovic,198,.460,430,0,,0,71,28,117,275,198,.460,430,14,.467,30,70,70,1785,184,207,410,C,31,73,459,SAS,.460
304,Ira Newble,163,.439,371,19,.358,53,91,30,18,142,182,.429,424,55,.797,69,74,69,1832,78,144,438,SG,50,61,220,CLE,.452
305,Andres Nocioni,216,.429,504,25,.258,97,122,25,34,317,241,.401,601,170,.766,222,81,38,1892,69,208,677,SF,37,135,386,CHI,.422
306,Moochie Norris,35,.361,97,0,.000,12,39,31,2,36,35,.321,109,20,.833,24,38,0,360,10,44,90,PG,18,27,46,TOT,.321
307,Dirk Nowitzki,572,.470,1217,91,.399,228,240,26,119,661,663,.459,1445,615,.869,708,78,78,3020,96,219,2032,PF,97,176,757,DAL,.490
308,Jermaine O'Neal,385,.454,848,1,.167,6,82,26,88,303,386,.452,854,295,.754,391,44,41,1530,85,173,1068,PF,25,131,388,IND,.453
309,Shaquille O'Neal*,658,.601,1095,0,,0,200,32,171,507,658,.601,1095,353,.461,765,73,73,2492,253,262,1669,C,36,203,760,MIA,.601
310,Lamar Odom,330,.502,657,36,.308,117,238,25,65,519,366,.473,774,207,.695,298,64,64,2320,134,211,975,PF,42,161,653,LAL,.496
311,Emeka Okafor,448,.447,1002,0,.000,1,64,22,125,520,448,.447,1003,209,.609,343,73,73,2600,275,214,1105,PF,62,125,795,CHA,.447
312,Mehmet Okur,337,.486,693,17,.270,63,166,25,68,422,354,.468,756,329,.850,387,82,25,2304,194,227,1054,C,32,141,616,UTA,.479
313,Kevin Ollie,11,.355,31,0,,0,19,32,0,16,11,.355,31,6,.667,9,26,0,158,3,16,28,PG,5,6,19,PHI,.355
314,Michael Olowokandi,161,.456,353,0,,0,29,29,56,218,161,.456,353,46,.667,69,62,34,1215,106,193,368,C,15,68,324,MIN,.456
315,Greg Ostertag,37,.451,82,0,.000,2,37,31,40,112,37,.440,84,13,.342,38,56,3,556,55,88,87,C,7,24,167,SAC,.440
316,Bo Outlaw,12,.353,34,0,,0,13,33,12,37,12,.353,34,5,.556,9,39,0,214,16,29,29,PF,6,8,53,PHO,.353
317,Travis Outlaw,129,.502,257,4,.400,10,35,20,40,81,133,.498,267,49,.653,75,59,2,793,40,77,319,SF,30,39,121,POR,.506
318,Zaza Pachulia,160,.453,353,0,.000,1,60,20,34,247,160,.452,354,138,.746,185,74,4,1397,131,166,458,C,44,70,378,MIL,.452
319,Scott Padgett,48,.449,107,50,.397,126,55,28,10,138,98,.421,233,29,.725,40,66,0,942,47,119,275,PF,33,30,185,HOU,.528
320,Milt Palacio,173,.455,380,2,.167,12,279,26,13,108,175,.446,392,115,.742,155,80,4,1533,26,126,467,PG,48,104,134,TOR,.449
321,Jannero Pargo,59,.401,147,23,.348,66,76,25,1,35,82,.385,213,17,.739,23,32,0,453,12,53,204,PG,16,45,47,CHI,.439
322,Smush Parker,15,.500,30,3,.231,13,15,23,0,8,18,.419,43,9,.692,13,16,1,144,4,16,48,PG,5,19,12,TOT,.453
323,Tony Parker,496,.516,962,43,.276,156,491,22,4,251,539,.482,1118,210,.650,323,80,80,2735,47,167,1331,PG,98,215,298,SAS,.501
324,Ruben Patterson,317,.550,576,2,.080,25,138,29,21,147,319,.531,601,169,.599,282,70,36,1957,126,164,809,SF,106,143,273,POR,.532
325,Sasha Pavlovic,90,.455,198,30,.385,78,49,21,4,56,120,.435,276,44,.688,64,65,9,862,15,121,314,SG,29,47,71,CLE,.489
326,Gary Payton*,297,.498,596,42,.326,129,469,36,12,188,339,.468,725,153,.761,201,77,77,2541,48,121,873,PG,88,148,236,BOS,.497
327,Anthony Peeler,31,.365,85,25,.385,65,57,35,2,51,56,.373,150,16,.889,18,40,0,529,14,39,153,SG,18,28,65,WAS,.457
328,Kirk Penney,1,.500,2,0,.000,1,1,24,0,1,1,.333,3,0,,0,4,0,12,0,0,2,SG,0,2,1,LAC,.333
329,Kendrick Perkins,56,.471,119,0,,0,21,20,37,123,56,.471,119,37,.638,58,60,3,548,53,98,149,C,9,43,176,BOS,.471
330,Wesley Person,66,.482,137,41,.461,89,39,33,4,80,107,.473,226,9,.692,13,41,3,667,3,30,264,SF,19,17,83,TOT,.564
331,Morris Peterson,227,.442,513,129,.385,335,169,27,18,269,356,.420,848,188,.832,226,82,61,2510,71,219,1029,SG,91,93,340,TOR,.496
332,Eric Piatkowski,54,.435,124,57,.425,134,51,34,1,64,111,.430,258,45,.804,56,68,11,841,15,67,324,SG,29,37,79,CHI,.541
333,Paul Pierce,448,.481,931,108,.370,292,348,27,39,461,556,.455,1223,549,.822,668,82,82,2960,78,255,1769,SF,133,230,539,BOS,.499
334,Mickael Pietrus,147,.480,306,67,.344,195,82,22,18,124,214,.427,501,141,.698,202,67,3,1340,65,139,636,SF,46,92,189,GSW,.494
335,Zoran Planinic,63,.470,134,15,.375,40,44,22,0,50,78,.448,174,46,.697,66,43,8,515,19,76,217,PG,25,41,69,NJN,.491
336,Pavel Podkolzin,0,,0,0,,0,0,20,0,2,0,,0,1,.500,2,5,0,10,0,4,1,C,0,2,2,DAL,
337,Scot Pollard,79,.473,167,0,,0,18,29,24,120,79,.473,167,33,.673,49,49,17,865,85,123,191,C,30,31,205,IND,.473
338,Mark Pope,2,.333,6,0,,0,1,32,2,3,2,.333,6,0,,0,9,0,27,5,5,4,PF,1,1,8,DEN,.333
339,James Posey,72,.404,178,55,.309,178,88,28,23,174,127,.357,356,96,.865,111,50,18,1382,45,134,405,SF,48,69,219,MEM,.434
340,Vitaly Potapenko,45,.523,86,0,.000,1,9,29,3,48,45,.517,87,27,.871,31,33,1,335,30,53,117,C,7,12,78,SEA,.517
341,Tayshaun Prince,422,.512,825,47,.341,138,247,24,71,302,469,.487,963,221,.807,274,82,82,3039,133,161,1206,SF,56,135,435,DET,.511
342,Laron Profit,48,.480,100,8,.286,28,37,27,5,52,56,.438,128,16,.640,25,42,4,428,24,44,136,SF,16,27,76,WAS,.469
343,Joel Przybilla,199,.598,333,0,,0,74,25,163,410,199,.598,333,90,.517,174,76,50,1858,178,239,488,C,24,98,588,POR,.598
344,Vladimir Radmanovic,138,.430,321,128,.389,329,86,24,31,237,266,.409,650,81,.786,103,63,0,1856,52,172,741,PF,57,80,289,SEA,.508
345,Aleksandar Radojevic,6,.316,19,0,,0,6,28,2,19,6,.316,19,7,.700,10,12,6,128,9,32,19,C,0,15,28,UTA,.316
346,Peter John Ramos,5,.500,10,0,,0,0,19,1,3,5,.500,10,1,.500,2,6,0,20,1,4,11,C,0,3,4,WAS,.500
347,Zach Randolph,332,.452,735,0,.000,6,86,23,17,300,332,.448,741,207,.815,254,46,37,1603,142,112,871,PF,34,112,442,POR,.448
348,Theo Ratliff,115,.447,257,0,,0,34,31,158,220,115,.447,257,74,.692,107,63,45,1731,111,183,304,C,23,56,331,POR,.447
349,Zeljko Rebraca,133,.568,234,0,,0,26,32,40,135,133,.568,234,73,.859,85,58,2,928,49,130,339,C,13,49,184,LAC,.568
350,Michael Redd,521,.463,1125,104,.355,293,172,25,8,240,625,.441,1418,369,.854,432,75,75,2848,72,152,1723,SG,63,133,312,MIL,.477
351,Justin Reed,15,.577,26,0,.000,3,10,23,1,8,15,.517,29,11,.733,15,23,0,121,8,12,41,SF,3,5,16,BOS,.517
352,Jared Reiner,10,.333,30,0,,0,1,22,7,25,10,.333,30,1,.250,4,19,2,132,13,35,21,C,3,9,38,CHI,.333
353,Jason Richardson,485,.486,998,125,.338,370,281,24,32,299,610,.446,1368,214,.693,309,72,72,2724,125,156,1559,SG,105,169,424,GSW,.492
354,Quentin Richardson,181,.437,414,226,.358,631,158,24,27,388,407,.389,1045,136,.739,184,79,78,2839,91,197,1176,SG,96,102,479,PHO,.498
355,Luke Ridnour,232,.414,561,67,.376,178,483,23,23,149,299,.405,739,159,.883,180,82,82,2571,55,185,824,PG,94,149,204,SEA,.450
356,Bernard Robinson,33,.452,73,3,.375,8,30,24,4,34,36,.444,81,18,.692,26,31,1,328,14,42,93,SG,11,20,48,CHA,.463
357,Clifford Robinson,135,.409,330,67,.347,193,104,38,53,155,202,.386,523,62,.639,97,71,29,1689,54,181,533,C-PF,62,66,209,TOT,.450
358,Glenn Robinson,32,.451,71,2,.333,6,8,32,3,20,34,.442,77,20,.870,23,9,0,157,4,19,90,SF,4,7,24,SAS,.455
359,Rodney Rogers,124,.440,282,48,.286,168,86,33,20,185,172,.382,450,52,.743,70,58,33,1367,61,172,444,SF-PF,41,86,246,TOT,.436
360,Jalen Rose,419,.473,885,108,.394,274,209,32,10,232,527,.455,1159,333,.854,390,81,65,2710,44,190,1495,SF,63,180,276,TOR,.501
361,Malik Rose,197,.457,431,1,.100,10,59,30,16,212,198,.449,441,137,.737,186,76,5,1475,129,208,534,PF,46,102,341,TOT,.450
362,Quinton Ross,160,.434,369,1,.250,4,109,23,22,151,161,.432,373,74,.673,110,78,19,1659,59,165,397,SG,51,54,210,LAC,.433
363,Michael Ruffin,41,.418,98,0,.000,1,64,28,41,175,41,.414,99,29,.433,67,79,7,1262,157,193,111,C,43,44,332,WAS,.414
364,Kareem Rush,106,.394,269,51,.372,137,68,24,7,69,157,.387,406,37,.771,48,48,22,968,20,74,402,SG,20,47,89,TOT,.450
365,Bryon Russell,39,.379,103,56,.376,149,72,34,11,122,95,.377,252,61,.792,77,70,2,1026,50,130,307,SF,44,35,172,DEN,.488
366,John Salmons,54,.454,119,31,.341,91,114,25,13,109,85,.405,210,35,.729,48,58,8,993,12,92,236,SG,40,51,121,PHI,.479
367,Jamal Sampson,28,.452,62,0,,0,8,21,17,86,28,.452,62,23,.590,39,23,0,329,36,53,79,PF,4,17,122,CHA,.452
368,Daniel Santiago,7,.333,21,0,,0,1,28,4,13,7,.333,21,8,.727,11,11,0,105,6,28,22,C,3,4,19,MIL,.333
369,Brian Scalabrine,110,.417,264,22,.324,68,88,26,18,161,132,.398,332,53,.768,69,54,14,1167,83,111,339,PF,34,66,244,NJN,.431
370,Ansu Sesay,15,.441,34,2,.250,8,12,28,3,20,17,.405,42,13,.542,24,16,0,128,18,16,49,SF,2,8,38,GSW,.429
371,Ha Seung-Jin,10,.435,23,0,,0,2,19,5,12,10,.435,23,6,.545,11,19,0,104,6,21,26,C,1,12,18,POR,.435
372,Paul Shirley,5,.455,11,0,,0,3,27,0,1,5,.455,11,2,.500,4,9,0,30,1,3,12,PF,0,1,2,PHO,.455
373,Bobby Simmons,424,.470,902,50,.435,115,205,24,16,318,474,.466,1017,231,.846,273,75,74,2799,128,227,1229,SF,106,135,446,LAC,.491
374,Brian Skinner,104,.510,204,0,.000,1,43,28,49,173,104,.507,205,25,.357,70,49,23,941,107,102,233,C-PF,31,40,280,TOT,.507
375,Tamar Slay,11,.407,27,2,.167,12,3,24,0,8,13,.333,39,0,.000,2,8,0,78,6,20,28,SG,5,8,14,CHA,.359
376,Donta Smith,38,.418,91,6,.273,22,39,21,5,33,44,.389,113,33,.688,48,38,0,433,19,50,127,SG,23,25,52,ATL,.416
377,J.R. Smith,214,.458,467,81,.288,281,142,19,11,113,295,.394,748,111,.689,161,76,56,1859,39,135,782,SG,55,109,152,NOH,.449
378,Jabari Smith,61,.418,146,1,.500,2,38,27,14,82,62,.419,148,41,.745,55,45,2,648,29,103,166,PF,25,39,111,NJN,.422
379,Joe Smith,319,.515,620,0,.000,1,67,29,38,362,319,.514,621,175,.768,228,74,73,2265,179,222,813,PF,43,79,541,MIL,.514
380,Josh Smith,270,.466,579,4,.174,23,127,19,144,310,274,.455,602,163,.688,237,74,59,2050,147,157,715,SF,59,135,457,ATL,.458
381,Steve Smith,61,.427,143,41,.390,105,71,35,7,50,102,.411,248,69,.863,80,50,1,750,15,82,314,SG,14,27,65,TOT,.494
382,Theron Smith,41,.331,124,3,.250,12,28,24,4,77,44,.324,136,14,.875,16,33,5,510,39,58,105,SF,6,27,116,CHA,.335
383,Eric Snow,112,.397,282,13,.289,45,317,31,16,118,125,.382,327,59,.738,80,81,15,1844,37,189,322,SG,67,89,155,CLE,.402
384,Kirk Snyder,92,.379,243,30,.353,85,36,21,19,71,122,.372,328,64,.667,96,68,7,906,50,116,338,SG,26,58,121,UTA,.418
385,Darius Songaila,257,.530,485,0,.000,3,114,26,18,219,257,.527,488,94,.847,111,81,21,1668,125,206,608,PF,51,70,344,SAC,.527
386,Pape Sow,23,.397,58,0,,0,2,23,4,39,23,.397,58,16,.593,27,27,4,255,18,46,62,C,12,10,57,TOR,.397
387,Latrell Sprewell,329,.439,750,69,.327,211,179,34,21,189,398,.414,961,156,.830,188,80,79,2450,65,124,1021,SF,53,127,254,MIN,.450
388,Jerry Stackhouse,242,.446,542,32,.267,120,127,30,10,145,274,.414,662,253,.849,298,56,7,1617,38,104,833,SG,53,106,183,DAL,.438
389,DeShawn Stevenson,149,.415,359,25,.373,67,69,23,9,64,174,.408,426,56,.554,101,55,27,1089,38,73,429,SG,16,57,102,ORL,.438
390,Michael Stewart,11,.524,21,0,,0,5,29,5,19,11,.524,21,3,.429,7,12,1,145,21,32,25,PF,6,6,40,ATL,.524
391,Peja Stojakovic,277,.475,583,174,.402,433,138,27,12,223,451,.444,1016,253,.920,275,66,66,2534,62,157,1329,SF,79,102,285,SAC,.530
392,Awvee Storey,2,.250,8,1,.500,2,1,27,0,1,3,.300,10,1,.500,2,9,0,32,4,3,8,SG,0,0,5,NJN,.350
393,Damon Stoudamire,276,.409,675,181,.369,490,458,31,2,254,457,.392,1165,182,.915,199,81,70,2762,56,158,1277,PG,86,164,310,POR,.470
394,Amar'e Stoudemire,744,.564,1320,3,.188,16,131,22,130,494,747,.559,1336,583,.733,795,80,80,2889,219,278,2080,C,77,189,713,PHO,.560
395,Erick Strickland,93,.421,221,21,.253,83,115,31,1,92,114,.375,304,52,.813,64,62,5,1014,11,103,301,SG,30,64,103,MIL,.410
396,Rod Strickland,8,.195,41,1,.500,2,39,38,2,24,9,.209,43,9,.900,10,16,2,196,3,15,28,PG,3,16,27,HOU,.221
397,Bruno Sundov,10,.294,34,1,.333,3,2,24,2,7,11,.297,37,2,1.000,2,21,0,73,6,16,25,C,2,6,13,NYK,.311
398,Bob Sura,160,.458,349,55,.355,155,317,31,7,258,215,.427,504,141,.750,188,61,59,1922,79,168,626,PG,65,147,337,HOU,.481
399,Mike Sweetney,237,.533,445,0,.000,1,44,22,28,249,237,.531,446,176,.749,235,77,28,1509,169,224,650,C,27,108,418,NYK,.531
400,Robert Swift,5,.455,11,0,,0,2,19,7,4,5,.455,11,5,.556,9,16,0,72,1,16,15,C,1,4,5,SEA,.455
401,Stromile Swift,219,.452,484,0,.000,4,43,25,92,181,219,.449,488,166,.758,219,60,14,1279,92,182,604,PF,41,90,273,MEM,.449
402,Wally Szczerbiak,402,.536,750,63,.373,169,191,27,16,221,465,.506,919,260,.855,304,81,37,2558,82,178,1253,SF,40,132,303,MIN,.540
403,Yuta Tabuse,0,.000,5,1,1.000,1,3,24,0,2,1,.167,6,4,1.000,4,4,0,17,2,1,7,PG,0,1,4,PHO,.250
404,Maurice Taylor,200,.458,437,3,.333,9,67,28,20,190,203,.455,446,63,.612,103,65,16,1336,67,180,472,PF-C,27,94,257,TOT,.459
405,Sebastian Telfair,152,.421,361,17,.246,69,224,19,4,94,169,.393,430,105,.789,133,68,26,1330,10,120,460,PG,35,125,104,POR,.413
406,Jason Terry,269,.540,498,103,.420,245,429,27,15,150,372,.501,743,146,.844,173,80,57,2401,38,177,993,PG,109,147,188,DAL,.570
407,Billy Thomas,17,.447,38,17,.304,56,17,29,1,29,34,.362,94,7,.778,9,25,0,356,7,29,92,SF,14,9,36,NJN,.452
408,Etan Thomas,128,.502,255,0,,0,20,26,51,159,128,.502,255,76,.528,144,47,10,976,85,133,332,C,17,50,244,WAS,.502
409,James Thomas,12,.600,20,0,,0,4,24,4,20,12,.600,20,2,.333,6,11,2,117,17,13,26,PF,4,7,37,TOT,.600
410,John Thomas,42,.488,86,0,,0,17,29,13,58,42,.488,86,27,.587,46,44,8,521,39,82,111,C,15,18,97,MIN,.488
411,Kenny Thomas,366,.472,776,1,.200,5,152,27,17,351,367,.470,781,173,.762,227,73,58,2167,184,227,908,PF,67,131,535,TOT,.471
412,Kurt Thomas,422,.470,897,2,.500,4,160,32,79,661,424,.471,901,66,.786,84,80,80,2855,170,310,916,PF,70,99,831,NYK,.472
413,Tim Thomas,230,.451,510,85,.409,208,110,27,17,192,315,.439,718,136,.786,173,71,68,1940,45,222,851,SF,41,113,237,NYK,.498
414,Jamaal Tinsley,160,.437,366,58,.372,156,257,26,12,134,218,.418,522,122,.744,164,40,40,1301,26,112,616,PG,81,134,160,IND,.473
415,Robert Traylor,177,.453,391,0,.000,8,61,27,50,196,177,.444,399,55,.539,102,74,6,1327,136,215,409,C,54,73,332,CLE,.444
416,Jake Tsakalidis,32,.500,64,0,,0,10,25,16,35,32,.500,64,14,.778,18,31,1,278,21,42,78,C,3,12,56,MEM,.500
417,Nikoloz Tskitishvili,20,.351,57,2,.118,17,10,21,11,29,22,.297,74,4,.571,7,35,0,220,12,33,50,PF,8,19,41,TOT,.311
418,Hedo Turkoglu,235,.438,537,93,.380,245,153,25,18,171,328,.419,782,188,.836,225,67,11,1757,62,140,937,SF,41,119,233,ORL,.479
419,Beno Udrih,115,.464,248,58,.408,142,150,22,10,67,173,.444,390,67,.753,89,80,2,1149,16,96,471,PG,41,77,83,SAS,.518
420,Nick Van Exel,114,.375,304,100,.389,257,227,33,0,141,214,.381,561,58,.784,74,53,34,1619,20,70,586,SG,44,92,161,POR,.471
421,Keith Van Horn,203,.481,422,54,.380,142,75,29,21,205,257,.456,564,128,.815,157,62,16,1502,89,170,696,SF-PF,36,81,294,TOT,.504
422,Anderson Varejao,99,.518,191,0,.000,2,27,22,38,148,99,.513,193,68,.535,127,54,0,863,109,122,266,PF,41,26,257,CLE,.513
423,Jacque Vaughn,141,.455,310,5,.333,15,135,29,1,90,146,.449,325,76,.835,91,71,34,1410,17,138,373,SG,41,62,107,NJN,.457
424,Jake Voskuhl,27,.458,59,0,,0,17,27,11,62,27,.458,59,26,.684,38,38,1,360,30,60,80,C,4,20,92,PHO,.458
425,Jackson Vroman,82,.418,196,0,.000,3,40,23,19,111,82,.412,199,48,.640,75,46,18,705,64,105,212,C-PF,25,64,175,TOT,.412
426,Sasha Vujacic,16,.296,54,17,.270,63,51,20,2,49,33,.282,117,18,.947,19,35,3,403,13,41,101,SG,12,15,62,LAL,.355
427,Dwyane Wade,617,.485,1273,13,.289,45,520,23,82,287,630,.478,1318,581,.762,762,77,77,2974,110,230,1854,SG,121,321,397,MIA,.483
428,Dajuan Wagner,13,.448,29,5,.192,26,13,21,0,2,18,.327,55,3,.750,4,11,0,102,0,15,44,SG,5,9,2,CLE,.373
429,Antoine Walker,471,.455,1036,110,.323,341,265,28,58,513,581,.422,1377,201,.539,373,77,77,2955,182,217,1473,PF,89,253,695,TOT,.462
430,Samaki Walker,11,.355,31,0,,0,4,28,7,10,11,.355,31,2,.667,3,14,0,134,8,25,24,PF,3,8,18,WAS,.355
431,Ben Wallace,294,.458,642,1,.111,9,123,30,176,610,295,.453,651,130,.428,304,74,74,2671,292,159,721,C,106,82,902,DET,.454
432,Gerald Wallace,269,.468,575,17,.274,62,137,22,91,268,286,.449,637,191,.661,289,70,68,2147,118,182,780,SF,117,159,386,CHA,.462
433,Rasheed Wallace,392,.475,826,75,.318,236,142,30,115,470,467,.440,1062,136,.697,195,79,79,2687,174,236,1145,PF,65,127,644,DET,.475
434,Luke Walton,58,.487,119,16,.262,61,93,24,11,87,74,.411,180,34,.708,48,61,5,768,55,70,198,SF,26,58,142,LAL,.456
435,Charlie Ward,8,.308,26,16,.314,51,43,34,0,33,24,.312,77,11,.846,13,14,13,360,6,22,75,PG,15,18,39,HOU,.416
436,Earl Watson,184,.471,391,52,.319,163,359,25,19,129,236,.426,554,91,.659,138,80,14,1808,35,184,615,PG,83,167,164,MEM,.473
437,Clarence Weatherspoon,47,.412,114,0,,0,17,34,6,87,47,.412,114,29,.829,35,40,18,525,35,74,123,PF,9,15,122,HOU,.412
438,Chris Webber,540,.436,1239,15,.341,44,318,31,53,482,555,.433,1283,181,.794,228,67,67,2370,130,214,1306,PF,94,182,612,TOT,.438
439,Bonzi Wells,236,.460,513,36,.346,104,80,28,27,180,272,.441,617,141,.750,188,69,19,1489,49,165,721,SG,85,90,229,MEM,.470
440,Jiri Welsch,115,.441,261,34,.309,110,103,25,5,141,149,.402,371,129,.763,169,71,32,1317,26,121,461,SG-SF,44,73,167,TOT,.447
441,David Wesley,216,.411,525,118,.375,315,265,34,9,190,334,.398,840,162,.857,189,80,79,2774,38,215,948,SG,96,113,228,TOT,.468
442,David West,73,.437,167,2,.400,5,23,24,16,89,75,.436,172,34,.680,50,30,8,552,40,62,186,SF,12,37,129,NOH,.442
443,Delonte West,42,.477,88,24,.358,67,53,21,8,51,66,.426,155,19,.704,27,39,7,507,14,69,175,SG,21,24,65,BOS,.503
444,Jahidi White,14,.452,31,0,,0,1,28,12,23,14,.452,31,14,.350,40,17,0,135,11,31,42,C,2,11,34,CHA,.452
445,Rodney White,97,.424,229,24,.400,60,44,24,11,65,121,.419,289,27,.614,44,58,2,677,24,64,293,SF,32,37,89,TOT,.460
446,Chris Wilcox,169,.514,329,0,,0,38,22,24,165,169,.514,329,88,.611,144,54,25,1005,63,129,426,C,26,77,228,LAC,.514
447,Damien Wilkins,57,.523,109,16,.271,59,26,25,10,37,73,.435,168,21,.618,34,29,7,520,29,55,183,SF,22,16,66,SEA,.482
448,Mike Wilks,27,.443,61,5,.313,16,33,25,1,21,32,.416,77,12,.750,16,48,0,278,4,26,81,PG,14,14,25,SAS,.448
449,Aaron Williams,29,.460,63,0,,0,8,33,8,43,29,.460,63,15,.882,17,42,4,315,17,70,73,C,5,17,60,TOT,.460
450,Eric Williams,114,.444,257,28,.384,73,92,32,4,128,142,.430,330,112,.696,161,55,39,1322,44,147,424,SG,38,60,172,TOT,.473
451,Frank Williams,3,.188,16,0,.000,4,11,24,3,4,3,.150,20,0,,0,9,0,71,2,9,6,SG,2,3,6,CHI,.150
452,Jason Williams,159,.506,314,107,.324,330,399,29,5,103,266,.413,644,80,.792,101,71,68,1952,19,91,719,PG,75,130,122,MEM,.496
453,Jerome Williams,122,.513,238,0,.000,5,41,31,10,168,122,.502,243,115,.669,172,79,4,1211,115,155,359,SF,55,65,283,NYK,.502
454,Mo Williams,291,.456,638,32,.323,99,484,22,11,194,323,.438,737,136,.850,160,80,80,2254,50,221,814,PG,74,196,244,MIL,.460
455,Scott Williams,12,.300,40,0,.000,1,8,36,6,15,12,.293,41,9,.818,11,19,0,152,15,30,33,C,4,5,30,CLE,.293
456,Corliss Williamson,273,.469,582,0,.000,2,78,31,15,155,273,.467,584,195,.799,244,72,9,1527,104,218,741,PF,38,86,259,TOT,.467
457,Kevin Willis,35,.398,88,0,.000,2,9,42,7,47,35,.389,90,17,.739,23,29,5,344,29,53,87,C,8,15,76,ATL,.389
458,Loren Woods,71,.436,163,0,.000,1,17,26,39,139,71,.433,164,34,.576,59,45,30,712,81,78,176,C,8,37,220,TOR,.433
459,Qyntel Woods,5,.417,12,0,,0,0,23,0,4,5,.417,12,0,,0,3,0,40,2,6,10,SF,4,2,6,MIA,.417
460,Metta World Peace,52,.510,102,7,.412,17,22,25,6,37,59,.496,119,47,.922,51,7,7,291,8,27,172,SF,12,17,45,IND,.525
461,Dorell Wright,3,.429,7,0,.000,4,3,19,0,1,3,.273,11,1,1.000,1,3,0,27,0,2,7,SF,4,3,1,MIA,.273
462,Lorenzen Wright,320,.471,680,0,.000,3,87,29,69,436,320,.469,683,131,.662,198,80,77,2287,177,251,771,C,58,100,613,MEM,.469
463,Wang Zhizhi,15,.455,33,2,.667,3,5,27,2,12,17,.472,36,7,.583,12,20,0,92,6,9,43,C,3,5,18,MIA,.500
