,Player_Name,2P,2P%,2PA,3P,3P%,3PA,AST,Age,BLK,DRB,FG,FG%,FGA,FT,FT%,FTA,Games,Games_Strated,Minutes_Played,ORB,PF,PTS,Position,STL,TOV,TRB,Team,eFG%
0,Shareef Abdur-Rahim,327,.536,610,5,.227,22,149,29,42,251,332,.525,632,218,.784,278,72,30,1961,106,227,887,PF,48,108,357,SAC,.529
1,Alex Acker,3,.273,11,1,.200,5,4,23,0,4,4,.250,16,0,,0,5,0,35,1,4,9,SG,1,4,5,DET,.281
2,Malik Allen,120,.488,246,1,1.000,1,20,27,16,96,121,.490,247,23,.605,38,54,20,701,44,92,266,PF,14,34,140,CHI,.492
3,Ray Allen,412,.486,847,269,.412,653,286,30,16,261,681,.454,1500,324,.903,359,78,78,3022,71,151,1955,SG,105,188,332,SEA,.544
4,Tony Allen,118,.492,240,11,.324,34,67,24,18,79,129,.471,274,100,.746,134,51,9,978,32,126,369,PG,51,67,111,BOS,.491
5,Rafer Alston,178,.418,426,102,.327,312,425,29,15,219,280,.379,738,99,.692,143,63,63,2431,36,194,761,PG,101,157,255,HOU,.449
6,Chris Andersen,56,.571,98,0,,0,6,27,41,94,56,.571,98,49,.476,103,32,2,570,61,84,161,C,8,26,155,NOK,.571
7,Alan Anderson,51,.415,123,24,.414,58,32,23,4,47,75,.414,181,33,.805,41,36,7,564,23,48,207,SF,11,32,70,CHA,.481
8,Derek Anderson,68,.402,169,40,.299,134,101,31,6,122,108,.356,303,93,.838,111,43,11,1047,21,98,349,SG,23,54,143,TOT,.422
9,Shandon Anderson,49,.458,107,5,.263,19,30,32,6,63,54,.429,126,13,.722,18,48,1,638,18,75,126,SF,17,24,81,MIA,.448
10,Martynas Andriuskevicius,0,.000,1,0,,0,0,19,0,3,0,.000,1,0,,0,6,0,9,1,1,0,C,2,0,4,CLE,.000
11,Carmelo Anthony,719,.506,1420,37,.243,152,216,21,42,272,756,.481,1572,573,.808,709,80,80,2941,122,229,2122,SF,88,218,394,DEN,.493
12,Rafael Araujo,53,.368,144,0,.000,1,15,25,6,101,53,.366,145,15,.536,28,52,34,601,43,104,121,C,24,42,144,TOR,.366
13,Gilbert Arenas,547,.485,1128,199,.369,540,484,24,25,221,746,.447,1668,655,.820,799,80,80,3384,59,286,2346,PG,161,297,280,WAS,.507
14,Trevor Ariza,92,.416,221,1,.200,5,61,20,11,140,93,.412,226,77,.606,127,57,10,999,78,100,264,SF,57,62,218,TOT,.414
15,Darrell Armstrong,32,.400,80,11,.229,48,86,37,3,63,43,.336,128,33,.786,42,62,2,622,18,71,130,PG,27,58,81,DAL,.379
16,Carlos Arroyo,161,.450,358,7,.350,20,232,26,4,97,168,.444,378,106,.774,137,77,0,1194,33,119,449,PG-SG,38,83,130,TOT,.454
17,Chucky Atkins,129,.431,299,97,.354,274,198,31,2,97,226,.394,573,129,.791,163,71,41,1713,23,152,678,PG-SG,43,87,120,TOT,.479
18,Stacey Augmon,25,.342,73,0,,0,23,37,6,35,25,.342,73,21,.700,30,36,3,385,18,40,71,SF,12,11,53,ORL,.342
19,Vin Baker,7,.467,15,0,,0,4,34,4,17,7,.467,15,13,.722,18,8,1,85,2,13,27,C,4,9,19,LAC,.467
20,Marcus Banks,197,.486,405,22,.349,63,220,24,11,112,219,.468,468,118,.803,147,58,29,1497,23,162,578,PG,54,119,135,TOT,.491
21,Leandro Barbosa,186,.501,371,87,.444,196,158,23,6,119,273,.481,567,111,.755,147,57,11,1592,31,145,744,SG,48,89,150,PHO,.558
22,Matt Barnes,67,.536,125,3,.200,15,28,25,7,73,70,.500,140,32,.681,47,56,5,631,48,100,175,PF-SF,20,30,121,TOT,.511
23,Andre Barrett,36,.400,90,2,.143,14,52,23,0,16,38,.365,104,9,.750,12,19,0,282,9,13,87,PG,10,15,25,TOT,.375
24,Earl Barron,5,.313,16,0,,0,0,24,0,8,5,.313,16,3,.750,4,8,0,45,2,10,13,C,0,5,10,MIA,.313
25,Brent Barry,76,.531,143,80,.396,202,123,34,27,130,156,.452,345,39,.661,59,74,5,1259,29,99,431,SG,39,52,159,SAS,.568
26,Jon Barry,13,.394,33,12,.375,32,26,36,1,30,25,.385,65,24,.828,29,20,0,342,1,25,86,SG,13,22,31,HOU,.477
27,Eddie Basden,14,.467,30,1,.143,7,8,22,2,21,15,.405,37,8,.800,10,19,0,141,7,17,39,SF,9,9,28,CHI,.419
28,Brandon Bass,28,.400,70,0,,0,3,20,7,50,28,.400,70,12,.632,19,29,1,268,18,18,68,PF,3,11,68,NOK,.400
29,Esteban Batista,34,.430,79,0,.000,1,7,22,11,83,34,.425,80,33,.623,53,57,3,495,61,111,101,PF,15,38,144,ATL,.425
30,Tony Battie,280,.513,546,0,.000,6,49,29,69,312,280,.507,552,89,.664,134,82,82,2215,145,250,649,C,46,88,457,ORL,.507
31,Shane Battier,238,.522,456,65,.394,165,136,27,114,265,303,.488,621,147,.707,208,81,81,2839,164,223,818,SF,92,90,429,MEM,.540
32,Lonny Baxter,45,.433,104,0,,0,4,27,8,72,45,.433,104,28,.800,35,41,0,400,45,56,118,C-PF,11,20,117,TOT,.433
33,Charlie Bell,109,.450,242,71,.423,168,130,26,5,99,180,.439,410,63,.708,89,59,6,1283,21,126,494,SG,59,41,120,MIL,.526
34,Raja Bell,228,.471,484,197,.442,446,207,29,22,209,425,.457,930,115,.788,146,79,79,2959,44,248,1162,SG,76,89,253,PHO,.563
35,Jonathan Bender,4,.800,5,0,,0,2,25,1,4,4,.800,5,2,1.000,2,2,0,21,0,2,10,SF,0,0,4,IND,.800
36,Mike Bibby,405,.458,885,192,.386,497,444,27,10,211,597,.432,1382,342,.849,403,82,82,3167,29,169,1728,PG,82,199,240,SAC,.501
37,Andris Biedrins,118,.638,185,0,,0,24,19,47,159,118,.638,185,22,.306,72,68,2,1000,124,190,258,C,23,34,283,GSW,.638
38,Chauncey Billups,239,.407,587,184,.433,425,699,29,8,211,423,.418,1012,465,.894,520,81,81,2925,41,160,1495,PG,71,170,252,DET,.509
39,Steve Blake,130,.455,286,76,.413,184,306,25,5,120,206,.438,470,72,.791,91,68,57,1781,26,107,560,PG,42,83,146,POR,.519
40,Andray Blatche,23,.426,54,3,.231,13,10,19,7,26,26,.388,67,10,.833,12,29,0,175,12,36,65,PF,5,12,38,WAS,.410
41,Mark Blount,373,.508,734,0,,0,99,30,76,269,373,.508,734,168,.757,222,81,55,2240,96,254,914,C,40,194,365,TOT,.508
42,Keith Bogans,150,.436,344,65,.325,200,128,25,9,200,215,.395,544,127,.683,186,72,31,1912,55,167,622,SG-SF,71,90,255,TOT,.455
43,Andrew Bogut,323,.536,603,0,.000,3,192,21,68,384,323,.533,606,122,.629,194,82,77,2348,189,259,768,PF,49,125,573,MIL,.533
44,Matt Bonner,107,.478,224,102,.420,243,56,25,31,198,209,.448,467,63,.829,76,78,6,1710,86,216,583,PF,49,32,284,TOR,.557
45,Calvin Booth,19,.422,45,1,.500,2,12,29,9,33,20,.426,47,5,.556,9,33,2,250,19,44,46,C,9,8,52,WAS,.436
46,Carlos Boozer,219,.549,399,0,,0,88,24,8,212,219,.549,399,99,.723,137,33,19,1025,73,105,537,PF,30,69,285,UTA,.549
47,Chris Bosh,549,.511,1074,0,.000,13,181,21,79,443,549,.505,1087,474,.816,581,70,70,2751,204,209,1572,C,50,157,647,TOR,.505
48,Bruce Bowen,128,.440,291,104,.424,245,126,34,30,285,232,.433,536,51,.607,84,82,82,2755,35,191,619,SF,79,67,320,SAS,.530
49,Ryan Bowen,34,.333,102,3,.136,22,24,30,6,57,37,.298,124,11,.786,14,68,19,652,31,85,88,SF,21,13,88,HOU,.310
50,Earl Boykins,209,.434,482,62,.346,179,230,29,4,60,271,.410,661,152,.874,174,60,0,1542,21,73,756,PG,48,83,81,DEN,.457
51,Michael Bradley,31,.419,74,1,.200,5,17,26,7,67,32,.405,79,2,.667,3,46,1,367,40,39,67,PF,5,19,107,PHI,.411
52,Elton Brand,755,.527,1432,1,.333,3,208,26,201,554,756,.527,1435,440,.775,568,79,79,3099,236,227,1953,PF,81,173,790,LAC,.527
53,Primoz Brezec,409,.518,789,0,.000,2,45,26,32,259,409,.517,791,164,.732,224,79,79,2165,181,227,982,C,19,85,440,CHA,.517
54,Devin Brown,168,.411,409,39,.331,118,104,27,14,134,207,.393,527,158,.745,212,81,14,1711,73,153,611,SG,44,99,207,UTA,.430
55,Kwame Brown,204,.527,387,0,.000,1,72,23,46,291,204,.526,388,128,.545,235,72,49,1978,182,196,536,C,27,100,473,LAL,.526
56,P.J. Brown,269,.461,583,0,,0,90,36,50,365,269,.461,583,139,.827,168,75,73,2380,182,216,677,C,46,90,547,NOK,.461
57,Rick Brunson,16,.390,41,5,.385,13,35,33,1,21,21,.389,54,7,.583,12,27,0,246,1,22,54,PG,8,22,22,TOT,.435
58,Kobe Bryant,798,.482,1655,180,.347,518,360,27,30,354,978,.450,2173,696,.850,819,80,80,3277,71,233,2832,SG,147,250,425,LAL,.491
59,Greg Buckner,95,.546,174,86,.354,243,127,29,20,178,181,.434,417,43,.782,55,73,27,1758,31,180,491,SG,87,52,209,DEN,.537
60,Pat Burke,61,.508,120,2,.286,7,16,32,13,52,63,.496,127,13,.619,21,42,0,346,21,62,141,C,6,33,73,PHO,.504
61,Antonio Burks,50,.362,138,1,.167,6,76,25,0,33,51,.354,144,10,.435,23,57,1,570,4,45,113,PG,20,36,37,MEM,.358
62,Kevin Burleson,12,.353,34,10,.185,54,48,26,2,22,22,.250,88,16,.941,17,39,1,340,4,63,70,PG,26,25,26,CHA,.307
63,Caron Butler,453,.469,966,41,.342,120,186,25,18,352,494,.455,1086,289,.870,332,75,54,2708,114,238,1318,SF,127,175,466,WAS,.474
64,Jackie Butler,117,.544,215,0,,0,25,20,31,116,117,.544,215,58,.753,77,55,0,740,67,127,292,C,17,62,183,NYK,.544
65,Rasual Butler,165,.422,391,92,.380,242,40,26,45,181,257,.406,633,79,.693,114,79,20,1875,51,142,685,SF,33,65,232,NOK,.479
66,Andrew Bynum,33,.402,82,0,,0,9,18,22,46,33,.402,82,8,.296,27,46,0,338,34,56,74,C,4,17,80,LAL,.402
67,Will Bynum,19,.442,43,2,.222,9,19,23,0,9,21,.404,52,10,.625,16,15,0,162,3,10,54,PG,7,14,12,GSW,.423
68,Zarko Cabarkapa,62,.403,154,5,.250,20,20,24,7,74,67,.385,174,60,.714,84,61,0,505,37,87,199,PF,13,35,111,GSW,.399
69,Jose Calderon,125,.465,269,7,.163,43,288,24,4,111,132,.423,312,78,.848,92,64,11,1487,30,93,349,SG,42,101,141,TOR,.434
70,Marcus Camby,301,.472,638,1,.091,11,115,31,184,536,302,.465,649,111,.712,156,56,54,1857,132,158,716,C,79,92,668,DEN,.466
71,Brian Cardinal,33,.402,82,13,.448,29,33,28,0,44,46,.414,111,19,.704,27,36,0,402,11,65,124,PF,23,27,55,MEM,.473
72,Matt Carroll,120,.412,291,72,.389,185,35,25,11,123,192,.403,476,138,.821,168,78,6,1275,34,120,594,SG,47,48,157,CHA,.479
73,Anthony Carter,49,.402,122,4,.267,15,101,30,9,53,53,.387,137,40,.727,55,45,8,589,9,71,150,PG,24,40,62,MIN,.401
74,Vince Carter,528,.459,1151,125,.341,367,338,29,53,327,653,.430,1518,480,.799,601,79,79,2906,135,235,1911,SG,94,213,462,NJN,.471
75,Sam Cassell,423,.459,922,70,.368,190,491,36,11,247,493,.443,1112,289,.863,335,78,75,2653,40,225,1345,PG,74,175,287,LAC,.475
76,Kelvin Cato,36,.429,84,0,,0,4,31,12,50,36,.429,84,26,.743,35,27,0,333,20,52,98,C,6,18,70,TOT,.429
77,Tyson Chandler,160,.567,282,0,.000,1,81,23,104,449,160,.565,283,97,.503,193,79,50,2121,265,298,417,C,41,123,714,CHI,.565
78,Calbert Cheaney,42,.420,100,0,.000,8,19,34,2,41,42,.389,108,8,1.000,8,42,0,448,20,38,92,SF,13,17,61,GSW,.389
79,Josh Childress,246,.560,439,32,.492,65,131,22,39,253,278,.552,504,154,.766,201,74,10,2249,134,184,742,SF,86,101,387,ATL,.583
80,Doug Christie,9,.360,25,0,.000,1,14,35,1,11,9,.346,26,8,.667,12,7,7,185,2,10,26,SG,9,6,13,DAL,.346
81,Speedy Claxton,287,.426,673,17,.270,63,339,27,6,154,304,.413,736,246,.769,320,71,3,2019,39,177,871,PG,108,154,193,NOK,.425
82,Mateen Cleaves,21,.382,55,4,.250,16,42,28,2,12,25,.352,71,19,.792,24,27,0,230,2,30,73,PG,3,14,14,SEA,.380
83,Jarron Collins,129,.461,280,0,,0,97,27,27,199,129,.461,280,157,.717,219,79,41,1730,134,252,415,C,36,61,333,UTA,.461
84,Jason Collins,101,.404,250,3,.250,12,70,27,40,249,104,.397,262,44,.512,86,71,70,1895,93,251,255,C,46,61,342,NJN,.403
85,Nick Collison,207,.529,391,0,.000,3,74,25,35,225,207,.525,394,79,.699,113,66,27,1448,143,213,493,PF,21,77,368,SEA,.525
86,Brian Cook,225,.527,427,36,.429,84,74,25,32,186,261,.511,511,84,.832,101,81,46,1535,88,205,642,PF,37,61,274,LAL,.546
87,Jamal Crawford,265,.452,586,101,.345,293,301,25,15,212,366,.416,879,295,.826,357,79,27,2555,36,150,1128,SG,87,175,248,NYK,.474
88,Austin Croshere,78,.538,145,54,.386,140,62,30,7,203,132,.463,285,90,.882,102,50,26,1148,62,105,408,PF,22,48,265,IND,.558
89,Eddy Curry,336,.563,597,0,,0,19,23,56,287,336,.563,597,307,.632,486,72,69,1865,145,239,979,C,28,179,432,NYK,.563
90,Samuel Dalembert,196,.533,368,0,.000,1,25,24,160,382,196,.531,369,93,.705,132,66,52,1761,159,244,485,C,34,107,541,PHI,.531
91,Erick Dampier,171,.493,347,0,,0,51,30,106,367,171,.493,347,127,.591,215,82,36,1934,273,263,469,C,27,115,640,DAL,.493
92,Antonio Daniels,207,.461,449,23,.228,101,284,30,8,153,230,.418,550,284,.845,336,80,17,2283,19,96,767,SG,52,89,172,WAS,.439
93,Marquis Daniels,242,.491,493,4,.211,19,172,25,13,143,246,.480,512,138,.754,183,62,29,1766,81,143,634,SG,67,100,224,DAL,.484
94,Antonio Davis,82,.434,189,0,.000,1,21,37,10,118,82,.432,190,52,.642,81,44,39,940,90,125,216,PF-C,23,51,208,TOT,.432
95,Baron Davis,233,.434,537,102,.315,324,480,26,14,191,335,.389,861,195,.675,289,54,48,1971,45,165,967,PG,89,159,236,GSW,.448
96,Dale Davis,9,.391,23,0,.000,1,6,36,9,32,9,.375,24,8,.533,15,28,2,178,21,23,26,C,0,4,53,DET,.375
97,Josh Davis,2,.400,5,0,.000,2,1,25,0,1,2,.286,7,2,.667,3,6,0,17,3,3,6,PF,2,1,4,TOT,.286
98,Ricky Davis,511,.481,1062,73,.302,242,394,26,17,286,584,.448,1304,275,.797,345,78,78,3207,65,190,1516,SG-SF,91,213,351,TOT,.476
99,Carlos Delfino,71,.428,166,20,.333,60,44,23,15,85,91,.403,226,45,.672,67,68,1,726,28,86,247,SG,21,36,113,DET,.447
100,Tony Delk,51,.447,114,20,.426,47,33,32,1,39,71,.441,161,20,.741,27,24,0,385,14,28,182,PG-SG,13,19,53,TOT,.503
101,Luol Deng,421,.481,876,21,.269,78,147,20,50,389,442,.463,954,207,.750,276,78,56,2604,127,128,1112,SF,72,105,516,CHI,.474
102,Boris Diaw,441,.536,823,8,.267,30,503,23,85,399,449,.526,853,174,.731,238,81,70,2874,159,260,1080,PF,58,189,558,PHO,.531
103,Dan Dickau,7,.269,26,10,.500,20,40,27,1,11,17,.370,46,18,1.000,18,19,0,234,5,40,62,PG,11,18,16,BOS,.478
104,Travis Diener,4,.333,12,25,.439,57,16,23,0,17,29,.420,69,5,.833,6,23,0,246,4,22,88,PG,7,10,21,ORL,.601
105,Ike Diogu,175,.524,334,0,,0,29,22,30,134,175,.524,334,136,.810,168,69,14,1031,95,164,486,PF,15,78,229,GSW,.524
106,DeSagana Diop,74,.487,152,1,.500,2,23,24,146,229,75,.487,154,39,.542,72,81,45,1510,145,253,190,C,44,36,374,DAL,.490
107,Juan Dixon,292,.449,651,65,.382,170,149,27,6,147,357,.435,821,156,.804,194,76,42,1920,30,157,935,SG,58,113,177,POR,.474
108,Michael Doleac,37,.420,88,0,,0,8,28,7,62,37,.420,88,24,.800,30,31,3,371,23,45,98,C,10,14,85,MIA,.420
109,Keyon Dooling,165,.456,362,13,.302,43,109,25,4,67,178,.440,405,101,.835,121,50,7,1137,11,116,470,PG,49,82,78,ORL,.456
110,Chris Duhon,115,.442,260,100,.360,278,373,23,3,192,215,.400,538,117,.818,143,74,38,2155,28,152,647,PG,70,117,220,CHI,.493
111,Tim Duncan,572,.485,1180,2,.400,5,253,29,162,650,574,.484,1185,335,.629,533,80,80,2784,231,219,1485,PF,70,198,881,SAS,.485
112,Mike Dunleavy,257,.462,556,74,.285,260,237,25,32,321,331,.406,816,196,.778,252,81,68,2578,78,199,932,SF,60,120,399,GSW,.451
113,Ronald Dupree,33,.532,62,0,.000,1,14,25,0,28,33,.524,63,14,.341,41,36,0,265,21,44,80,SF,12,14,49,MIN,.524
114,John Edwards,31,.484,64,0,,0,5,24,15,30,31,.484,64,8,.727,11,40,4,296,18,76,70,C,3,12,48,ATL,.484
115,Howard Eisley,21,.344,61,13,.310,42,69,33,2,30,34,.330,103,20,.833,24,32,0,394,3,34,101,PG,11,21,33,TOT,.393
116,Monta Ellis,104,.441,236,28,.341,82,78,20,11,83,132,.415,318,42,.712,59,49,3,886,22,69,334,SG,32,58,105,GSW,.459
117,Francisco Elson,150,.538,279,1,.200,5,47,29,45,240,151,.532,284,49,.662,74,72,54,1579,99,211,352,C,54,65,339,DEN,.533
118,Melvin Ely,216,.511,423,0,.000,2,76,27,44,183,216,.508,425,128,.667,192,57,22,1348,94,160,560,PF,29,100,277,CHA,.508
119,Maurice Evans,111,.493,225,43,.371,116,60,27,15,87,154,.452,341,52,.800,65,80,1,1139,76,122,403,SG,41,39,163,DET,.515
120,Reggie Evans,131,.491,267,0,.000,1,38,25,10,331,131,.489,268,115,.530,217,67,25,1393,171,166,377,PF,40,85,502,TOT,.489
121,Daniel Ewing,75,.424,177,22,.282,78,84,22,6,62,97,.380,255,36,.783,46,66,5,971,23,86,252,SG,37,57,85,LAC,.424
122,Noel Felix,5,.227,22,1,.333,3,2,24,3,10,6,.240,25,5,.625,8,12,0,82,3,13,18,SF,2,8,13,SEA,.260
123,Raymond Felton,248,.405,612,97,.358,271,446,21,8,188,345,.391,883,161,.725,222,80,54,2406,77,181,948,PG,102,182,265,CHA,.446
124,Michael Finley,176,.423,416,110,.394,279,116,32,7,216,286,.412,695,98,.852,115,77,18,2038,31,97,780,SG,37,62,247,SAS,.491
125,Derek Fisher,247,.417,592,117,.397,295,352,31,8,175,364,.410,887,244,.833,293,82,36,2589,36,237,1089,PG,125,156,211,GSW,.476
126,Gerald Fitch,23,.365,63,7,.269,26,33,23,5,23,30,.337,89,17,.739,23,18,1,239,7,28,84,PG,7,15,30,MIA,.376
127,Marcus Fizer,8,.500,16,1,1.000,1,1,27,0,6,9,.529,17,1,.500,2,3,0,39,1,5,20,PF,0,2,7,NOK,.559
128,Sharrod Ford,2,.667,3,0,,0,0,24,1,2,2,.667,3,0,,0,3,0,13,1,7,4,PF,0,2,3,PHO,.667
129,T.J. Ford,293,.428,685,35,.337,104,473,22,7,248,328,.416,789,187,.754,248,72,70,2557,63,196,878,PG,104,219,311,MIL,.438
130,Danny Fortson,27,.529,51,0,,0,2,29,2,47,27,.529,51,33,.767,43,23,1,276,31,76,87,C,4,26,78,SEA,.529
131,Jeff Foster,138,.561,246,0,.000,4,50,29,27,350,138,.552,250,96,.604,159,63,37,1581,224,191,372,C,41,64,574,IND,.552
132,Adonal Foyle,152,.507,300,0,,0,33,30,125,281,152,.507,300,41,.612,67,77,72,1824,143,215,345,C,44,80,424,GSW,.507
133,Richie Frahm,16,.533,30,23,.329,70,21,28,2,30,39,.390,100,7,.700,10,33,0,342,3,30,108,SG,4,8,33,TOT,.505
134,Steve Francis,308,.452,682,25,.301,83,345,28,17,216,333,.435,765,314,.787,399,70,60,2393,74,204,1005,PG-SG,74,214,290,TOT,.452
135,Channing Frye,302,.479,631,3,.333,9,53,22,47,236,305,.477,640,189,.825,229,65,14,1572,138,200,802,C,30,97,374,NYK,.479
136,Dan Gadzuric,171,.555,308,0,.000,1,24,27,43,141,171,.553,309,41,.461,89,74,0,885,91,171,383,C,25,35,232,MIL,.553
137,Deng Gai,0,,0,0,,0,0,23,0,0,0,,0,0,,0,2,0,5,0,0,0,C,0,0,0,PHI,
138,Reece Gaines,6,.600,10,0,.000,2,3,25,0,0,6,.500,12,1,.250,4,12,0,54,0,1,13,PG,1,1,0,MIL,.500
139,Francisco Garcia,91,.484,188,39,.285,137,94,24,47,146,130,.400,325,78,.772,101,67,11,1301,39,135,377,SF,41,75,185,SAC,.460
140,Kevin Garnett,618,.532,1161,8,.267,30,308,29,107,752,626,.526,1191,396,.810,489,76,76,2957,214,206,1656,PF,104,180,966,MIN,.529
141,Pat Garrity,51,.451,113,50,.388,129,38,29,9,77,101,.417,242,30,.811,37,57,0,938,31,108,282,PF,12,38,108,ORL,.521
142,Pau Gasol,597,.505,1182,3,.250,12,371,25,153,522,600,.503,1194,425,.689,617,80,80,3135,191,184,1628,PF,46,235,713,MEM,.504
143,Devean George,120,.453,265,50,.313,160,68,28,34,192,170,.400,425,58,.674,86,71,5,1542,82,159,448,SF,66,54,274,LAL,.459
144,Eddie Gill,3,.136,22,7,.304,23,12,27,1,15,10,.222,45,18,.783,23,41,0,122,0,13,45,PG,11,9,15,IND,.300
145,Manu Ginobili,226,.500,452,83,.382,217,235,28,26,188,309,.462,669,280,.778,360,65,56,1813,42,156,981,SG,101,121,230,SAS,.524
146,Gordan Giricek,148,.457,324,18,.305,59,63,28,4,55,166,.433,383,43,.754,57,37,36,956,15,87,393,SG,16,63,70,UTA,.457
147,Anthony Goldwire,1,.200,5,0,.000,2,2,34,0,1,1,.143,7,0,,0,3,0,22,0,0,2,PG,0,1,1,LAC,.143
148,Ryan Gomes,170,.491,346,3,.333,9,58,23,5,196,173,.487,355,112,.752,149,61,33,1376,102,83,461,PF,35,55,298,BOS,.492
149,Drew Gooden,333,.513,649,1,.333,3,56,24,49,428,334,.512,652,176,.682,258,79,79,2174,237,190,845,PF,52,106,665,CLE,.513
150,Ben Gordon,320,.416,770,166,.435,382,240,22,5,176,486,.422,1152,211,.787,268,80,47,2482,43,238,1349,SG,75,180,219,CHI,.494
151,Joey Graham,169,.517,327,29,.333,87,60,23,13,187,198,.478,414,108,.812,133,80,24,1581,57,228,533,SF,37,92,244,TOR,.513
152,Stephen Graham,19,.432,44,2,.200,10,7,23,2,22,21,.389,54,14,.933,15,22,0,175,5,31,58,SG,5,13,27,TOT,.407
153,Danny Granger,191,.496,385,30,.323,93,90,22,62,253,221,.462,478,115,.777,148,78,17,1765,131,211,587,SF,58,80,384,IND,.494
154,Brian Grant,27,.415,65,0,,0,7,33,3,46,27,.415,65,7,.875,8,21,2,248,11,45,61,C,5,7,57,PHO,.415
155,Devin Green,6,.231,26,0,.000,2,7,23,0,14,6,.214,28,13,.619,21,27,0,135,10,13,25,SG,3,5,24,LAL,.214
156,Gerald Green,60,.508,118,6,.300,20,18,20,4,31,66,.478,138,29,.784,37,32,3,374,10,41,167,SG,13,22,41,BOS,.500
157,Willie Green,18,.383,47,10,.526,19,5,24,0,14,28,.424,66,4,.800,5,10,2,153,1,13,70,SG,2,12,15,PHI,.500
158,Orien Greene,91,.427,213,9,.225,40,129,23,10,108,100,.395,253,45,.662,68,80,5,1235,37,181,254,PG,77,109,145,BOS,.413
159,Adrian Griffin,98,.485,202,0,.000,2,89,31,9,152,98,.480,204,41,.774,53,52,45,1245,75,113,237,SG,51,39,227,DAL,.480
160,Eddie Griffin,114,.396,288,16,.195,82,40,23,148,282,130,.351,370,44,.595,74,70,27,1359,107,125,320,C,13,43,389,MIN,.373
161,Anthony Grundy,14,.609,23,5,.333,15,9,26,0,16,19,.500,38,9,.643,14,12,0,108,1,14,52,SG,7,9,17,ATL,.566
162,Richard Hamilton,594,.494,1202,55,.458,120,275,27,16,172,649,.491,1322,256,.845,303,80,80,2825,84,207,1609,SG,52,173,256,DET,.512
163,Zendon Hamilton,7,.500,14,0,,0,0,30,0,8,7,.500,14,12,.667,18,12,0,49,3,5,26,C,4,6,11,TOT,.500
164,Anfernee Hardaway,4,.308,13,0,.000,1,8,34,0,10,4,.286,14,2,1.000,2,4,0,72,0,7,10,SF,2,6,10,NYK,.286
165,Matt Harpring,308,.482,639,14,.359,39,98,29,14,210,322,.475,678,227,.725,313,71,32,1944,158,202,885,SF,59,109,368,UTA,.485
166,Al Harrington,485,.471,1029,66,.346,191,238,25,14,391,551,.452,1220,243,.694,350,76,76,2782,132,301,1411,PF,85,195,523,ATL,.479
167,Othella Harrington,135,.495,273,0,,0,39,32,13,100,135,.495,273,77,.626,123,72,23,824,54,131,347,C,7,61,154,CHI,.495
168,Devin Harris,185,.482,384,5,.238,21,177,22,16,99,190,.469,405,169,.716,236,56,4,1275,26,121,554,PG,53,84,125,DAL,.475
169,David Harrison,148,.503,294,0,,0,14,23,59,170,148,.503,294,89,.511,174,67,17,1034,84,193,385,C,23,79,254,IND,.503
170,Jason Hart,77,.405,190,9,.290,31,70,27,5,59,86,.389,221,37,.661,56,66,0,818,12,85,218,PG,31,43,71,SAC,.410
171,Udonis Haslem,300,.509,589,0,.000,2,95,25,17,467,300,.508,591,157,.789,199,81,80,2491,167,216,757,PF,50,80,634,MIA,.508
172,Trenton Hassell,279,.470,593,7,.304,23,203,26,29,134,286,.464,616,131,.744,176,77,67,2514,82,201,710,SG,43,124,216,MIN,.470
173,Chuck Hayes,59,.567,104,0,.000,1,14,22,14,112,59,.562,105,29,.644,45,40,0,535,67,76,147,PF,26,12,179,HOU,.562
174,Jarvis Hayes,60,.441,136,17,.362,47,27,24,1,57,77,.421,183,25,.833,30,21,13,516,19,38,196,SG,16,22,76,WAS,.467
175,Brendan Haywood,222,.514,432,0,,0,46,26,104,267,222,.514,432,131,.585,224,79,70,1879,200,232,575,C,30,97,467,WAS,.514
176,Luther Head,141,.445,317,113,.361,313,215,23,9,233,254,.403,630,86,.699,123,80,27,2310,33,169,707,SG,89,119,266,HOU,.493
177,Alan Henderson,47,.516,91,0,,0,10,33,12,77,47,.516,91,33,.673,49,51,3,531,60,58,127,C,9,22,137,CLE,.516
178,Nene Hilario,0,.000,1,0,,0,0,23,0,0,0,.000,1,0,,0,1,0,3,0,1,0,PF,0,2,0,DEN,.000
179,Grant Hill,117,.498,235,2,.250,8,48,33,6,65,119,.490,243,78,.765,102,21,17,613,15,50,318,SF,24,35,80,ORL,.494
180,Kirk Hinrich,325,.441,737,126,.370,341,514,25,21,259,451,.418,1078,256,.815,314,81,81,2955,29,251,1284,PG,94,188,288,CHI,.477
181,Julius Hodge,5,.385,13,0,,0,6,22,0,2,5,.385,13,3,.375,8,14,0,33,5,7,13,SG,2,8,7,DEN,.385
182,Randy Holcomb,1,1.000,1,0,,0,0,26,0,0,1,1.000,1,0,,0,4,0,11,1,2,2,SF,0,0,1,CHI,1.000
183,Robert Horry,59,.399,148,53,.368,144,79,35,51,171,112,.384,292,44,.647,68,63,3,1182,71,115,321,PF,43,41,242,SAS,.474
184,Eddie House,197,.445,443,123,.389,316,148,27,12,117,320,.422,759,33,.805,41,81,0,1421,15,96,796,PG,42,76,132,PHO,.503
185,Dwight Howard,468,.532,879,0,.000,2,125,20,115,734,468,.531,881,356,.595,598,82,81,3021,288,277,1292,PF,65,217,1022,ORL,.531
186,Josh Howard,323,.475,680,27,.429,63,111,25,26,248,350,.471,743,196,.734,267,59,58,1915,123,167,923,SF,68,79,371,DAL,.489
187,Juwan Howard,394,.461,855,0,.000,4,112,32,8,367,394,.459,859,154,.806,191,80,80,2537,168,235,942,PF,49,133,535,HOU,.459
188,Troy Hudson,87,.375,232,40,.396,101,106,29,4,36,127,.381,333,48,.923,52,36,0,800,8,55,342,PG,12,40,44,MIN,.441
189,Larry Hughes,164,.417,393,28,.368,76,131,27,21,135,192,.409,469,146,.756,193,36,31,1281,26,117,558,SG,53,99,161,CLE,.439
190,Kris Humphries,77,.389,198,0,.000,5,30,20,16,101,77,.379,203,34,.523,65,62,2,619,56,82,188,PF,23,31,157,UTA,.379
191,Lindsey Hunter,26,.456,57,11,.256,43,62,35,1,30,37,.370,100,2,.500,4,30,1,353,10,44,87,PG,19,20,40,DET,.425
192,Steven Hunter,175,.601,291,0,,0,17,24,76,161,175,.601,291,71,.514,138,69,35,1312,110,120,421,C,12,64,271,PHI,.601
193,Andre Iguodala,288,.543,530,56,.354,158,255,22,21,364,344,.500,688,263,.754,349,82,82,3086,117,198,1007,SF,135,153,481,PHI,.541
194,Zydrunas Ilgauskas,450,.509,884,0,.000,5,91,30,136,346,450,.506,889,317,.834,380,78,78,2283,245,280,1217,C,38,155,591,CLE,.506
195,Didier Ilunga-Mbenga,32,.542,59,0,.000,1,2,25,25,37,32,.533,60,10,.500,20,43,1,237,19,47,74,C,6,16,56,DAL,.533
196,Allen Iverson*,743,.465,1599,72,.323,223,532,30,10,188,815,.447,1822,675,.814,829,72,72,3103,44,121,2377,PG,140,248,232,PHI,.467
197,Royal Ivey,112,.441,254,4,.400,10,74,24,7,65,116,.439,264,24,.727,33,73,66,978,31,147,260,PG,24,23,96,ATL,.447
198,Jarrett Jack,169,.480,352,20,.263,76,219,22,2,142,189,.442,428,128,.800,160,79,4,1599,18,138,526,SG,41,102,160,POR,.465
199,Bobby Jackson,157,.377,416,129,.389,332,195,32,1,179,286,.382,748,107,.733,146,71,15,1775,44,155,808,PG,61,101,223,MEM,.469
200,Jermaine Jackson,10,.455,22,1,.250,4,25,29,1,19,11,.423,26,12,.857,14,30,2,202,8,19,35,PG,4,13,27,MIL,.442
201,Jim Jackson,29,.337,86,18,.243,74,35,35,6,65,47,.294,160,9,.692,13,40,1,512,11,51,121,SF,12,35,76,TOT,.350
202,Luke Jackson,17,.347,49,12,.333,36,25,24,2,24,29,.341,85,26,.788,33,36,0,315,16,30,96,SF,11,31,40,CLE,.412
203,Marc Jackson,173,.471,367,1,.500,2,44,31,8,131,174,.472,369,66,.805,82,64,10,1027,86,126,415,C,13,65,217,TOT,.473
204,Stephen Jackson,355,.439,809,117,.345,339,225,27,43,264,472,.411,1148,268,.786,341,81,81,2910,48,195,1329,SG,104,203,312,IND,.462
205,Jerome James,56,.463,121,0,,0,12,30,23,52,56,.463,121,25,.625,40,45,9,406,39,104,137,C,3,51,91,NYK,.463
206,LeBron James,748,.518,1444,127,.335,379,521,21,66,481,875,.480,1823,601,.738,814,79,79,3361,75,181,2478,SF,123,260,556,CLE,.515
207,Mike James,407,.481,846,169,.442,382,460,30,3,217,576,.469,1228,283,.837,338,79,79,2925,45,214,1604,PG,72,206,262,TOR,.538
208,Antawn Jamison,513,.458,1121,147,.394,373,158,29,12,598,660,.442,1494,217,.731,297,82,80,3288,167,189,1684,SF,90,137,765,WAS,.491
209,Marko Jaric,186,.430,433,40,.301,133,293,27,21,173,226,.399,566,95,.688,138,75,49,2102,60,189,587,PG,108,127,233,MIN,.435
210,Sarunas Jasikevicius,84,.435,193,86,.364,236,227,29,4,134,170,.396,429,121,.910,133,75,15,1557,19,108,547,PG,40,116,153,IND,.497
211,Al Jefferson,189,.504,375,0,.000,4,30,21,46,202,189,.499,379,86,.642,134,59,7,1062,97,166,464,PF,30,62,299,BOS,.499
212,Richard Jefferson,435,.532,817,60,.319,188,297,25,17,439,495,.493,1005,471,.812,580,78,78,3059,95,193,1521,SF,59,174,534,NJN,.522
213,Jared Jeffries,171,.468,365,16,.320,50,148,24,50,215,187,.451,415,99,.589,168,77,77,1951,164,223,489,PF,58,99,379,WAS,.470
214,Amir Johnson,5,.714,7,2,.667,3,3,18,2,1,7,.700,10,4,1.000,4,3,0,39,3,7,20,SF,0,4,4,DET,.800
215,Anthony Johnson,216,.482,448,51,.329,155,324,31,22,137,267,.443,603,106,.752,141,75,53,1981,31,132,691,PG,63,115,168,IND,.485
216,DerMarr Johnson,76,.521,146,56,.350,160,55,25,26,77,132,.431,306,34,.810,42,58,21,924,19,86,354,SG,25,46,96,DEN,.523
217,Ervin Johnson,7,.412,17,0,,0,2,38,2,19,7,.412,17,1,.500,2,18,0,81,5,23,15,C,1,5,24,MIL,.412
218,Joe Johnson,504,.487,1035,128,.356,360,536,24,31,237,632,.453,1395,261,.791,330,82,82,3340,98,187,1653,SG,103,267,335,ATL,.499
219,Linton Johnson,48,.425,113,13,.361,36,14,25,12,82,61,.409,149,18,.667,27,36,7,524,40,61,153,SF,12,28,122,TOT,.453
220,Dahntay Jones,106,.438,242,3,.143,21,39,25,15,84,109,.414,263,60,.645,93,71,4,967,20,108,281,SF,38,50,104,MEM,.420
221,Damon Jones,50,.417,120,140,.377,371,169,29,1,119,190,.387,491,32,.640,50,82,7,2089,14,112,552,PG,37,55,133,CLE,.530
222,Dwayne Jones,4,.400,10,0,,0,2,22,3,21,4,.400,10,6,.462,13,14,0,87,10,14,14,PF,1,3,31,BOS,.400
223,Eddie Jones,159,.457,348,133,.356,374,177,34,27,244,292,.404,722,168,.781,215,75,75,2437,35,201,885,SG,131,93,279,MEM,.497
224,Fred Jones,170,.457,372,63,.337,187,154,26,20,152,233,.417,559,122,.763,160,68,2,1837,18,142,651,SG,55,107,170,IND,.473
225,James Jones,133,.449,296,110,.386,285,57,25,49,209,243,.418,581,103,.851,121,75,24,1772,44,142,699,SF,38,35,253,PHO,.513
226,Jumaine Jones,183,.456,401,115,.343,335,63,26,22,271,298,.405,736,88,.727,121,76,42,2089,105,200,799,PF,68,74,376,CHA,.483
227,Chris Kaman,369,.524,704,0,.000,2,79,23,108,563,369,.523,706,194,.770,252,78,78,2560,187,269,932,C,45,176,750,LAC,.523
228,Jason Kapono,58,.468,124,21,.396,53,37,24,3,59,79,.446,177,28,.848,33,51,2,665,12,89,207,SF,7,20,71,MIA,.506
229,Mario Kasun,31,.449,69,0,,0,3,25,3,36,31,.449,69,18,.783,23,28,0,213,24,69,80,C,2,15,60,ORL,.449
230,Viktor Khryapa,148,.474,312,10,.333,30,88,23,29,193,158,.462,342,77,.694,111,69,53,1492,114,209,403,SF,50,84,307,POR,.477
231,Jason Kidd,227,.445,510,139,.352,395,672,32,29,494,366,.404,905,194,.795,244,80,80,2975,86,157,1065,PG,150,192,580,NJN,.481
232,Andrei Kirilenko,300,.489,613,36,.308,117,299,24,220,391,336,.460,730,346,.699,495,69,63,2604,161,162,1054,SF,102,203,552,UTA,.485
233,Linas Kleiza,75,.469,160,2,.154,13,15,21,13,78,77,.445,173,57,.704,81,61,2,519,38,87,213,PF,10,16,116,DEN,.451
234,Brevin Knight,305,.402,759,3,.231,13,610,30,4,188,308,.399,772,252,.803,314,69,67,2351,35,202,871,PG,157,164,223,CHA,.401
235,Yaroslav Korolev,7,.304,23,2,.286,7,9,18,0,8,9,.300,30,7,.700,10,24,0,127,5,11,27,SF,3,6,13,LAC,.333
236,Kyle Korver,143,.443,323,184,.420,438,163,24,26,243,327,.430,761,101,.849,119,82,43,2563,27,224,939,SF,65,98,270,PHI,.551
237,Nenad Krstic,446,.509,877,1,.250,4,88,22,63,331,447,.507,881,185,.698,265,80,80,2469,182,297,1080,PF,32,133,513,NJN,.508
238,Toni Kukoc,71,.470,151,45,.306,147,139,37,17,124,116,.389,298,40,.714,56,65,0,1018,26,87,317,PF,33,66,150,MIL,.465
239,Raef LaFrentz,126,.474,266,112,.392,286,115,29,72,326,238,.431,552,51,.680,75,82,63,2033,80,273,639,PF,29,65,406,BOS,.533
240,Maciej Lampe,2,.182,11,0,,0,2,20,0,5,2,.182,11,0,.000,2,6,0,28,4,2,4,C,0,3,9,TOT,.182
241,David Lee,137,.596,230,0,,0,43,22,20,194,137,.596,230,71,.577,123,67,14,1129,109,124,345,SF,30,51,303,NYK,.596
242,Voshon Lenard,50,.442,113,25,.321,78,41,32,4,42,75,.393,191,16,.516,31,26,6,458,5,39,191,SG,21,31,47,TOT,.458
243,Rashard Lewis,396,.507,781,142,.384,370,182,26,50,279,538,.467,1151,350,.818,428,78,77,2876,111,191,1568,SF,102,141,390,SEA,.529
244,Randy Livingston,0,.000,2,0,,0,1,30,0,3,0,.000,2,0,,0,5,0,22,1,6,0,PG,1,1,4,CHI,.000
245,Shaun Livingston,148,.434,341,1,.125,8,273,20,32,142,149,.427,349,53,.688,77,61,14,1525,41,160,352,PG,46,111,183,LAC,.428
246,John Lucas III,12,.444,27,2,.222,9,12,23,0,3,14,.389,36,0,,0,13,0,107,2,6,30,PG,5,7,5,HOU,.417
247,Tyronn Lue,134,.460,291,58,.457,127,157,28,3,69,192,.459,418,118,.855,138,51,10,1234,13,113,560,PG,26,75,82,ATL,.529
248,Arvydas Macijauskas,11,.379,29,3,.250,12,5,26,0,7,14,.341,41,13,.867,15,19,0,135,3,10,44,SG,7,8,10,NOK,.378
249,Mark Madsen,27,.458,59,0,.000,7,11,30,17,91,27,.409,66,20,.426,47,62,7,676,50,114,74,C,23,26,141,MIN,.409
250,Corey Maggette,143,.470,304,24,.338,71,66,26,4,141,167,.445,375,212,.828,256,32,13,943,28,95,570,SF,19,78,169,LAC,.477
251,Jamaal Magloire,287,.467,615,0,,0,56,27,80,558,287,.467,615,178,.535,333,82,82,2465,220,276,752,C,29,166,778,MIL,.467
252,Stephon Marbury,316,.472,670,33,.317,104,382,28,4,150,349,.451,774,246,.755,326,60,60,2193,25,143,977,PG,63,157,175,NYK,.472
253,Shawn Marion,620,.577,1075,96,.331,290,143,27,137,710,716,.525,1365,241,.809,298,81,81,3263,249,223,1769,PF,160,125,959,PHO,.560
254,Sean Marks,37,.544,68,0,.000,3,7,30,7,31,37,.521,71,7,.583,12,25,0,181,12,21,81,PF,5,7,43,SAS,.521
255,Donyell Marshall,137,.496,276,128,.324,395,60,32,41,387,265,.395,671,92,.748,123,81,0,2077,105,160,750,PF,59,90,492,CLE,.490
256,Rawle Marshall,23,.404,57,1,.333,3,10,23,7,23,24,.400,60,22,.759,29,23,9,241,8,17,71,SF,8,15,31,DAL,.408
257,Darrick Martin,18,.316,57,16,.400,40,57,34,0,18,34,.351,97,18,.750,24,40,0,339,2,42,102,PG,17,15,20,TOR,.433
258,Kenyon Martin,292,.505,578,5,.227,22,79,28,52,260,297,.495,600,121,.712,170,56,49,1546,93,171,720,PF,43,72,353,DEN,.499
259,Kevin Martin,196,.534,367,66,.369,179,97,22,9,203,262,.480,546,188,.847,222,72,41,1913,58,138,778,SG,55,81,261,SAC,.540
260,Desmond Mason,274,.401,684,1,.167,6,66,28,17,234,275,.399,690,206,.682,302,70,55,2102,64,136,757,SF,42,113,298,NOK,.399
261,Jason Maxiell,23,.426,54,0,,0,3,22,5,16,23,.426,54,14,.333,42,26,0,159,12,14,60,PF,4,11,28,DET,.426
262,Sean May,70,.422,166,0,.000,5,22,21,12,67,70,.409,171,49,.766,64,23,1,398,42,58,189,PF,17,33,109,CHA,.409
263,Rashad McCants,174,.490,355,67,.372,180,63,21,22,114,241,.450,535,78,.736,106,79,12,1362,29,176,627,SG,44,86,143,MIN,.513
264,Walter McCarty,23,.426,54,10,.222,45,23,31,5,53,33,.333,99,12,.571,21,36,1,353,15,52,88,SF,8,19,68,LAC,.384
265,Antonio McDyess,285,.511,558,0,.000,2,90,31,48,280,285,.509,560,68,.557,122,82,0,1733,156,220,638,PF,46,76,436,DET,.509
266,Tracy McGrady*,337,.434,777,73,.312,234,225,26,41,261,410,.406,1011,254,.747,340,47,47,1745,46,88,1147,SF,59,120,307,HOU,.442
267,Jeff McInnis,60,.472,127,3,.188,16,52,31,2,39,63,.441,143,20,.690,29,28,1,486,11,37,149,SG,11,29,50,NJN,.451
268,Aaron McKie,3,.300,10,0,.000,2,11,33,0,17,3,.250,12,1,.500,2,14,0,121,3,7,7,PG,5,2,20,LAL,.250
269,Keith McLeod,96,.372,258,24,.293,82,151,26,9,67,120,.353,340,106,.797,133,66,32,1232,11,131,370,PG,42,76,78,UTA,.388
270,Stanislav Medvedenko,1,.500,2,0,,0,1,26,0,0,1,.500,2,0,,0,2,0,6,0,1,2,PF,0,0,0,LAL,.500
271,Chris Mihm,230,.501,459,0,,0,61,26,73,236,230,.501,459,144,.716,201,59,56,1541,137,214,604,C,16,83,373,LAL,.501
272,Aaron Miles,6,.333,18,0,,0,24,22,1,14,6,.333,18,4,1.000,4,19,0,118,0,13,16,PG,4,11,14,GSW,.333
273,C.J. Miles,23,.411,56,5,.250,20,16,18,2,20,28,.368,76,18,.750,24,23,0,203,18,20,79,PG,7,9,38,UTA,.401
274,Darius Miles,233,.466,500,2,.200,10,73,24,39,158,235,.461,510,87,.534,163,40,23,1286,24,100,559,SF,42,99,182,POR,.463
275,Darko Milicic,119,.513,232,0,.000,2,41,20,77,107,119,.509,234,28,.560,50,55,1,767,44,92,266,C,14,51,151,TOT,.509
276,Andre Miller,399,.472,845,5,.185,27,674,29,18,259,404,.463,872,313,.738,424,82,82,2937,92,213,1126,PG,106,256,351,DEN,.466
277,Brad Miller,400,.507,789,34,.386,88,374,29,62,493,434,.495,877,280,.828,338,79,79,2923,122,234,1182,C,61,180,615,SAC,.514
278,Mike Miller,216,.513,421,138,.407,339,200,25,27,355,354,.466,760,168,.800,210,74,9,2268,42,173,1014,SG,52,140,397,MEM,.557
279,Yao Ming*,467,.519,899,0,.000,1,85,25,94,433,467,.519,900,337,.853,395,57,57,1949,148,195,1271,C,30,147,581,HOU,.519
280,Cuttino Mobley,346,.453,763,83,.339,245,238,30,36,291,429,.426,1008,229,.839,273,79,74,2979,50,208,1170,SG,93,145,341,LAC,.467
281,Nazr Mohammed,190,.504,377,0,,0,40,28,49,255,190,.504,377,113,.785,144,80,30,1389,163,220,493,C,21,91,418,SAS,.504
282,Sergei Monia,20,.377,53,9,.265,34,19,22,5,41,29,.333,87,10,.714,14,26,15,343,11,41,77,SF,7,12,52,TOT,.385
283,Mikki Moore,54,.443,122,0,.000,2,27,30,15,86,54,.435,124,46,.742,62,47,1,583,44,92,154,C,7,40,130,SEA,.435
284,Terence Morris,16,.340,47,0,.000,2,4,27,5,32,16,.327,49,3,1.000,3,22,0,192,6,19,35,SF,6,7,38,ORL,.327
285,Alonzo Mourning*,188,.599,314,0,.000,1,11,35,173,234,188,.597,315,133,.594,224,65,20,1302,125,177,509,C,13,79,359,MIA,.597
286,Troy Murphy,305,.464,657,58,.320,181,101,25,26,548,363,.433,838,251,.787,319,74,74,2516,195,191,1035,PF,47,108,743,GSW,.468
287,Lamond Murray,45,.437,103,27,.346,78,13,32,7,103,72,.398,181,25,.625,40,57,1,576,29,66,196,SF,17,22,132,NJN,.472
288,Ronald Murray,284,.453,627,37,.262,141,197,26,11,120,321,.418,768,172,.711,242,76,27,2112,33,133,851,SG,68,135,153,TOT,.442
289,Dikembe Mutombo*,50,.526,95,0,,0,4,39,57,206,50,.526,95,69,.758,91,64,23,955,100,128,169,C,17,35,306,HOU,.526
290,Boniface N'Dong,22,.423,52,0,.000,1,7,28,5,22,22,.415,53,6,.667,9,23,1,152,15,23,50,C,2,6,37,LAC,.415
291,Bostjan Nachbar,35,.412,85,19,.268,71,27,25,5,52,54,.346,156,30,.682,44,36,13,502,8,65,157,PF-SF,16,24,60,TOT,.407
292,Lee Nailon,40,.500,80,0,,0,7,30,4,19,40,.500,80,13,.867,15,22,0,237,23,32,93,PF,8,10,42,PHI,.500
293,Eduardo Najera,123,.426,289,4,.333,12,52,29,34,197,127,.422,301,89,.781,114,64,3,1449,128,165,347,PF,53,54,325,DEN,.429
294,Steve Nash,391,.548,714,150,.439,342,826,31,12,286,541,.512,1056,257,.921,279,79,79,2796,47,120,1489,PG,61,276,333,PHO,.583
295,Jameer Nelson,277,.500,554,70,.424,165,302,23,9,141,347,.483,719,141,.779,181,62,33,1784,39,174,905,PG,70,148,180,ORL,.531
296,Rasho Nesterovic,172,.518,332,0,.000,2,33,29,88,195,172,.515,334,18,.600,30,80,51,1515,114,209,362,C,21,53,309,SAS,.515
297,Ira Newble,14,.318,44,3,.231,13,9,31,10,35,17,.298,57,11,.688,16,36,3,353,21,47,48,SG,5,12,56,CLE,.325
298,Andres Nocioni,290,.489,593,93,.391,238,117,26,52,411,383,.461,831,204,.843,242,82,43,2239,89,252,1063,PF,40,120,500,CHI,.517
299,Moochie Norris,42,.429,98,4,.286,14,50,32,1,42,46,.411,112,29,.690,42,45,0,424,12,49,125,PG,20,33,54,TOT,.429
300,Dirk Nowitzki,641,.496,1293,110,.406,271,226,27,83,613,751,.480,1564,539,.901,598,81,81,3089,115,164,2151,PF,58,156,728,DAL,.515
301,Jermaine O'Neal,377,.474,795,3,.300,10,133,27,117,374,380,.472,805,261,.709,368,51,47,1802,102,177,1024,PF,27,151,476,IND,.474
302,Shaquille O'Neal*,480,.600,800,0,,0,113,33,104,369,480,.600,800,221,.469,471,59,58,1806,172,230,1181,C,23,168,541,MIA,.600
303,Fabricio Oberto,44,.484,91,0,.000,2,27,30,11,66,44,.473,93,15,.556,27,59,0,490,57,91,103,C,9,28,123,SAS,.473
304,Lamar Odom,365,.514,710,80,.372,215,443,26,64,557,445,.481,925,216,.690,313,80,80,3221,181,256,1186,PF,75,213,738,LAL,.524
305,Emeka Okafor,131,.415,316,0,,0,31,23,50,167,131,.415,316,82,.656,125,26,25,874,94,88,344,PF,22,53,261,CHA,.415
306,Mehmet Okur,439,.491,894,80,.342,234,194,26,73,535,519,.460,1128,354,.780,454,82,82,2945,211,285,1472,PF,40,163,746,UTA,.496
307,Kevin Ollie,74,.433,171,1,.333,3,101,33,3,85,75,.431,174,41,.837,49,70,23,1069,13,103,192,SG,33,29,98,PHI,.434
308,Michael Olowokandi,107,.446,240,0,,0,23,30,33,170,107,.446,240,24,.511,47,48,24,919,50,122,238,C,22,55,220,TOT,.446
309,Greg Ostertag,61,.492,124,0,,0,58,32,66,143,61,.492,124,24,.500,48,60,22,807,82,129,146,C,6,46,225,UTA,.492
310,Bo Outlaw,35,.603,58,0,,0,14,34,12,46,35,.603,58,5,.625,8,32,0,355,31,50,75,PF,10,17,77,ORL,.603
311,Travis Outlaw,148,.470,315,14,.264,53,34,21,46,141,162,.440,368,62,.697,89,69,11,1153,48,112,400,PF,31,37,189,POR,.459
312,Andre Owens,24,.414,58,3,.188,16,8,25,0,10,27,.365,74,12,.667,18,23,2,210,11,25,69,PG,5,13,21,UTA,.385
313,Zaza Pachulia,307,.452,679,0,.000,2,129,21,39,349,307,.451,681,297,.735,404,78,78,2452,264,286,911,C,89,180,613,ATL,.451
314,Scott Padgett,29,.363,80,42,.347,121,41,29,12,109,71,.353,201,27,.794,34,62,1,718,56,90,211,PF,28,21,165,NJN,.458
315,Milt Palacio,170,.439,387,1,.063,16,190,27,14,117,171,.424,403,98,.653,150,71,18,1376,17,125,441,PG,47,110,134,UTA,.426
316,Jannero Pargo,70,.370,189,39,.379,103,94,26,2,53,109,.373,292,17,.810,21,57,0,646,8,57,274,PG,24,61,61,CHI,.440
317,Smush Parker,228,.506,451,120,.366,328,302,24,16,234,348,.447,779,125,.694,180,82,82,2773,37,213,941,PG,140,147,271,LAL,.524
318,Tony Parker,612,.556,1100,11,.306,36,460,23,4,223,623,.548,1136,253,.707,358,80,80,2715,38,161,1510,PG,83,249,261,SAS,.553
319,Ruben Patterson,326,.524,622,1,.077,13,127,30,21,126,327,.515,635,203,.601,338,71,22,1792,118,150,858,SF-SG,76,150,244,TOT,.516
320,Chris Paul,357,.464,770,50,.282,177,611,20,6,339,407,.430,947,394,.847,465,78,78,2808,61,218,1258,PG,175,183,400,NOK,.456
321,Sasha Pavlovic,52,.448,116,35,.365,96,25,22,6,64,87,.410,212,32,.653,49,53,19,813,16,103,241,SG,19,42,80,CLE,.493
322,Gary Payton*,164,.517,317,66,.287,230,257,37,10,199,230,.420,547,100,.794,126,81,25,2305,34,169,626,PG,71,102,233,MIA,.481
323,Kendrick Perkins,137,.519,264,0,.000,2,69,21,105,264,137,.515,266,80,.615,130,68,40,1332,140,199,354,C,21,107,404,BOS,.515
324,Morris Peterson,301,.465,648,177,.395,448,190,28,15,316,478,.436,1096,241,.820,294,82,77,3140,65,223,1374,SG,104,126,381,TOR,.517
325,Johan Petro,153,.510,300,0,,0,15,20,51,187,153,.510,300,47,.627,75,68,41,1282,109,213,353,C,25,60,296,SEA,.510
326,Eric Piatkowski,15,.536,28,9,.273,33,13,35,1,19,24,.393,61,2,.400,5,29,1,228,4,20,59,SG,6,11,23,CHI,.467
327,Paul Pierce,578,.503,1148,111,.354,314,375,28,34,453,689,.471,1462,627,.772,812,79,79,3084,77,223,2116,SF,107,273,530,BOS,.509
328,Mickael Pietrus,113,.467,242,56,.318,176,44,23,10,105,169,.404,418,87,.608,143,52,18,1179,58,132,481,SF,33,78,163,GSW,.471
329,Zoran Planinic,53,.417,127,13,.232,56,53,23,4,60,66,.361,183,46,.697,66,56,1,596,14,91,191,PG,20,43,74,NJN,.396
330,Pavel Podkolzin,0,.000,2,0,,0,0,21,1,7,0,.000,2,3,.500,6,1,0,18,0,0,3,C,0,2,7,DAL,.000
331,Scot Pollard,70,.455,154,0,,0,24,30,20,145,70,.455,154,29,.763,38,45,32,771,73,115,169,C,37,26,218,IND,.455
332,James Posey,42,.400,105,117,.403,290,89,29,20,286,159,.403,395,48,.787,61,67,63,1914,33,196,483,SF,54,58,319,MIA,.551
333,Vitaly Potapenko,37,.521,71,0,,0,9,30,2,37,37,.521,71,10,.588,17,33,12,353,27,50,84,C,2,16,64,TOT,.521
334,Josh Powell,37,.457,81,0,,0,9,23,4,53,37,.457,81,36,.800,45,37,2,429,28,52,110,PF,7,22,81,DAL,.457
335,Ronnie Price,15,.484,31,6,.222,27,11,22,0,10,21,.362,58,12,1.000,12,29,0,150,5,10,60,PG,6,10,15,SAC,.414
336,Tayshaun Prince,391,.479,816,64,.350,183,186,25,39,242,455,.455,999,182,.765,238,82,82,2898,104,96,1156,SF,62,91,346,DET,.487
337,Laron Profit,37,.561,66,3,.167,18,15,28,5,35,40,.476,84,21,.875,24,25,1,279,8,25,104,SG,11,24,43,LAL,.494
338,Joel Przybilla,131,.548,239,0,,0,43,26,130,245,131,.548,239,82,.532,154,56,52,1395,146,149,344,C,20,76,391,POR,.548
339,Vladimir Radmanovic,124,.429,289,138,.390,354,136,25,29,294,262,.407,643,93,.816,114,77,27,1974,64,210,755,PF,61,93,358,TOT,.515
340,Shavlik Randolph,44,.454,97,0,,0,19,22,12,78,44,.454,97,43,.606,71,57,1,487,55,83,131,PF,19,21,133,PHI,.454
341,Zach Randolph,520,.443,1174,16,.291,55,144,24,14,399,536,.436,1229,245,.714,343,74,71,2545,193,185,1333,PF,57,165,592,POR,.443
342,Theo Ratliff,108,.571,189,0,,0,28,32,88,190,108,.571,189,54,.651,83,55,19,1301,89,143,270,C,18,47,279,POR,.571
343,Zeljko Rebraca,52,.542,96,0,,0,9,33,19,51,52,.542,96,31,.756,41,29,2,412,13,59,135,C,5,24,64,LAC,.542
344,Michael Redd,519,.471,1103,163,.395,413,229,26,5,264,682,.450,1516,501,.877,571,80,80,3130,78,157,2028,SG,95,170,342,MIL,.504
345,Justin Reed,119,.405,294,0,.000,1,41,24,15,71,119,.403,295,87,.725,120,72,6,997,53,163,325,SF,23,52,124,TOT,.403
346,Jason Richardson,458,.477,961,183,.384,477,232,25,37,333,641,.446,1438,276,.673,410,75,75,2877,105,206,1741,SG,97,167,438,GSW,.509
347,Quentin Richardson,99,.365,271,64,.340,188,88,25,6,165,163,.355,459,61,.670,91,55,43,1442,65,134,451,SF,39,56,230,NYK,.425
348,Luke Ridnour,291,.448,650,43,.289,149,550,24,22,188,334,.418,799,199,.877,227,79,77,2625,47,178,910,PG,123,162,235,SEA,.445
349,Anthony Roberson,9,.429,21,5,.500,10,5,22,0,6,14,.452,31,2,1.000,2,16,0,88,0,6,35,PG,1,3,6,MEM,.532
350,Lawrence Roberts,20,.476,42,0,.000,2,5,23,2,23,20,.455,44,11,.478,23,33,0,181,26,30,51,C,8,5,49,MEM,.455
351,Bernard Robinson,155,.451,344,2,.095,21,77,25,10,157,157,.430,365,106,.791,134,66,18,1303,62,141,422,SF,81,74,219,CHA,.433
352,Clifford Robinson,159,.470,338,60,.343,175,89,39,40,212,219,.427,513,52,.658,79,80,13,1863,55,206,550,PF,44,62,267,NJN,.485
353,Nate Robinson,172,.411,419,58,.397,146,147,21,1,111,230,.407,565,152,.752,202,72,26,1544,56,201,670,PG,59,114,167,NYK,.458
354,Jalen Rose,231,.450,513,59,.343,172,181,33,13,183,290,.423,685,248,.780,318,72,45,1983,28,156,887,SF-SG,30,115,211,TOT,.466
355,Malik Rose,104,.371,280,1,1.000,1,67,31,14,175,105,.374,281,107,.781,137,72,35,1119,84,145,318,PF,43,80,259,NYK,.375
356,Quinton Ross,130,.432,301,0,.000,7,79,24,16,132,130,.422,308,57,.760,75,67,45,1515,38,155,317,SF,51,47,170,LAC,.422
357,Michael Ruffin,34,.453,75,0,.000,2,27,29,31,149,34,.442,77,37,.500,74,76,4,1010,122,179,105,C,33,38,271,WAS,.442
358,Kareem Rush,124,.407,305,57,.348,164,50,25,13,85,181,.386,469,55,.714,77,47,25,1111,18,79,474,SG,38,65,103,CHA,.447
359,Bryon Russell,0,,0,0,,0,1,35,0,1,0,,0,0,,0,1,0,3,0,0,0,SF,0,0,1,DEN,
360,John Salmons,193,.445,434,26,.299,87,223,26,13,172,219,.420,521,155,.775,200,82,24,2059,48,178,619,SG,73,125,220,PHI,.445
361,Jamal Sampson,5,.714,7,0,,0,5,22,4,13,5,.714,7,0,.000,2,12,0,39,5,5,10,PF,0,0,18,SAC,.714
362,Melvin Sanders,14,.467,30,2,.667,3,3,25,0,19,16,.485,33,7,.700,10,16,0,113,4,20,41,SG,5,8,23,SAS,.515
363,Brian Scalabrine,43,.406,106,31,.356,87,51,27,19,87,74,.383,193,26,.722,36,71,1,938,27,127,205,PF,21,50,114,BOS,.464
364,Alex Scales,0,,0,0,,0,0,27,0,0,0,,0,0,,0,1,0,0,0,0,0,SG,0,0,0,SAS,
365,Luke Schenscher,16,.615,26,0,,0,7,23,3,21,16,.615,26,4,.308,13,20,0,149,8,21,36,C,1,5,29,CHI,.615
366,Ha Seung-Jin,18,.581,31,0,,0,1,20,8,35,18,.581,31,8,.471,17,27,4,212,14,41,44,C,3,14,49,POR,.581
367,Wayne Simien,58,.483,120,0,,0,7,22,1,50,58,.483,120,30,.882,34,43,2,414,38,70,146,PF,13,24,88,MIA,.483
368,Bobby Simmons,261,.468,558,105,.420,250,172,25,21,242,366,.453,808,165,.825,200,75,74,2538,91,254,1002,SF,86,123,333,MIL,.518
369,James Singleton,67,.511,131,10,.500,20,29,24,21,134,77,.510,151,39,.780,50,59,10,753,63,95,203,SF,19,28,197,LAC,.543
370,Brian Skinner,82,.513,160,0,,0,30,29,43,152,82,.513,160,27,.482,56,65,5,944,76,119,191,PF-C,25,45,228,TOT,.513
371,Charles Smith,15,.441,34,15,.395,38,9,30,6,13,30,.417,72,5,.625,8,22,4,210,3,28,80,SG,5,4,16,TOT,.521
372,Donta Smith,13,.565,23,2,.500,4,9,22,0,11,15,.556,27,6,.500,12,23,0,127,3,20,38,SG,8,4,14,ATL,.593
373,J.R. Smith,92,.407,226,52,.371,140,58,20,4,91,144,.393,366,83,.822,101,55,25,989,19,90,423,SG,37,54,110,NOK,.464
374,Joe Smith,145,.479,303,0,.000,2,31,30,13,147,145,.475,305,89,.774,115,44,5,887,83,120,379,PF,24,40,230,MIL,.475
375,Josh Smith,295,.444,664,34,.309,110,191,20,208,355,329,.425,774,210,.719,292,80,73,2559,176,260,902,SF,64,162,531,ATL,.447
376,Eric Snow,162,.416,389,1,.100,10,346,32,19,160,163,.409,399,64,.688,93,82,82,2351,38,218,391,PG,76,116,198,CLE,.410
377,Kirk Snyder,159,.491,324,46,.357,129,102,22,23,106,205,.453,453,86,.735,117,68,45,1310,55,106,542,SG,29,70,161,NOK,.503
378,Darius Songaila,234,.481,486,2,.400,5,88,27,16,170,236,.481,491,94,.817,115,62,7,1329,76,157,568,PF,35,85,246,CHI,.483
379,Pape Sow,53,.431,123,0,,0,8,24,19,92,53,.431,123,41,.719,57,42,25,590,54,118,147,C,21,30,146,TOR,.431
380,Jerry Stackhouse,206,.436,473,36,.277,130,160,31,10,121,242,.401,603,195,.882,221,55,11,1525,32,96,715,SG,37,121,153,DAL,.431
381,DeShawn Stevenson,357,.466,766,2,.133,15,160,24,17,182,359,.460,781,180,.744,242,82,82,2648,59,178,900,SG,58,123,241,ORL,.461
382,Peja Stojakovic,283,.461,614,162,.401,404,136,28,10,336,445,.437,1018,238,.915,260,71,71,2601,79,171,1290,SF,45,103,415,TOT,.517
383,Awvee Storey,13,.382,34,3,.429,7,4,28,1,14,16,.390,41,8,.571,14,25,1,116,8,22,43,SF,3,5,22,WAS,.427
384,Damon Stoudamire,78,.426,183,36,.346,104,128,32,1,72,114,.397,287,53,.855,62,27,27,862,23,49,317,PG,19,55,95,MEM,.460
385,Salim Stoudamire,122,.442,276,82,.380,216,75,23,3,104,204,.415,492,99,.900,110,61,1,1236,12,118,589,SG,27,82,116,ATL,.498
386,Amar'e Stoudemire,9,.346,26,0,.000,1,2,23,3,10,9,.333,27,8,.889,9,3,3,50,6,4,26,C,1,1,16,PHO,.333
387,Mike Sweetney,200,.450,444,0,,0,59,23,56,232,200,.450,444,133,.652,204,66,44,1222,118,209,533,C,19,95,350,CHI,.450
388,Robert Swift,124,.515,241,0,,0,8,20,56,170,124,.515,241,53,.582,91,47,20,987,94,142,301,C,15,49,264,SEA,.515
389,Stromile Swift,225,.493,456,0,.000,2,25,26,50,188,225,.491,458,136,.651,209,66,5,1344,103,198,586,C,38,91,291,HOU,.491
390,Wally Szczerbiak,391,.517,757,102,.400,255,213,28,19,236,493,.487,1012,278,.897,310,72,71,2729,77,150,1366,SF,40,136,313,TOT,.538
391,Chris Taft,23,.605,38,0,,0,2,20,7,17,23,.605,38,1,.167,6,17,0,144,19,25,47,C,2,2,36,GSW,.605
392,Donell Taylor,49,.412,119,4,.235,17,45,23,4,37,53,.390,136,30,.698,43,51,1,465,16,47,140,SG,30,34,53,WAS,.404
393,Maurice Taylor,182,.469,388,0,.000,1,53,29,14,164,182,.468,389,58,.699,83,67,13,1210,65,177,422,PF,21,103,229,NYK,.468
394,Sebastian Telfair,171,.411,416,57,.352,162,247,20,6,101,228,.394,578,130,.743,175,68,30,1641,19,167,643,PG,66,115,120,POR,.444
395,Jason Terry,345,.505,683,171,.411,416,306,28,27,127,516,.470,1099,168,.800,210,80,80,2798,31,196,1371,PG,100,135,158,DAL,.547
396,Billy Thomas,3,.300,10,10,.333,30,9,30,1,9,13,.325,40,2,1.000,2,17,0,131,5,19,38,SG,10,6,14,WAS,.450
397,Etan Thomas,131,.533,246,0,,0,14,27,68,180,131,.533,246,75,.600,125,71,9,1121,99,148,337,C,20,51,279,WAS,.533
398,James Thomas,10,.526,19,0,,0,1,25,3,27,10,.526,19,8,.571,14,22,0,150,12,35,28,PF,0,7,39,TOT,.526
399,John Thomas,6,.400,15,0,,0,2,30,2,10,6,.400,15,3,.750,4,16,0,127,10,17,15,C,3,8,20,TOT,.400
400,Kenny Thomas,305,.506,603,0,.000,1,168,28,39,419,305,.505,604,138,.676,204,82,55,2293,199,196,748,PF,72,135,618,SAC,.505
401,Kurt Thomas,190,.486,391,0,,0,57,33,54,313,190,.486,391,75,.815,92,53,50,1411,102,193,455,C,23,57,415,PHO,.486
402,Tim Thomas,67,.444,151,46,.414,111,20,28,7,109,113,.431,262,28,.667,42,29,10,666,22,78,300,PF-SF,16,33,131,TOT,.519
403,Dijon Thompson,7,.500,14,4,.364,11,1,22,1,7,11,.440,25,2,1.000,2,10,0,43,4,6,28,SG,3,2,11,PHO,.520
404,Jamaal Tinsley,142,.449,316,16,.229,70,211,27,6,98,158,.409,386,58,.637,91,42,27,1122,35,96,390,PG,49,109,133,IND,.430
405,Jake Tsakalidis,100,.606,165,0,,0,13,26,32,134,100,.606,165,57,.655,87,51,19,732,78,107,257,C,14,39,212,MEM,.606
406,Nikoloz Tskitishvili,12,.353,34,1,.333,3,3,22,2,13,13,.351,37,9,.643,14,17,0,99,9,8,36,SF-PF,1,6,22,TOT,.365
407,Ronny Turiaf,15,.500,30,0,,0,8,23,10,26,15,.500,30,15,.556,27,23,1,161,11,30,45,C,3,7,37,LAL,.500
408,Hedo Turkoglu,284,.478,594,114,.403,283,216,26,21,263,398,.454,877,255,.861,296,78,59,2615,70,234,1165,SF,70,130,333,ORL,.519
409,Ime Udoka,8,.381,21,1,.333,3,6,28,0,14,9,.375,24,3,.500,6,8,0,114,3,8,22,SF,1,2,17,NYK,.396
410,Beno Udrih,82,.503,163,24,.343,70,92,23,2,34,106,.455,233,39,.780,50,54,3,586,18,55,275,PG,14,53,52,SAS,.506
411,Nick Van Exel,81,.429,189,55,.357,154,123,34,3,85,136,.397,343,28,.683,41,65,2,986,6,60,355,PG,16,57,91,SAS,.477
412,Keith Van Horn,114,.454,251,50,.368,136,37,30,11,138,164,.424,387,94,.832,113,53,0,1090,54,121,472,SF,31,71,192,DAL,.488
413,Anderson Varejao,79,.530,149,0,.000,1,19,23,19,158,79,.527,150,61,.513,119,48,4,760,77,118,219,C,31,27,235,CLE,.527
414,Jacque Vaughn,106,.444,239,1,.167,6,123,30,1,75,107,.437,245,59,.728,81,80,6,1234,16,140,274,SG,42,52,91,NJN,.439
415,Charlie Villanueva,365,.503,726,70,.327,214,88,21,63,340,435,.463,940,113,.706,160,81,36,2361,181,247,1053,PF,60,99,521,TOR,.500
416,Jake Voskuhl,113,.438,258,1,.333,3,39,28,23,121,114,.437,261,41,.683,60,51,2,818,62,157,270,C,26,33,183,CHA,.439
417,Jackson Vroman,26,.394,66,0,,0,11,24,11,53,26,.394,66,21,.477,44,41,2,406,33,78,73,PF,12,21,86,NOK,.394
418,Sasha Vujacic,49,.350,140,59,.343,172,139,21,3,126,108,.346,312,46,.885,52,82,4,1449,33,150,321,PG,48,50,159,LAL,.441
419,Dwyane Wade,686,.513,1337,13,.171,76,503,24,58,323,699,.495,1413,629,.783,803,75,75,2892,107,217,2040,SG,146,268,430,MIA,.499
420,Von Wafer,4,.190,21,2,.118,17,4,20,0,3,6,.158,38,6,.750,8,16,0,73,5,12,20,SG,3,1,8,LAL,.184
421,Antoine Walker,254,.493,515,137,.358,383,166,29,30,318,391,.435,898,81,.628,129,82,19,2199,103,187,1000,PF,47,150,421,MIA,.512
422,Samaki Walker,0,.000,2,0,,0,0,29,1,3,0,.000,2,2,1.000,2,7,0,22,0,7,2,PF,0,2,3,IND,.000
423,Ben Wallace,237,.514,461,0,.000,4,158,31,181,622,237,.510,465,123,.416,296,82,82,2890,301,164,597,C,146,88,923,DET,.510
424,Gerald Wallace,303,.562,539,14,.280,50,96,23,115,289,317,.538,589,188,.614,306,55,52,1895,123,150,836,SF,138,99,412,CHA,.550
425,Rasheed Wallace,304,.480,633,155,.357,434,182,31,130,457,459,.430,1067,136,.743,183,80,80,2780,90,232,1209,PF,82,85,547,DET,.503
426,Matt Walsh,1,1.000,1,0,,0,0,23,0,0,1,1.000,1,0,.000,2,2,0,3,0,0,2,SG,0,1,0,MIA,1.000
427,Luke Walton,117,.429,273,18,.327,55,156,25,15,159,135,.412,328,57,.750,76,69,6,1333,88,119,345,SF,41,78,247,LAL,.439
428,Hakim Warrick,101,.443,228,0,,0,30,23,21,101,101,.443,228,76,.661,115,68,2,724,43,113,278,PF,14,56,144,MEM,.443
429,Earl Watson,109,.460,237,110,.404,272,289,26,10,134,219,.430,509,75,.676,111,70,10,1578,24,159,623,PG,68,136,158,TOT,.538
430,Chris Webber,596,.443,1345,21,.273,77,256,32,62,557,617,.434,1422,263,.756,348,75,75,2893,184,219,1518,PF,103,182,741,PHI,.441
431,Martell Webster,74,.446,166,65,.357,182,34,19,14,101,139,.399,348,61,.859,71,61,18,1070,29,90,404,SF,21,43,130,POR,.493
432,Bonzi Wells,274,.482,568,10,.222,45,144,29,25,259,284,.463,613,129,.679,190,52,41,1684,142,156,707,SG,94,126,401,SAC,.471
433,Jiri Welsch,72,.416,173,14,.286,49,62,26,1,89,86,.387,222,65,.747,87,58,2,866,22,65,251,SF,34,41,111,MIL,.419
434,David Wesley,127,.438,290,99,.365,271,204,35,6,154,226,.403,561,151,.807,187,71,59,2372,24,212,702,SG,59,120,178,HOU,.491
435,David West,527,.514,1025,3,.273,11,92,25,64,380,530,.512,1036,199,.843,236,74,74,2526,168,214,1262,PF,61,105,548,NOK,.513
436,Delonte West,249,.534,466,84,.385,218,329,22,46,232,333,.487,684,86,.851,101,71,71,2418,57,197,836,PG,84,133,289,BOS,.548
437,Robert Whaley,23,.404,57,0,,0,17,23,8,27,23,.404,57,3,.500,6,23,0,212,16,41,49,C,7,14,43,UTA,.404
438,Chris Wilcox,257,.574,448,0,.000,2,52,23,34,292,257,.571,450,112,.732,153,77,24,1529,118,183,626,C-PF,33,72,410,TOT,.571
439,Damien Wilkins,179,.472,379,14,.250,56,107,26,12,113,193,.444,435,136,.840,162,82,12,1525,79,144,536,SF,72,85,192,SEA,.460
440,Mike Wilks,26,.366,71,3,.158,19,32,26,1,30,29,.322,90,25,.610,41,47,0,348,9,34,86,PG,14,24,39,TOT,.339
441,Aaron Williams,91,.517,176,0,,0,17,34,21,117,91,.517,176,40,.690,58,48,5,791,64,138,222,C,17,30,181,TOT,.517
442,Alvin Williams,0,.000,1,0,.000,2,0,31,0,3,0,.000,3,1,.500,2,1,0,10,0,0,1,PG,0,0,3,TOR,.000
443,Deron Williams,248,.423,586,91,.416,219,359,21,17,159,339,.421,805,95,.704,135,80,47,2307,35,233,864,PG,60,145,194,UTA,.478
444,Eric Williams,24,.421,57,5,.278,18,15,33,2,40,29,.387,75,28,.737,38,28,11,352,10,55,91,SF,7,15,50,TOR,.420
445,Jason Williams,161,.506,318,107,.372,288,287,30,5,133,268,.442,606,85,.867,98,59,56,1874,6,101,728,PG,53,100,139,MIA,.531
446,Lou Williams,21,.488,43,2,.222,9,10,19,0,16,23,.442,52,8,.615,13,30,0,145,3,13,56,PG,5,13,19,PHI,.462
447,Marvin Williams,222,.464,478,13,.245,53,63,19,24,261,235,.443,531,189,.747,253,79,7,1952,122,227,672,PF,48,83,383,ATL,.455
448,Mo Williams,194,.443,438,73,.382,191,230,23,7,113,267,.424,629,96,.850,113,58,12,1531,30,146,703,PG,52,105,143,MIL,.483
449,Corliss Williamson,41,.406,101,2,1.000,2,14,32,4,46,43,.417,103,38,.776,49,37,0,362,21,56,126,SF,7,30,67,SAC,.427
450,Loren Woods,28,.483,58,0,.000,1,4,27,23,66,28,.475,59,6,.429,14,27,4,324,44,49,62,C,9,16,110,TOR,.475
451,Qyntel Woods,107,.552,194,22,.367,60,47,24,13,146,129,.508,254,49,.645,76,49,16,1013,44,96,329,SF,32,61,190,NYK,.551
452,Metta World Peace,272,.443,614,78,.308,253,203,26,41,211,350,.404,867,206,.675,305,56,56,2207,75,164,984,SF,122,131,286,TOT,.449
453,Antoine Wright,28,.424,66,1,.067,15,12,21,3,22,29,.358,81,11,.500,22,39,0,370,8,42,70,SG,4,21,30,NJN,.364
454,Bracey Wright,15,.441,34,6,.353,17,5,21,0,15,21,.412,51,14,.875,16,7,0,135,3,8,62,SG,1,8,18,MIN,.471
455,Dorell Wright,17,.459,37,3,.500,6,8,20,1,30,20,.465,43,15,.882,17,20,2,132,2,12,58,SF,3,14,32,MIA,.500
456,Lorenzen Wright,194,.480,404,0,.000,2,48,30,46,253,194,.478,406,66,.564,117,78,58,1689,142,201,454,C,52,67,395,MEM,.478
457,Derrick Zimmerman,2,.667,3,0,,0,7,24,0,3,2,.667,3,0,,0,2,0,32,1,4,4,PG,0,4,4,NJN,.667
