,Player_Name,2P,2P%,2PA,3P,3P%,3PA,AST,Age,BLK,DRB,FG,FG%,FGA,FT,FT%,FTA,Games,Games_Strated,Minutes_Played,ORB,PF,PTS,Position,STL,TOV,TRB,Team,eFG%
0,Shareef Abdur-Rahim,307,.484,634,3,.150,20,109,30,40,276,310,.474,654,170,.726,234,80,45,2015,122,243,793,C,53,116,398,SAC,.476
1,Hassan Adams,75,.560,134,0,.000,1,13,22,4,42,75,.556,135,24,.667,36,61,8,495,35,47,174,SG,17,22,77,NJN,.556
2,Maurice Ager,17,.309,55,5,.333,15,7,22,3,20,22,.314,70,20,.606,33,32,1,214,1,27,69,SG,4,15,21,DAL,.350
3,LaMarcus Aldridge,241,.505,477,0,.000,2,24,21,73,168,241,.503,479,83,.722,115,63,22,1392,144,186,565,C,22,43,312,POR,.503
4,Malik Allen,107,.416,257,0,.000,1,16,28,16,77,107,.415,258,28,.824,34,60,1,638,42,85,242,PF,17,21,119,CHI,.415
5,Ray Allen,340,.479,710,165,.372,443,228,31,11,190,505,.438,1153,279,.903,309,55,55,2219,57,113,1454,SG,82,154,247,SEA,.510
6,Tony Allen,125,.553,226,8,.242,33,56,25,12,89,133,.514,259,105,.784,134,33,18,805,35,87,379,SG,49,75,124,BOS,.529
7,Rafer Alston,191,.389,491,192,.363,529,444,30,10,253,383,.375,1020,130,.734,177,82,82,3040,29,195,1088,PG,129,170,282,HOU,.470
8,Lou Amundson,6,.400,15,0,,0,1,24,8,15,6,.400,15,4,.400,10,11,0,89,13,15,16,PF,1,5,28,TOT,.400
9,Alan Anderson,32,.525,61,5,.250,20,21,24,0,21,37,.457,81,19,.826,23,17,0,256,11,33,98,SG,7,22,32,CHA,.488
10,Derek Anderson,72,.507,142,54,.355,152,133,32,7,84,126,.429,294,93,.877,106,50,32,1190,29,115,399,SF,52,56,113,CHA,.520
11,Carmelo Anthony,651,.499,1304,40,.268,149,249,22,23,248,691,.476,1453,459,.808,568,65,65,2486,143,203,1881,SF,77,234,391,DEN,.489
12,Rafael Araujo,27,.415,65,0,,0,10,26,2,44,27,.415,65,18,.621,29,28,0,248,22,39,72,C,6,17,66,UTA,.415
13,Gilbert Arenas,442,.459,964,205,.351,584,443,25,13,277,647,.418,1548,606,.844,718,74,73,2942,61,249,2105,PG,139,236,338,WAS,.484
14,Trevor Ariza,200,.549,364,0,.000,7,65,21,19,151,200,.539,371,106,.620,171,57,7,1278,98,134,506,SG,59,84,249,ORL,.539
15,Darrell Armstrong,84,.515,163,72,.336,214,191,38,6,101,156,.414,377,73,.785,93,81,4,1275,34,102,457,PG,70,76,135,IND,.509
16,Hilton Armstrong,68,.544,125,0,,0,10,22,26,91,68,.544,125,40,.597,67,56,5,634,58,79,176,C,12,35,149,NOK,.544
17,Carlos Arroyo,189,.443,427,14,.275,51,202,27,2,103,203,.425,478,132,.795,166,72,5,1304,31,131,552,PG,39,90,134,ORL,.439
18,Chucky Atkins,194,.474,409,116,.379,306,346,32,4,121,310,.434,715,252,.810,311,75,23,2064,18,136,988,PG,50,127,139,MEM,.515
19,James Augustine,1,.333,3,0,,0,2,22,0,2,1,.333,3,0,,0,2,0,7,1,2,2,PF,0,0,3,ORL,.333
20,Kelenna Azubuike,64,.454,141,34,.430,79,28,23,10,68,98,.445,220,61,.782,78,41,9,669,26,49,291,SG,22,39,94,GSW,.523
21,Renaldo Balkman,134,.540,248,5,.185,27,44,22,44,197,139,.505,275,51,.567,90,68,1,1064,97,146,334,SF,57,49,294,NYK,.515
22,Marcus Banks,79,.473,167,5,.172,29,60,25,3,28,84,.429,196,48,.800,60,45,1,503,10,70,221,PG,23,40,38,PHO,.441
23,Leandro Barbosa,339,.504,673,190,.434,438,317,24,15,192,529,.476,1111,196,.845,232,80,18,2613,22,210,1444,SG,96,146,214,PHO,.562
24,J.J. Barea,22,.386,57,6,.286,21,24,22,1,18,28,.359,78,16,.667,24,33,1,191,7,19,78,PG,1,14,25,DAL,.397
25,Andrea Bargnani,167,.468,357,100,.373,268,50,21,53,203,267,.427,625,117,.824,142,65,2,1629,52,180,751,PF,32,107,255,TOR,.507
26,Matt Barnes,169,.500,338,106,.366,290,156,26,41,259,275,.438,628,90,.732,123,76,23,1813,91,188,746,PF,73,105,350,GSW,.522
27,Andre Barrett,4,.500,8,0,,0,7,24,0,4,4,.500,8,0,,0,6,0,29,1,4,8,PG,0,4,5,CHI,.500
28,Earl Barron,24,.293,82,0,.000,1,5,25,4,22,24,.289,83,17,.944,18,28,0,203,19,21,65,C,6,11,41,MIA,.289
29,Brent Barry,74,.536,138,128,.446,287,138,35,12,143,202,.475,425,103,.880,117,75,28,1631,17,88,635,SG,56,61,160,SAS,.626
30,Brandon Bass,15,.349,43,0,.000,1,3,21,3,30,15,.341,44,12,.750,16,21,3,162,13,16,42,PF,2,10,43,NOK,.341
31,Maceo Baston,46,.667,69,3,.429,7,16,31,18,53,49,.645,76,37,.787,47,47,2,405,21,65,138,PF,12,32,74,IND,.664
32,Esteban Batista,8,.500,16,0,,0,4,23,0,23,8,.500,16,4,.571,7,13,0,81,7,13,20,PF,3,4,30,ATL,.500
33,Tony Battie,176,.490,359,0,.000,1,35,30,30,252,176,.489,360,52,.675,77,66,66,1575,92,185,404,PF,29,61,344,ORL,.489
34,Shane Battier,135,.480,281,157,.421,373,175,28,60,271,292,.446,654,88,.779,113,82,82,2988,67,190,829,SF,79,72,338,HOU,.567
35,Charlie Bell,299,.488,613,127,.352,361,247,27,4,181,426,.437,974,131,.780,168,82,64,2848,57,213,1110,SG,97,104,238,MIL,.503
36,Raja Bell,205,.452,454,205,.413,496,196,30,22,203,410,.432,950,118,.776,152,78,78,2917,48,233,1143,SG,50,83,251,PHO,.539
37,Mike Bibby,298,.435,685,173,.360,481,388,28,6,224,471,.404,1166,288,.830,347,82,82,2784,39,139,1403,PG,88,197,263,SAC,.478
38,Andris Biedrins,348,.599,581,0,,0,88,20,136,511,348,.599,581,87,.521,167,82,63,2382,251,304,783,C,67,119,762,GSW,.599
39,Chauncey Billups,239,.479,499,109,.345,316,502,30,17,214,348,.427,815,386,.883,437,70,70,2533,23,161,1191,PG,84,140,237,DET,.494
40,Steve Blake,142,.472,301,67,.322,208,408,26,8,148,209,.411,509,43,.672,64,82,42,2225,21,121,528,PG,61,129,169,TOT,.476
41,Will Blalock,8,.320,25,1,.200,5,17,23,0,9,9,.300,30,6,1.000,6,14,0,166,6,9,25,PG,5,12,15,DET,.317
42,Andray Blatche,82,.482,170,4,.148,27,39,20,32,114,86,.437,197,30,.612,49,56,13,682,77,94,206,PF,17,49,191,WAS,.447
43,Mark Blount,418,.517,808,9,.290,31,67,31,58,369,427,.509,839,147,.754,195,82,81,2544,136,239,1010,C,43,159,505,MIN,.514
44,Keith Bogans,46,.426,108,53,.387,137,59,26,2,77,99,.404,245,47,.746,63,59,18,990,16,98,298,SG,28,46,93,ORL,.512
45,Andrew Bogut,347,.556,624,1,.200,5,198,22,35,416,348,.553,629,112,.577,194,66,66,2258,168,216,809,C,49,150,584,MIL,.554
46,Matt Bonner,70,.490,143,36,.383,94,22,26,11,92,106,.447,237,27,.711,38,56,0,653,64,67,275,PF,17,25,156,SAS,.523
47,Josh Boone,99,.579,171,0,,0,10,22,21,112,99,.579,171,56,.544,103,61,0,669,64,94,254,PF,11,33,176,NJN,.579
48,Calvin Booth,30,.469,64,1,.500,2,18,30,29,54,31,.470,66,6,.600,10,44,1,380,27,71,69,C,4,9,81,WAS,.477
49,Carlos Boozer,647,.561,1154,0,,0,221,25,21,632,647,.561,1154,255,.685,372,74,74,2557,235,217,1549,PF,70,194,867,UTA,.561
50,Chris Bosh,531,.501,1059,12,.343,35,175,22,90,555,543,.496,1094,463,.785,590,69,69,2658,186,163,1561,C,39,179,741,TOR,.502
51,Bruce Bowen,100,.426,235,89,.384,232,117,35,25,200,189,.405,467,43,.589,73,82,82,2464,23,175,510,SF,62,65,223,SAS,.500
52,Earl Boykins,228,.430,530,95,.397,239,291,30,2,90,323,.420,769,220,.898,245,66,23,2031,49,92,961,PG,56,120,139,TOT,.482
53,Cedric Bozeman,9,.346,26,2,.154,13,9,23,2,20,11,.282,39,2,.333,6,23,5,199,3,32,26,SG,5,9,23,ATL,.308
54,Elton Brand,644,.532,1210,1,1.000,1,235,27,179,476,645,.533,1211,351,.761,461,80,80,3077,268,238,1642,PF,77,202,744,LAC,.533
55,Ronnie Brewer,102,.554,184,0,.000,9,24,21,6,38,102,.528,193,56,.675,83,56,14,675,37,44,260,SG,37,24,75,UTA,.528
56,Primoz Brezec,121,.446,271,1,.333,3,23,27,23,104,122,.445,274,43,.632,68,58,40,838,80,161,288,C,11,38,184,CHA,.447
57,Andre Brown,42,.575,73,0,.000,1,2,25,4,48,42,.568,74,9,.600,15,38,0,271,26,26,93,PF,6,29,74,SEA,.568
58,Dee Brown,26,.371,70,6,.214,28,83,22,7,32,32,.327,98,24,.649,37,49,0,450,8,51,94,PG,22,31,40,UTA,.357
59,Devin Brown,152,.463,328,81,.357,227,149,28,9,196,233,.420,555,123,.794,155,58,49,1662,55,139,670,SG,44,91,251,NOK,.493
60,Kwame Brown,143,.593,241,0,.000,1,75,24,49,163,143,.591,242,59,.440,134,41,28,1132,81,124,345,C,39,76,244,LAL,.591
61,P.J. Brown,170,.409,416,0,.000,2,48,37,52,218,170,.407,418,96,.787,122,72,49,1456,129,187,436,PF,24,85,347,CHI,.407
62,Shannon Brown,21,.429,49,7,.280,25,10,21,3,15,28,.378,74,10,.714,14,23,5,202,6,24,73,SG,7,14,21,CLE,.426
63,Kobe Bryant,676,.497,1359,137,.344,398,413,28,36,364,813,.463,1757,667,.868,768,77,77,3140,75,205,2430,SG,111,255,439,LAL,.502
64,Greg Buckner,91,.464,196,32,.311,103,70,30,7,123,123,.411,299,27,.794,34,76,11,1372,35,152,305,SG,47,40,158,DAL,.465
65,Pat Burke,17,.395,43,6,.273,22,5,33,2,35,23,.354,65,8,.615,13,23,0,164,12,19,60,C,3,7,47,PHO,.400
66,Caron Butler,433,.480,903,18,.250,72,233,26,17,320,451,.463,975,283,.863,328,63,63,2474,147,188,1203,SF,134,181,467,WAS,.472
67,Jackie Butler,16,.457,35,0,,0,5,21,0,16,16,.457,35,9,.900,10,11,2,103,6,16,41,C,2,10,22,SAS,.457
68,Rasual Butler,180,.424,425,134,.369,363,63,27,54,214,314,.398,788,56,.644,87,81,38,2223,42,148,818,SF,40,67,256,NOK,.484
69,Andrew Bynum,247,.561,440,0,.000,3,94,19,128,345,247,.558,443,143,.668,214,82,53,1793,139,249,637,C,12,115,484,LAL,.558
70,Jose Calderon,238,.553,430,25,.333,75,387,25,5,113,263,.521,505,117,.818,143,77,11,1614,21,136,668,PG,63,110,134,TOR,.546
71,Marcus Camby,312,.475,657,0,.000,2,223,32,231,652,312,.473,659,161,.729,221,70,70,2369,164,183,785,C,87,122,816,DEN,.473
72,Brian Cardinal,24,.585,41,18,.409,44,31,29,1,46,42,.494,85,25,.926,27,28,1,313,13,42,127,PF,22,23,59,MEM,.600
73,Rodney Carney,157,.491,320,25,.347,72,26,22,23,89,182,.464,392,53,.609,87,67,35,1169,39,118,442,SF,38,43,128,PHI,.496
74,Matt Carroll,174,.445,391,111,.416,267,91,26,9,172,285,.433,658,188,.904,208,72,47,1878,35,176,869,SG,53,73,207,CHA,.517
75,Anthony Carter,3,.500,6,0,.000,2,11,31,1,3,3,.375,8,0,,0,2,0,37,0,4,6,PG,0,6,3,DEN,.375
76,Vince Carter,570,.491,1161,156,.357,437,393,30,30,378,726,.454,1598,462,.802,576,82,82,3126,114,266,2070,SG,82,217,492,NJN,.503
77,Sam Cassell,229,.444,516,32,.294,109,270,37,8,140,261,.418,625,160,.879,182,58,30,1407,27,126,714,PG,28,101,167,LAC,.443
78,Kelvin Cato,7,.318,22,0,,0,0,32,10,19,7,.318,22,8,.667,12,18,0,95,12,10,22,C,3,6,31,NYK,.318
79,Tyson Chandler,292,.625,467,0,.000,1,66,24,129,584,292,.624,468,106,.527,201,73,73,2525,320,244,690,C,37,126,904,NOK,.624
80,Josh Childress,235,.533,441,26,.338,77,127,23,36,217,261,.504,518,167,.795,210,55,13,2024,123,118,715,SG,58,80,340,ATL,.529
81,Doug Christie,4,.364,11,1,.167,6,8,36,1,8,5,.294,17,2,.667,3,7,0,82,3,11,13,SG,3,5,11,LAC,.324
82,Speedy Claxton,85,.340,250,6,.214,28,185,28,4,69,91,.327,278,33,.550,60,42,31,1054,12,131,221,PG,72,75,81,ATL,.338
83,Jarron Collins,75,.441,170,0,,0,60,28,8,100,75,.441,170,54,.651,83,82,9,913,71,147,204,C,13,37,171,UTA,.441
84,Jason Collins,55,.369,149,0,.000,2,46,28,38,226,55,.364,151,59,.465,127,80,78,1844,90,273,169,PF,40,73,316,NJN,.364
85,Mardy Collins,74,.409,181,13,.277,47,83,22,3,76,87,.382,228,48,.585,82,52,9,777,28,75,235,SF,32,57,104,NYK,.410
86,Nick Collison,318,.502,634,0,.000,2,82,26,66,437,318,.500,636,154,.774,199,82,56,2378,229,289,790,C,48,123,666,SEA,.500
87,Will Conroy,0,.000,3,0,,0,9,24,0,4,0,.000,3,0,.000,4,7,0,52,3,7,0,PG-SG,0,2,7,TOT,.000
88,Brian Cook,139,.474,293,46,.400,115,65,26,27,154,185,.453,408,34,.723,47,65,24,1018,61,134,450,PF,25,51,215,LAL,.510
89,Jamal Crawford,251,.445,564,103,.320,322,259,26,8,145,354,.400,886,228,.838,272,59,36,2198,44,114,1039,SG,57,162,189,NYK,.458
90,Austin Croshere,52,.397,131,26,.286,91,44,31,6,153,78,.351,222,45,.865,52,61,2,727,33,68,227,PF,14,33,186,DAL,.410
91,Eddy Curry,584,.575,1015,1,1.000,1,68,24,40,376,585,.576,1016,405,.615,659,81,81,2849,195,265,1576,C,34,295,571,NYK,.576
92,Samuel Dalembert,356,.543,656,0,.000,2,64,25,159,494,356,.541,658,167,.746,224,82,82,2535,239,287,879,C,47,161,733,PHI,.541
93,Erick Dampier,209,.626,334,0,,0,44,31,82,349,209,.626,334,119,.623,191,76,73,1915,217,239,537,C,24,107,566,DAL,.626
94,Antonio Daniels,153,.469,326,19,.302,63,290,31,9,133,172,.442,389,208,.832,250,80,8,1761,18,79,571,SG,39,69,151,WAS,.467
95,Marquis Daniels,123,.482,255,6,.231,26,57,26,7,56,129,.459,281,56,.700,80,45,4,800,26,56,320,SG,27,55,82,IND,.470
96,Baron Davis,367,.489,750,85,.304,280,509,27,29,225,452,.439,1030,275,.745,369,63,62,2221,51,181,1264,PG,135,193,276,GSW,.480
97,Dale Davis,33,.446,74,0,,0,12,37,34,78,33,.446,74,17,.654,26,46,6,464,59,59,83,C,10,15,137,DET,.446
98,Paul Davis,22,.423,52,0,,0,7,22,5,23,22,.423,52,7,.700,10,31,0,180,21,28,51,C,6,8,44,LAC,.423
99,Ricky Davis,383,.492,779,123,.397,310,385,27,23,261,506,.465,1089,239,.839,285,81,81,3021,54,189,1374,SF,80,210,315,MIN,.521
100,Carlos Delfino,110,.462,238,46,.333,138,88,24,8,199,156,.415,376,70,.787,89,82,1,1372,67,97,428,SG,46,61,266,DET,.476
101,Luol Deng,629,.519,1211,1,.143,7,204,21,48,431,630,.517,1218,279,.777,359,82,82,3071,148,167,1540,SF,97,153,579,CHI,.518
102,Boris Diaw,291,.555,524,15,.333,45,352,24,38,226,306,.538,569,82,.683,120,73,59,2268,91,177,709,PF,28,154,317,PHO,.551
103,Yakhouba Diawara,51,.418,122,49,.288,170,55,24,7,83,100,.342,292,35,.660,53,64,19,1177,27,132,284,SG,30,37,110,DEN,.426
104,Dan Dickau,38,.422,90,16,.262,61,70,28,1,36,54,.358,151,42,.792,53,50,3,444,7,55,166,PG,14,27,43,POR,.411
105,Travis Diener,16,.533,30,18,.360,50,35,24,0,15,34,.425,80,12,.800,15,26,0,288,3,27,98,PG,4,13,18,ORL,.538
106,Ike Diogu,127,.477,266,0,,0,25,23,26,128,127,.477,266,112,.800,140,59,2,760,75,122,366,PF,8,67,203,TOT,.477
107,DeSagana Diop,71,.473,150,0,.000,1,30,25,113,272,71,.470,151,48,.558,86,81,9,1480,166,244,190,C,40,63,438,DAL,.470
108,Juan Dixon,220,.461,477,79,.350,226,123,28,9,131,299,.425,703,101,.871,116,81,6,1926,27,177,778,SG,76,101,158,TOT,.482
109,Michael Doleac,82,.471,174,0,.000,1,22,29,15,111,82,.469,175,36,.878,41,56,0,698,44,96,200,C,18,30,155,MIA,.469
110,Keyon Dooling,157,.434,362,31,.323,96,112,26,15,64,188,.410,458,114,.809,141,66,2,1435,22,125,521,SG,52,72,86,ORL,.444
111,Quincy Douby,36,.474,76,12,.240,50,15,22,4,26,48,.381,126,11,.733,15,42,0,359,11,21,119,PG,15,15,37,SAC,.429
112,Chris Duhon,109,.458,238,88,.359,245,310,24,6,146,197,.408,483,76,.752,101,78,30,1906,23,150,558,PG,69,105,169,CHI,.499
113,Tim Duncan,617,.550,1122,1,.111,9,273,30,190,633,618,.546,1131,362,.637,568,80,80,2726,213,203,1599,C,66,224,846,SAS,.547
114,Mike Dunleavy,314,.502,626,70,.313,224,228,26,22,347,384,.452,850,211,.784,269,82,49,2580,84,203,1049,SG-PF,84,149,431,TOT,.493
115,Ronald Dupree,11,.355,31,0,,0,5,26,1,12,11,.355,31,3,.333,9,19,0,94,5,12,25,SF,5,3,17,DET,.355
116,Monta Ellis,441,.509,867,39,.273,143,319,21,21,181,480,.475,1010,273,.763,358,77,53,2638,62,210,1272,SG,132,221,243,GSW,.495
117,Francisco Elson,144,.514,280,0,.000,2,55,30,59,255,144,.511,282,62,.775,80,70,41,1332,81,184,350,C,31,86,336,SAS,.511
118,Melvin Ely,29,.363,80,0,,0,18,28,8,38,29,.363,80,31,.660,47,30,0,309,15,51,89,PF-C,6,28,53,TOT,.363
119,Maurice Evans,186,.455,409,48,.361,133,74,28,14,128,234,.432,542,122,.787,155,76,10,1732,93,126,638,SG,38,57,221,LAL,.476
120,Reggie Evans,117,.544,215,0,,0,45,26,16,304,117,.544,215,91,.497,183,66,11,1127,156,144,325,PF,42,95,460,DEN,.544
121,Daniel Ewing,51,.436,117,14,.318,44,90,23,4,64,65,.404,161,35,.778,45,61,3,712,9,62,179,PG,32,50,73,LAC,.447
122,Jordan Farmar,79,.503,157,45,.328,137,137,20,7,97,124,.422,294,27,.711,38,72,2,1090,22,77,320,PG,44,73,119,LAL,.498
123,Desmon Farmer,3,.429,7,2,.250,8,9,25,0,1,5,.333,15,1,1.000,1,8,0,32,0,2,13,SG,1,1,1,SEA,.400
124,Raymond Felton,290,.407,712,103,.330,312,545,22,10,216,393,.384,1024,204,.797,256,78,75,2832,51,180,1093,PG,118,230,267,CHA,.434
125,Michael Finley,169,.448,377,104,.364,286,108,33,16,189,273,.412,663,90,.918,98,82,16,1823,34,76,740,SF,32,46,223,SAS,.490
126,Derek Fisher,210,.405,519,48,.308,156,274,32,6,119,258,.382,675,262,.853,307,82,61,2287,30,234,826,SG,83,120,149,UTA,.418
127,T.J. Ford,372,.447,833,21,.304,69,595,23,8,183,393,.436,902,240,.819,293,75,71,2243,53,186,1047,PG,101,231,236,TOR,.447
128,Danny Fortson,15,.517,29,0,.000,1,1,30,0,30,15,.500,30,10,.769,13,14,6,158,13,38,40,C,1,15,43,SEA,.500
129,Jeff Foster,122,.471,259,0,.000,1,57,30,37,356,122,.469,260,78,.639,122,75,43,1740,253,202,322,C,62,70,609,IND,.469
130,Randy Foye,232,.458,506,68,.368,185,232,23,21,169,300,.434,691,164,.854,192,82,12,1879,49,184,832,PG,53,152,218,MIN,.483
131,Adonal Foyle,48,.565,85,0,,0,19,31,50,75,48,.565,85,11,.440,25,48,6,475,51,61,107,C,11,23,126,GSW,.565
132,Steve Francis,98,.422,232,42,.378,111,170,29,12,124,140,.408,343,175,.829,211,44,30,1237,33,126,497,SG,41,100,157,NYK,.469
133,Matt Freije,13,.406,32,3,.136,22,7,25,1,16,16,.296,54,5,.833,6,19,0,147,8,13,40,PF,3,3,24,ATL,.324
134,Channing Frye,295,.440,671,3,.167,18,67,23,42,304,298,.433,689,85,.787,108,72,59,1896,91,216,684,PF,36,100,395,NYK,.435
135,Dan Gadzuric,108,.476,227,0,.000,1,29,28,32,152,108,.474,228,42,.467,90,54,8,840,94,141,258,C,22,49,246,MIL,.474
136,Jorge Garbajosa,156,.464,336,66,.342,193,125,29,15,282,222,.420,529,57,.731,78,67,60,1909,48,90,567,PF,78,64,330,TOR,.482
137,Francisco Garcia,110,.476,231,53,.356,149,87,25,43,152,163,.429,380,95,.833,114,79,5,1410,53,190,474,SF,45,70,205,SAC,.499
138,Kevin Garnett,626,.487,1285,12,.214,56,313,30,126,792,638,.476,1341,416,.835,498,76,76,2995,183,184,1704,PF,89,205,975,MIN,.480
139,Pat Garrity,11,.289,38,11,.344,32,14,30,0,30,22,.314,70,16,.889,18,33,0,277,12,37,71,PF,7,14,42,ORL,.393
140,Pau Gasol,459,.542,847,3,.273,11,201,26,126,432,462,.538,858,299,.748,400,59,59,2133,149,137,1226,C,29,162,581,MEM,.540
141,Rudy Gay,269,.436,617,52,.364,143,100,20,74,255,321,.422,760,152,.727,209,78,43,2103,93,192,846,SF,71,140,348,MEM,.457
142,Mickael Gelabale,111,.512,217,11,.234,47,56,23,22,114,122,.462,264,66,.805,82,70,14,1239,59,108,321,SF,24,49,173,SEA,.483
143,Devean George,93,.423,220,53,.353,150,33,29,23,156,146,.395,370,36,.750,48,60,17,1283,57,143,381,SF,46,51,213,DAL,.466
144,Daniel Gibson,46,.430,107,52,.419,124,69,20,8,64,98,.424,231,28,.718,39,60,16,988,28,94,276,PG,23,44,92,CLE,.537
145,Manu Ginobili,268,.505,531,128,.396,323,263,29,27,268,396,.464,854,320,.860,372,75,36,2060,59,155,1240,SG,109,157,327,SAS,.539
146,Gordan Giricek,124,.479,259,52,.426,122,63,29,5,105,176,.462,381,71,.816,87,61,6,1188,24,122,475,SG,28,64,129,UTA,.530
147,Andreas Glyniadakis,8,.471,17,0,,0,1,25,0,6,8,.471,17,1,.500,2,13,4,81,2,19,17,C,0,9,8,SEA,.471
148,Ryan Gomes,322,.473,681,16,.381,42,119,24,13,282,338,.467,723,189,.811,233,73,60,2275,125,169,881,PF,48,105,407,BOS,.479
149,Drew Gooden,370,.476,778,1,.167,6,88,25,28,418,371,.473,784,142,.714,199,80,80,2238,263,210,885,PF,70,115,681,CLE,.474
150,Ben Gordon,454,.471,963,155,.413,375,296,23,17,223,609,.455,1338,380,.864,440,82,51,2704,35,252,1753,SG,64,249,258,CHI,.513
151,Joey Graham,183,.513,357,9,.290,31,44,24,4,193,192,.495,388,110,.840,131,79,21,1319,55,161,503,SF,30,49,248,TOR,.506
152,Stephen Graham,14,.483,29,3,.273,11,5,24,1,15,17,.425,40,8,.889,9,14,1,165,6,25,45,SG,4,13,21,POR,.463
153,Danny Granger,288,.497,580,110,.382,288,114,23,61,267,398,.459,868,236,.803,294,82,57,2785,114,245,1142,SF,67,135,381,IND,.522
154,Gerald Green,215,.447,481,95,.368,258,83,21,24,140,310,.419,739,128,.805,159,81,26,1780,68,198,843,SF,41,120,208,BOS,.484
155,Willie Green,306,.430,711,51,.325,157,112,25,4,116,357,.411,868,74,.667,111,74,36,1842,42,144,839,SG,56,106,158,PHI,.441
156,Orien Greene,21,.412,51,2,.182,11,22,24,4,32,23,.371,62,15,.600,25,41,0,254,12,38,63,SG,17,28,44,IND,.387
157,Lynn Greer,43,.483,89,18,.346,52,53,27,1,25,61,.433,141,27,.844,32,41,0,432,2,32,167,SG,17,18,27,MIL,.496
158,Adrian Griffin,61,.496,123,0,.000,6,59,32,4,69,61,.473,129,15,.789,19,54,1,585,40,78,137,SF,32,38,109,CHI,.473
159,Eddie Griffin,7,.269,26,0,.000,1,4,24,7,18,7,.259,27,4,.800,5,13,0,92,7,8,18,PF,0,6,25,MIN,.259
160,Mike Hall,1,.250,4,0,,0,1,22,0,1,1,.250,4,0,,0,2,0,13,1,1,2,SF,0,0,2,WAS,.250
161,Richard Hamilton,503,.483,1041,44,.341,129,285,28,15,207,547,.468,1170,347,.861,403,75,75,2763,75,232,1485,SG,59,159,282,DET,.486
162,Matt Harpring,309,.501,617,13,.333,39,99,30,11,236,322,.491,656,237,.767,309,77,2,1965,117,232,894,SF,52,118,353,UTA,.501
163,Al Harrington,368,.466,790,127,.433,293,149,26,24,345,495,.457,1083,168,.694,242,78,78,2563,151,269,1285,PF,65,169,496,TOT,.516
164,Junior Harrington,50,.450,111,7,.269,26,89,26,5,56,57,.416,137,31,.674,46,29,8,543,12,79,152,PG,21,52,68,MEM,.442
165,Othella Harrington,25,.446,56,0,,0,6,33,1,25,25,.446,56,17,.773,22,26,0,220,13,49,67,PF,1,15,38,CHA,.446
166,Devin Harris,278,.512,543,14,.280,50,296,23,21,151,292,.492,593,215,.824,261,80,61,2081,45,242,813,PG,96,146,196,DAL,.504
167,David Harrison,30,.517,58,0,,0,6,24,12,33,30,.517,58,11,.500,22,24,2,190,9,47,71,C,5,26,42,IND,.517
168,Jason Hart,93,.477,195,7,.241,29,103,28,1,84,100,.446,224,42,.894,47,36,22,846,14,83,249,PG,44,38,98,TOT,.462
169,Udonis Haslem,353,.495,713,0,.000,4,97,26,26,466,353,.492,717,138,.680,203,79,79,2483,188,236,844,PF,49,110,654,MIA,.492
170,Trenton Hassell,211,.505,418,6,.240,25,203,27,26,160,217,.490,443,72,.783,92,76,68,2223,83,144,512,SG,22,80,243,MIN,.497
171,Chuck Hayes,192,.573,335,0,,0,47,23,18,317,192,.573,335,55,.618,89,78,43,1714,204,281,439,PF,70,64,521,HOU,.573
172,Jarvis Hayes,158,.435,363,66,.361,183,80,25,13,168,224,.410,546,71,.845,84,81,17,1626,42,160,585,SF,48,56,210,WAS,.471
173,Brendan Haywood,198,.558,355,0,,0,47,27,88,282,198,.558,355,115,.548,210,77,49,1740,195,208,511,C,34,90,477,WAS,.558
174,Luther Head,129,.431,299,177,.441,401,194,24,5,221,306,.437,700,83,.790,105,80,10,2211,31,133,872,SG,76,137,252,HOU,.564
175,Alan Henderson,43,.642,67,0,,0,10,34,12,59,43,.642,67,33,.702,47,38,5,418,48,62,119,PF,9,12,107,PHI,.642
176,Walter Herrmann,121,.563,215,53,.461,115,26,27,7,111,174,.527,330,41,.774,53,48,12,936,28,76,442,PF,17,32,139,CHA,.608
177,Nene Hilario,294,.571,515,0,.000,1,77,24,59,299,294,.570,516,195,.689,283,64,42,1715,150,209,783,C,62,127,449,DEN,.570
178,Grant Hill,340,.525,648,2,.167,12,138,34,25,184,342,.518,660,248,.765,324,65,64,2009,53,146,934,SG,61,144,237,ORL,.520
179,Kirk Hinrich,335,.463,724,140,.415,337,500,26,23,242,475,.448,1061,237,.835,284,80,80,2839,32,274,1327,PG,100,191,274,CHI,.514
180,Robert Hite,14,.378,37,5,.217,23,8,23,2,12,19,.317,60,8,.667,12,12,0,136,4,8,51,SG,3,6,16,MIA,.358
181,Julius Hodge,6,.500,12,0,,0,12,23,0,6,6,.500,12,3,.750,4,9,1,65,2,6,15,SG,4,3,8,TOT,.500
182,Ryan Hollins,20,.556,36,0,,0,1,22,7,20,20,.556,36,24,.600,40,27,0,185,11,40,64,C,4,16,31,CHA,.556
183,Robert Horry,40,.392,102,50,.336,149,77,36,41,156,90,.359,251,38,.594,64,68,8,1124,73,105,268,PF,45,44,229,SAS,.458
184,Eddie House,105,.427,246,75,.429,175,67,28,3,78,180,.428,421,33,.917,36,56,1,946,14,69,468,SG,27,27,92,NJN,.517
185,Dwight Howard,525,.603,871,1,.500,2,158,21,156,725,526,.603,873,390,.586,666,82,82,3023,283,245,1443,C,70,317,1008,ORL,.603
186,Josh Howard,401,.480,836,92,.385,239,127,26,56,345,493,.459,1075,243,.827,294,70,69,2455,130,180,1321,SF,82,123,475,DAL,.501
187,Juwan Howard,309,.465,665,0,,0,131,33,8,332,309,.465,665,155,.824,188,80,38,2123,138,205,773,PF,29,112,470,HOU,.465
188,Troy Hudson,46,.400,115,28,.350,80,73,30,2,40,74,.379,195,26,.813,32,34,6,554,8,23,202,PG,14,40,48,MIN,.451
189,Larry Hughes,307,.420,731,74,.333,222,256,28,26,226,381,.400,953,209,.676,309,70,68,2596,41,164,1045,SG,89,154,267,CLE,.439
190,Kris Humphries,87,.470,185,0,,0,18,21,21,109,87,.470,185,53,.671,79,60,2,670,78,98,227,PF,14,32,187,TOR,.470
191,Lindsey Hunter,56,.448,125,38,.319,119,93,36,7,38,94,.385,244,30,.909,33,52,0,745,9,56,256,PG,34,35,47,DET,.463
192,Steven Hunter,188,.577,326,0,,0,26,25,76,221,188,.577,326,74,.490,151,70,41,1605,114,137,450,PF,13,65,335,PHI,.577
193,Andre Iguodala,395,.472,836,48,.310,155,432,23,33,357,443,.447,991,452,.820,551,76,76,3062,77,200,1386,SG,152,261,434,PHI,.471
194,Zydrunas Ilgauskas,385,.486,792,0,.000,1,123,31,98,357,385,.485,793,155,.807,192,78,78,2130,242,257,925,C,48,141,599,CLE,.485
195,Mile Ilic,0,.000,3,0,,0,0,22,0,1,0,.000,3,0,,0,5,0,6,0,1,0,C,0,3,1,NJN,.000
196,Didier Ilunga-Mbenga,5,.313,16,0,,0,6,26,5,8,5,.313,16,7,.875,8,21,0,79,3,17,17,C,3,5,11,DAL,.313
197,Ersan Ilyasova,85,.395,215,54,.365,148,49,19,17,131,139,.383,363,70,.787,89,66,14,973,58,147,402,PF,27,51,189,MIL,.457
198,Allen Iverson*,519,.465,1116,62,.315,197,468,31,13,170,581,.442,1313,485,.795,610,65,64,2761,23,95,1709,SG-PG,123,268,193,TOT,.466
199,Royal Ivey,59,.465,127,5,.313,16,45,25,4,36,64,.448,143,24,.686,35,53,18,539,15,62,157,PG,24,31,51,ATL,.465
200,Jarrett Jack,257,.490,525,63,.350,180,417,23,9,190,320,.454,705,243,.871,279,79,79,2651,18,202,946,PG,86,187,208,POR,.499
201,Bobby Jackson,150,.425,353,54,.327,165,141,33,6,136,204,.394,518,130,.774,168,56,2,1330,42,98,592,SG,50,78,178,NOK,.446
202,Luke Jackson,14,.538,26,5,.294,17,13,25,1,8,19,.442,43,5,.556,9,13,2,138,2,15,48,SF,5,7,10,TOT,.500
203,Marc Jackson,159,.411,387,0,.000,1,58,32,7,130,159,.410,388,90,.874,103,56,25,1025,62,89,408,PF,21,65,192,NOK,.410
204,Stephen Jackson,309,.488,633,100,.322,311,287,28,34,161,409,.433,944,243,.813,299,75,69,2479,61,200,1161,SF-SG,84,183,222,TOT,.486
205,Jerome James,33,.418,79,0,,0,3,31,15,45,33,.418,79,10,.556,18,41,11,273,21,73,76,C,6,23,66,NYK,.418
206,LeBron James,673,.513,1311,99,.319,310,470,22,55,443,772,.476,1621,489,.698,701,78,78,3190,83,171,2132,SF,125,250,526,CLE,.507
207,Mike James,217,.445,488,80,.372,215,297,31,7,138,297,.422,703,154,.837,184,82,65,2069,25,171,828,PG,55,129,163,MIN,.479
208,Antawn Jamison,374,.492,760,138,.364,379,136,30,36,428,512,.450,1139,226,.736,307,70,70,2662,134,194,1388,PF,80,104,562,WAS,.510
209,Marko Jaric,104,.433,240,32,.376,85,145,28,16,130,136,.418,325,67,.761,88,70,13,1555,54,172,371,SG,75,88,184,MIN,.468
210,Sarunas Jasikevicius,84,.438,192,44,.338,130,172,30,1,54,128,.398,322,86,.905,95,63,3,973,15,75,386,SG-PG,26,90,69,TOT,.466
211,Al Jefferson,453,.514,881,0,.000,1,88,22,106,519,453,.514,882,201,.681,295,69,60,2319,237,232,1107,C,48,136,756,BOS,.514
212,Richard Jefferson,251,.483,520,52,.359,145,148,26,8,192,303,.456,665,239,.733,326,55,53,1956,48,123,897,SF,34,120,240,NJN,.495
213,Jared Jeffries,93,.500,186,2,.100,20,67,25,30,127,95,.461,206,31,.456,68,55,43,1307,111,150,223,SF,44,61,238,NYK,.466
214,Alexander Johnson,91,.538,169,0,,0,17,23,35,131,91,.538,169,78,.661,118,59,19,753,50,137,260,PF,25,47,181,MEM,.538
215,Amir Johnson,18,.600,30,0,.000,3,3,19,13,22,18,.545,33,11,.786,14,8,0,124,15,19,47,PF,5,9,37,DET,.545
216,Anthony Johnson,117,.433,270,25,.342,73,201,32,3,79,142,.414,343,46,.754,61,67,17,1301,22,119,355,PG,33,76,101,TOT,.450
217,DerMarr Johnson,31,.470,66,19,.216,88,17,26,12,47,50,.325,154,16,.762,21,39,7,419,10,39,135,SF,16,27,57,DEN,.386
218,Joe Johnson,417,.504,827,119,.381,312,249,25,11,186,536,.471,1139,235,.748,314,57,57,2359,53,115,1426,SG,60,176,239,ATL,.523
219,Linton Johnson,83,.519,160,10,.333,30,18,26,18,111,93,.489,190,30,.811,37,54,0,720,52,101,226,PF,33,27,163,NOK,.516
220,Bobby Jones,42,.500,84,1,.111,9,16,23,1,35,43,.462,93,23,.561,41,44,5,336,22,59,110,SF,11,18,57,PHI,.468
221,Dahntay Jones,215,.479,449,5,.417,12,68,26,22,106,220,.477,461,138,.793,174,78,25,1671,47,192,583,SG,39,92,153,MEM,.483
222,Damon Jones,48,.387,124,89,.385,231,94,30,2,57,137,.386,355,30,.682,44,60,0,1173,9,53,393,PG,16,36,66,CLE,.511
223,Dwayne Jones,0,.000,1,0,,0,0,23,0,5,0,.000,1,3,.500,6,4,0,18,1,3,3,PF,0,2,6,CLE,.000
224,Eddie Jones,100,.500,200,78,.351,222,109,35,10,159,178,.422,422,59,.787,75,64,41,1594,31,124,493,SG,68,47,190,TOT,.514
225,Fred Jones,100,.429,233,39,.305,128,108,27,16,92,139,.385,361,95,.833,114,63,12,1319,23,121,412,SG,48,67,115,TOT,.439
226,James Jones,72,.356,202,90,.378,238,45,26,42,143,162,.368,440,71,.877,81,76,7,1376,33,115,485,SF,28,28,176,PHO,.470
227,Jumaine Jones,4,.211,19,10,.313,32,1,27,1,17,14,.275,51,2,1.000,2,18,0,138,6,19,40,SF,5,7,23,PHO,.373
228,Solomon Jones,65,.512,127,0,.000,1,11,22,42,87,65,.508,128,59,.787,75,58,8,666,49,124,189,PF,11,25,136,ATL,.508
229,Chris Kaman,294,.452,651,0,.000,1,79,24,116,428,294,.451,652,166,.741,224,75,66,2176,160,251,754,C,41,147,588,LAC,.451
230,Jason Kapono,170,.482,353,108,.514,210,81,25,2,154,278,.494,563,66,.892,74,67,35,1767,26,135,730,SF,38,70,180,MIA,.590
231,Viktor Khryapa,27,.422,64,0,.000,6,21,24,1,37,27,.386,70,19,.731,26,33,0,231,20,53,73,PF,10,16,57,CHI,.386
232,Jason Kidd,245,.448,547,124,.343,361,736,33,23,520,369,.406,908,179,.778,230,80,80,2933,135,146,1041,PG,127,213,655,NJN,.475
233,Tarence Kinsey,126,.488,258,13,.283,46,41,22,1,68,139,.457,304,78,.796,98,48,12,967,29,57,369,SG,53,46,97,MEM,.479
234,Andrei Kirilenko,181,.528,343,16,.213,75,202,25,144,241,197,.471,418,174,.728,239,70,70,2049,88,172,584,SF,74,135,329,UTA,.490
235,Linas Kleiza,117,.462,253,83,.376,221,45,22,14,189,200,.422,474,115,.852,135,79,14,1488,77,200,598,PF,28,79,266,DEN,.509
236,Brevin Knight,151,.438,345,1,.056,18,296,31,3,101,152,.419,363,103,.805,128,45,25,1273,14,113,408,PG,67,95,115,CHA,.420
237,Yaroslav Korolev,3,.273,11,1,.200,5,4,19,0,2,4,.250,16,3,.500,6,10,0,41,1,0,12,SF,3,1,3,LAC,.281
238,Kyle Korver,240,.446,538,132,.430,307,105,25,20,229,372,.440,845,191,.914,209,74,1,2288,30,188,1067,SF,57,117,259,PHI,.518
239,Nenad Krstic,170,.528,322,0,.000,1,46,23,24,125,170,.526,323,86,.711,121,26,26,848,51,88,426,C,10,52,176,NJN,.526
240,Raef LaFrentz,37,.468,79,2,.087,23,8,30,11,45,39,.382,102,20,.769,26,27,9,352,25,57,100,PF,7,13,70,POR,.392
241,James Lang,4,.444,9,0,,0,2,23,3,6,4,.444,9,3,.600,5,11,0,55,5,14,11,C,0,2,11,WAS,.444
242,David Lee,240,.600,400,0,,0,104,23,23,406,240,.600,400,141,.815,173,58,12,1731,196,155,621,PF,48,92,602,NYK,.600
243,Rashard Lewis,312,.505,618,151,.390,387,145,27,39,305,463,.461,1005,265,.841,315,60,60,2348,91,143,1342,SF,68,118,396,SEA,.536
244,Randy Livingston,0,.000,3,0,,0,4,31,0,0,0,.000,3,0,,0,4,0,26,1,2,0,PG,0,1,1,SEA,.000
245,Shaun Livingston,203,.469,433,5,.313,16,274,21,29,128,208,.463,449,82,.707,116,54,31,1611,56,135,503,PG,59,108,184,LAC,.469
246,Kyle Lowry,11,.367,30,3,.375,8,32,20,1,19,14,.368,38,25,.893,28,10,0,175,12,20,56,PG,14,12,31,MEM,.408
247,John Lucas III,47,.485,97,15,.254,59,33,24,0,27,62,.397,156,15,.789,19,47,0,383,9,38,154,PG,17,15,36,HOU,.446
248,Tyronn Lue,162,.446,363,56,.348,161,201,29,0,85,218,.416,524,144,.883,163,56,17,1488,19,101,636,PG,24,85,104,ATL,.469
249,Mark Madsen,23,.535,43,0,,0,10,31,10,52,23,.535,43,15,.517,29,56,0,473,35,100,61,C,10,21,87,MIN,.535
250,Corey Maggette,354,.476,743,13,.200,65,208,27,14,352,367,.454,808,519,.820,633,75,31,2291,90,244,1266,SF,65,201,442,LAC,.462
251,Jamaal Magloire,199,.504,395,0,,0,30,28,66,341,199,.504,395,131,.541,242,81,23,1703,151,226,529,C,21,129,492,POR,.504
252,Renaldo Major,2,.200,10,0,,0,0,24,0,2,2,.200,10,1,.500,2,1,0,27,0,4,5,PF,2,1,2,GSW,.200
253,Stephon Marbury,272,.448,607,123,.357,345,403,29,10,177,395,.415,952,297,.769,386,74,74,2748,36,185,1210,PG,71,179,213,NYK,.480
254,Shawn Marion,481,.587,819,80,.317,252,134,28,122,613,561,.524,1071,201,.810,248,80,80,3010,172,216,1403,SF,156,114,785,PHO,.561
255,Damir Markota,13,.361,36,6,.375,16,6,21,1,20,19,.365,52,7,.636,11,30,0,170,11,22,51,PF,3,15,31,MIL,.423
256,Sean Marks,2,.400,5,0,.000,1,0,31,1,3,2,.333,6,2,1.000,2,3,0,17,0,4,6,PF,0,0,3,PHO,.333
257,Donyell Marshall,114,.514,222,95,.351,271,46,33,43,237,209,.424,493,53,.663,80,81,0,1360,86,130,566,PF,39,67,323,CLE,.520
258,Rawle Marshall,28,.394,71,4,.222,18,13,24,5,21,32,.360,89,31,.689,45,40,2,361,8,22,99,SG,12,19,29,IND,.382
259,Darrick Martin,20,.351,57,13,.351,37,43,35,0,10,33,.351,94,15,.714,21,31,0,220,2,22,94,PG,3,12,12,TOR,.420
260,Kenyon Martin,8,.533,15,0,.000,1,1,29,0,14,8,.500,16,3,.250,12,2,2,63,6,10,19,PF,0,5,20,DEN,.500
261,Kevin Martin,378,.515,734,127,.381,333,173,23,11,273,505,.473,1067,481,.844,570,80,80,2818,69,181,1618,SG,98,135,342,SAC,.533
262,Desmond Mason,407,.452,900,0,,0,115,29,22,221,407,.452,900,214,.663,323,75,75,2575,124,174,1028,SF,52,192,345,NOK,.452
263,Roger Mason,26,.338,77,33,.324,102,35,26,6,38,59,.330,179,14,.875,16,62,0,492,7,66,165,SG,13,19,45,WAS,.422
264,Jason Maxiell,131,.500,262,0,,0,14,23,60,98,131,.500,262,72,.526,137,67,8,943,88,110,334,C,30,53,186,DET,.500
265,Sean May,162,.498,325,2,.667,3,66,22,24,160,164,.500,328,86,.768,112,35,8,838,73,100,416,PF,19,56,233,CHA,.503
266,Rashad McCants,42,.412,102,20,.267,75,38,22,7,33,62,.350,177,40,.690,58,37,0,554,14,71,184,SG,26,40,47,MIN,.407
267,Chris McCray,0,.000,3,0,,0,0,22,0,0,0,.000,3,0,,0,5,0,12,0,1,0,SG,0,2,0,MIL,.000
268,Antonio McDyess,284,.526,540,0,,0,72,32,65,331,284,.526,540,96,.691,139,82,3,1729,165,240,664,PF,61,75,496,DET,.526
269,Ivan McFarlin,5,.417,12,0,.000,1,1,24,0,4,5,.385,13,5,.714,7,11,0,41,7,8,15,PF,0,1,11,PHI,.385
270,Tracy McGrady*,512,.466,1099,126,.331,381,458,27,36,322,638,.431,1480,345,.707,488,71,71,2539,56,136,1747,SG,92,213,378,HOU,.474
271,Jeff McInnis,70,.405,173,1,.125,8,124,32,0,48,71,.392,181,22,.688,32,38,3,702,14,72,165,PG,14,42,62,CHA,.395
272,Aaron McKie,11,.647,17,0,,0,13,34,0,17,11,.647,17,0,,0,10,0,131,1,14,22,SF,4,8,18,LAL,.647
273,Keith McLeod,57,.399,143,16,.356,45,90,27,5,39,73,.388,188,69,.885,78,48,9,718,4,51,231,PG,24,46,43,TOT,.431
274,Stanislav Medvedenko,11,.407,27,1,.500,2,2,27,2,10,12,.414,29,17,.850,20,14,0,81,4,16,42,C,0,5,14,ATL,.431
275,Pops Mensah-Bonsu,11,.647,17,0,,0,0,23,0,12,11,.647,17,7,.389,18,12,0,71,9,8,29,PF,1,9,21,DAL,.647
276,C.J. Miles,33,.393,84,7,.219,32,25,19,4,24,40,.345,116,14,.609,23,37,13,373,11,60,101,SG,11,28,35,UTA,.375
277,Darko Milicic,249,.455,547,0,.000,1,90,21,140,292,249,.454,548,141,.613,230,80,16,1913,145,219,639,PF,44,124,437,ORL,.454
278,Andre Miller,419,.479,874,5,.143,35,625,30,10,255,424,.466,909,222,.784,283,80,79,2966,97,184,1075,PG,110,222,352,TOT,.469
279,Brad Miller,219,.475,461,5,.152,33,224,30,39,322,224,.453,494,115,.772,149,63,56,1783,79,155,568,C,38,108,401,SAC,.459
280,Mike Miller,263,.514,512,202,.406,498,298,26,18,326,465,.460,1010,161,.793,203,70,69,2740,52,138,1293,SG,54,179,378,MEM,.560
281,Paul Millsap,208,.527,395,1,.333,3,62,21,74,240,209,.525,398,140,.673,208,82,1,1472,183,236,559,PF,67,94,423,UTA,.526
282,Yao Ming*,423,.518,817,0,.000,2,94,26,94,351,423,.516,819,356,.862,413,48,48,1624,101,159,1202,C,17,167,452,HOU,.516
283,Cuttino Mobley,287,.451,636,101,.411,246,198,31,24,215,388,.440,882,200,.837,239,78,73,2841,52,186,1077,SG,92,145,267,LAC,.497
284,Nazr Mohammed,118,.532,222,0,,0,9,29,40,140,118,.532,222,50,.610,82,51,33,773,89,133,286,C,27,43,229,DET,.532
285,Mikki Moore,308,.610,505,0,.000,1,74,31,60,258,308,.609,506,160,.681,235,79,55,2082,145,261,776,C,46,113,403,NJN,.609
286,Randolph Morris,1,.167,6,0,,0,1,21,1,8,1,.167,6,2,.333,6,5,0,44,1,4,4,C,2,2,9,NYK,.167
287,Adam Morrison,268,.391,686,87,.337,258,163,22,6,176,355,.376,944,120,.710,169,78,23,2326,54,179,917,PF,28,130,230,CHA,.422
288,Alonzo Mourning*,238,.560,425,0,,0,18,36,178,224,238,.560,425,185,.601,308,77,43,1572,126,219,661,C,13,129,350,MIA,.560
289,Troy Murphy,208,.479,434,58,.395,147,126,26,42,314,266,.458,581,108,.745,145,68,48,1852,100,196,698,PF,46,78,414,TOT,.508
290,Ronald Murray,153,.431,355,24,.289,83,187,27,13,87,177,.404,438,87,.725,120,69,18,1477,26,96,465,SG,49,90,113,DET,.432
291,Dikembe Mutombo*,85,.556,153,0,,0,13,40,76,324,85,.556,153,60,.690,87,75,33,1289,164,156,230,C,22,38,488,HOU,.556
292,Bostjan Nachbar,114,.496,230,112,.423,265,61,26,26,226,226,.457,495,132,.805,164,76,1,1532,27,183,696,SF,30,69,253,NJN,.570
293,Eduardo Najera,203,.594,342,1,.083,12,64,30,26,179,204,.576,354,88,.715,123,75,36,1658,131,207,497,PF,73,56,310,DEN,.578
294,Steve Nash,361,.575,628,156,.455,343,884,32,6,239,517,.532,971,222,.899,247,76,76,2682,30,117,1412,PG,57,287,269,PHO,.613
295,Jameer Nelson,311,.457,681,65,.335,194,330,24,5,186,376,.430,875,183,.828,221,77,77,2331,50,225,1000,PG,73,184,236,ORL,.467
296,Rasho Nesterovic,230,.548,420,0,.000,1,74,30,84,245,230,.546,421,34,.680,50,80,73,1676,115,193,494,C,37,56,360,TOR,.546
297,Ira Newble,8,.364,22,8,.533,15,2,32,0,17,16,.432,37,6,.600,10,15,1,129,13,17,46,SF,6,3,30,CLE,.541
298,Andres Nocioni,193,.515,375,80,.383,209,57,27,24,259,273,.467,584,123,.848,145,53,31,1406,42,164,749,PF,27,104,301,CHI,.536
299,David Noel,48,.387,124,17,.321,53,65,22,9,81,65,.367,177,37,.860,43,68,0,792,42,77,184,PF,25,40,123,MIL,.415
300,Steve Novak,5,.455,11,13,.333,39,6,23,0,22,18,.360,50,2,1.000,2,35,1,191,4,21,51,SF,5,4,26,HOU,.490
301,Dirk Nowitzki,601,.515,1168,72,.416,173,263,28,62,571,673,.502,1341,498,.904,551,78,78,2820,122,171,1916,PF,52,167,693,DAL,.529
302,Patrick O'Bryant,10,.313,32,0,,0,9,20,8,14,10,.313,32,11,.647,17,16,0,119,7,26,31,C,6,8,21,GSW,.313
303,Jermaine O'Neal,498,.439,1134,0,.000,7,167,28,182,508,498,.436,1141,343,.767,447,69,69,2459,153,232,1339,C,50,203,661,IND,.436
304,Shaquille O'Neal*,283,.591,479,0,,0,79,34,55,200,283,.591,479,124,.422,294,40,39,1135,97,139,690,C,8,95,297,MIA,.591
305,Fabricio Oberto,158,.562,281,0,,0,68,31,24,237,158,.562,281,33,.647,51,79,33,1365,131,213,349,PF,25,69,368,SAS,.562
306,Lamar Odom,265,.531,499,54,.297,182,270,27,32,445,319,.468,681,198,.700,283,56,56,2202,102,182,890,PF,53,163,547,LAL,.508
307,Emeka Okafor,394,.532,740,0,,0,80,24,172,499,394,.532,740,175,.593,295,67,65,2329,258,210,963,C,57,111,757,CHA,.532
308,Mehmet Okur,361,.498,725,129,.384,336,156,27,38,419,490,.462,1061,296,.765,387,80,80,2664,160,257,1405,C,36,125,579,UTA,.523
309,Kevin Ollie,81,.438,185,0,.000,2,130,34,1,66,81,.433,187,37,.822,45,53,23,919,8,76,199,PG,21,47,74,PHI,.433
310,Michael Olowokandi,19,.413,46,0,,0,5,31,13,34,19,.413,46,2,.667,3,24,0,234,14,48,40,C,8,17,48,BOS,.413
311,Bo Outlaw,34,.667,51,0,,0,16,35,6,59,34,.667,51,13,.591,22,41,0,460,47,57,81,PF,17,21,106,ORL,.667
312,Travis Outlaw,236,.445,530,10,.270,37,52,22,74,152,246,.434,567,143,.790,181,67,1,1532,65,150,645,PF,61,66,217,POR,.443
313,Zaza Pachulia,291,.475,613,0,.000,1,106,22,36,301,291,.474,614,293,.786,373,72,47,2026,199,267,875,C,77,162,500,ATL,.474
314,Scott Padgett,8,.348,23,8,.242,33,8,30,3,38,16,.286,56,6,.462,13,31,0,231,16,35,46,PF,5,9,54,TOT,.357
315,Jannero Pargo,202,.418,483,81,.388,209,203,27,4,160,283,.409,692,104,.852,122,82,7,1710,20,121,751,PG,53,122,180,NOK,.467
316,Anthony Parker,213,.500,426,115,.441,261,153,31,11,223,328,.477,687,132,.835,158,73,73,2437,60,135,903,SG,73,71,283,TOR,.561
317,Smush Parker,232,.479,484,110,.365,301,228,25,10,161,342,.436,785,113,.646,175,82,80,2457,45,211,907,PG,119,153,206,LAL,.506
318,Tony Parker,555,.525,1058,15,.395,38,420,24,6,216,570,.520,1096,274,.783,350,77,77,2499,34,137,1429,PG,82,191,250,SAS,.527
319,Ruben Patterson,472,.557,848,3,.158,19,232,31,25,250,475,.548,867,241,.641,376,81,53,2508,190,232,1194,SF,110,199,440,MIL,.550
320,Chris Paul,331,.455,728,50,.350,143,569,21,3,226,381,.437,871,292,.818,357,64,64,2353,54,154,1104,PG,118,161,280,NOK,.466
321,Sasha Pavlovic,162,.474,342,60,.405,148,105,23,17,135,222,.453,490,100,.794,126,67,28,1534,23,145,604,SG,55,102,158,CLE,.514
322,Gary Payton*,112,.461,243,32,.260,123,201,38,3,114,144,.393,366,38,.667,57,68,28,1503,18,117,358,PG,43,66,132,MIA,.437
323,Kendrick Perkins,132,.496,266,0,.000,3,94,22,96,259,132,.491,269,60,.600,100,72,53,1576,113,214,324,C,23,113,372,BOS,.491
324,Morris Peterson,116,.523,222,106,.359,295,47,29,12,205,222,.429,517,84,.683,123,71,12,1515,32,126,634,SF,45,53,237,TOR,.532
325,Johan Petro,226,.516,438,0,,0,45,21,47,243,226,.516,438,50,.649,77,81,13,1510,92,237,502,C,39,82,335,SEA,.516
326,Eric Piatkowski,2,.286,7,7,.389,18,4,36,1,7,9,.360,25,2,1.000,2,11,0,73,2,6,27,SG,0,5,9,PHO,.500
327,Paul Pierce,266,.463,575,107,.389,275,194,29,13,238,373,.439,850,320,.796,402,47,46,1740,39,122,1173,SG,48,152,277,BOS,.502
328,Mickael Pietrus,193,.558,346,93,.388,240,62,24,55,246,286,.488,586,136,.648,210,72,38,1937,81,220,801,SF,48,105,327,GSW,.567
329,Kevinn Pinkney,11,.440,25,1,.500,2,5,23,3,8,12,.444,27,6,.667,9,6,0,100,7,12,31,PF,3,4,15,BOS,.463
330,Scot Pollard,11,.423,26,0,,0,3,31,1,16,11,.423,26,2,.500,4,24,0,109,15,27,24,C,4,4,31,CLE,.423
331,James Posey,89,.514,173,97,.375,259,94,30,23,291,186,.431,432,81,.827,98,71,19,1919,66,193,550,SF,71,55,357,MIA,.543
332,Vitaly Potapenko,0,.000,4,0,,0,0,31,0,2,0,.000,4,0,,0,3,0,13,0,3,0,C,0,2,2,SAC,.000
333,Leon Powe,79,.451,175,0,.000,2,10,23,22,118,79,.446,177,106,.736,144,63,2,720,97,104,264,C,14,47,215,BOS,.446
334,Josh Powell,43,.462,93,0,,0,21,24,12,64,43,.462,93,30,.714,42,37,0,353,24,61,116,PF,5,29,88,TOT,.462
335,Roger Powell,0,.000,2,0,.000,1,0,24,0,0,0,.000,3,2,1.000,2,3,0,13,3,2,2,SF,0,3,3,UTA,.000
336,Ronnie Price,46,.430,107,21,.323,65,48,23,4,56,67,.390,172,37,.673,55,58,1,563,15,64,192,PG,28,33,71,SAC,.451
337,Tayshaun Prince,378,.480,787,81,.386,210,227,26,55,285,459,.460,997,172,.768,224,82,82,3001,144,116,1171,SF,51,98,429,DET,.501
338,Joel Przybilla,37,.474,78,0,,0,12,27,67,109,37,.474,78,10,.370,27,43,43,701,59,124,84,C,10,40,168,POR,.474
339,Chris Quinn,28,.378,74,20,.351,57,65,23,0,24,48,.366,131,25,.676,37,42,1,408,6,32,141,PG,15,21,30,MIA,.443
340,Vladimir Radmanovic,94,.475,198,40,.339,118,66,26,18,127,134,.424,316,53,.726,73,55,15,986,53,125,361,PF,25,69,180,LAL,.487
341,Shavlik Randolph,23,.479,48,0,,0,4,23,10,35,23,.479,48,12,.545,22,13,6,179,19,23,58,PF,7,9,54,PHI,.479
342,Zach Randolph,586,.473,1238,14,.292,48,147,25,15,489,600,.467,1286,394,.819,481,68,67,2425,199,184,1608,PF,53,215,688,POR,.472
343,Theo Ratliff,1,.333,3,0,,0,0,33,3,5,1,.333,3,3,.750,4,2,2,44,2,6,5,C,1,1,7,BOS,.333
344,Allan Ray,52,.364,143,48,.414,116,43,22,3,51,100,.386,259,42,.764,55,47,5,710,18,85,290,SG,20,42,69,BOS,.479
345,Michael Redd,360,.501,719,117,.382,306,124,27,9,154,477,.465,1025,345,.829,416,53,53,2036,42,78,1416,SF,63,122,196,MIL,.522
346,J.J. Redick,42,.433,97,38,.388,98,36,22,0,42,80,.410,195,54,.900,60,42,0,622,10,52,252,PG,12,21,52,ORL,.508
347,Justin Reed,40,.374,107,0,,0,17,25,3,31,40,.374,107,26,.867,30,41,3,318,15,44,106,PF,5,22,46,MIN,.374
348,Jared Reiner,15,.349,43,0,,0,13,24,6,50,15,.349,43,3,.300,10,27,2,244,21,45,33,C,5,14,71,MIL,.349
349,Jason Richardson,196,.453,433,110,.365,301,172,26,32,188,306,.417,734,92,.657,140,51,49,1675,71,129,814,SG,54,82,259,GSW,.492
350,Jeremy Richardson,1,.333,3,2,.667,3,0,22,0,1,3,.500,6,0,,0,6,0,20,1,2,8,SG-SF,1,1,2,TOT,.667
351,Quentin Richardson,131,.456,287,97,.376,258,108,26,7,287,228,.418,545,83,.692,120,49,47,1621,65,133,636,SF,36,70,352,NYK,.507
352,Luke Ridnour,252,.453,556,49,.353,139,368,25,19,136,301,.433,695,128,.805,159,71,58,2091,28,181,779,PG,83,156,164,SEA,.468
353,Anthony Roberson,23,.469,49,21,.382,55,10,23,0,19,44,.423,104,2,.667,3,20,1,227,2,27,111,PG,12,13,21,GSW,.524
354,Lawrence Roberts,94,.456,206,0,.000,2,30,24,13,160,94,.452,208,95,.725,131,54,18,969,101,133,283,PF,36,36,261,MEM,.452
355,Bernard Robinson,19,.317,60,0,.000,2,19,26,2,38,19,.306,62,23,.852,27,31,0,278,10,32,61,SG-SF,17,16,48,TOT,.306
356,Clifford Robinson,56,.368,152,25,.379,66,51,40,23,91,81,.372,218,16,.444,36,50,1,955,31,98,203,C,12,30,122,NJN,.429
357,Nate Robinson,144,.465,310,83,.390,213,90,22,6,97,227,.434,523,108,.777,139,64,5,1356,55,160,645,PG,50,72,152,NYK,.513
358,Sergio Rodriguez,77,.500,154,24,.282,85,218,20,2,71,101,.423,239,21,.808,26,67,1,862,20,72,247,PG,35,77,91,POR,.473
359,Rajon Rondo,182,.432,421,6,.207,29,297,20,8,218,188,.418,450,119,.647,184,78,25,1831,74,181,501,PG,128,137,292,BOS,.424
360,Jalen Rose,17,.436,39,21,.447,47,16,34,2,20,38,.442,86,11,.917,12,29,0,246,3,22,108,SF,5,9,23,PHO,.564
361,Malik Rose,72,.404,178,2,.250,8,65,32,9,128,74,.398,186,42,.808,52,65,2,810,47,120,192,PF,26,65,175,NYK,.403
362,Quinton Ross,175,.474,369,2,.200,10,86,25,32,130,177,.467,379,68,.782,87,81,43,1700,60,179,424,SG,70,33,190,LAC,.470
363,Brandon Roy,294,.475,619,55,.377,146,230,22,10,192,349,.456,765,202,.838,241,57,55,2015,58,139,955,SG,67,116,250,POR,.492
364,Michael Ruffin,5,.278,18,0,,0,6,30,8,27,5,.278,18,7,.368,19,30,0,271,35,43,17,PF,6,12,62,WAS,.278
365,John Salmons,196,.484,405,40,.357,112,254,27,27,217,236,.456,517,159,.779,204,79,19,2135,47,177,671,SG,73,119,264,SAC,.495
366,Jamal Sampson,9,.692,13,0,.000,1,5,23,7,33,9,.643,14,6,.429,14,22,3,125,15,17,24,C,2,10,48,DEN,.643
367,Brian Scalabrine,33,.407,81,44,.400,110,59,28,18,81,77,.403,191,18,.783,23,54,17,1027,24,130,216,PF,23,44,105,BOS,.518
368,Luke Schenscher,7,.304,23,0,,0,1,24,4,15,7,.304,23,5,.714,7,11,0,118,10,25,19,C,2,4,25,POR,.304
369,Thabo Sefolosha,94,.439,214,15,.357,42,60,22,11,118,109,.426,256,23,.511,45,71,4,868,35,100,256,SG,33,60,153,CHI,.455
370,Mouhamed Sene,18,.367,49,0,,0,0,20,12,29,18,.367,49,17,.586,29,28,3,169,16,33,53,C,3,11,45,SEA,.367
371,Wayne Simien,9,.391,23,0,,0,4,23,0,6,9,.391,23,5,.714,7,8,0,93,5,13,23,PF,2,3,11,MIA,.391
372,Cedric Simmons,55,.417,132,0,,0,12,21,23,63,55,.417,132,16,.485,33,43,4,534,44,75,126,PF,8,22,107,NOK,.417
373,James Singleton,27,.397,68,3,.214,14,17,25,17,70,30,.366,82,22,.759,29,53,0,376,36,45,85,PF,15,17,106,LAC,.384
374,Brian Skinner,124,.490,253,0,,0,58,30,64,279,124,.490,253,46,.582,79,67,44,1523,106,195,294,PF,18,75,385,MIL,.490
375,Uros Slokar,13,.542,24,1,.500,2,1,23,2,7,14,.538,26,9,.692,13,20,0,72,7,11,38,C,1,9,14,TOR,.558
376,Craig Smith,246,.538,457,0,.000,6,49,23,18,267,246,.531,463,116,.624,186,82,5,1537,149,223,608,PF,51,74,416,MIN,.531
377,J.R. Smith,135,.515,262,149,.390,382,91,21,9,113,284,.441,644,102,.810,126,63,24,1471,30,147,819,SG,49,85,143,DEN,.557
378,Joe Smith,214,.453,472,0,.000,5,49,31,27,280,214,.449,477,125,.845,148,65,11,1503,120,148,553,PF,37,76,400,TOT,.449
379,Josh Smith,398,.473,841,38,.250,152,236,21,207,456,436,.439,993,268,.693,387,72,72,2647,165,241,1178,SF,101,227,621,ATL,.458
380,Steven Smith,2,.250,8,0,,0,0,23,0,5,2,.250,8,1,.500,2,8,0,28,1,4,5,PF,1,2,6,PHI,.250
381,Eric Snow,135,.422,320,0,.000,4,330,33,16,153,135,.417,324,72,.637,113,82,45,1929,35,185,342,PG,55,111,188,CLE,.417
382,Kirk Snyder,55,.539,102,11,.250,44,39,23,12,66,66,.452,146,49,.653,75,39,1,563,17,51,192,SF,11,26,83,HOU,.490
383,Darius Songaila,118,.529,223,0,.000,2,38,28,10,90,118,.524,225,46,.852,54,37,1,700,44,105,282,PF,17,43,134,WAS,.524
384,Pape Sow,3,.333,9,0,,0,2,25,1,5,3,.333,9,4,.667,6,7,0,34,6,2,10,C,1,1,11,TOR,.333
385,Vassilis Spanoulis,18,.419,43,5,.172,29,28,24,1,17,23,.319,72,34,.810,42,31,0,272,5,33,85,SG,7,29,22,HOU,.354
386,Jerry Stackhouse,218,.443,492,62,.383,162,187,32,10,106,280,.428,654,182,.847,215,67,8,1615,39,78,804,SF,51,117,145,DAL,.476
387,DeShawn Stevenson,273,.479,570,74,.404,183,218,25,19,161,347,.461,753,152,.704,216,82,82,2419,55,155,920,SG,65,119,216,WAS,.510
388,Peja Stojakovic,49,.438,112,34,.405,84,11,29,4,43,83,.423,196,31,.816,38,13,13,425,11,29,231,SF,8,19,54,NOK,.510
389,Damon Stoudamire,112,.427,262,59,.337,175,299,33,2,108,171,.391,437,66,.795,83,62,51,1501,31,95,467,PG,47,101,139,MEM,.459
390,Salim Stoudamire,121,.448,270,56,.361,155,61,24,2,68,177,.416,425,61,.897,68,61,0,1034,6,88,471,SG,21,55,74,ATL,.482
391,Amar'e Stoudemire,607,.577,1052,0,.000,3,84,24,110,564,607,.575,1055,457,.781,585,82,78,2689,222,295,1671,C,78,232,786,PHO,.575
392,Mike Sweetney,58,.433,134,0,,0,28,24,11,75,58,.433,134,37,.561,66,48,0,385,45,79,153,C,9,42,120,CHI,.433
393,Stromile Swift,161,.472,341,0,.000,5,17,27,62,165,161,.465,346,97,.724,134,54,18,1029,85,146,419,C,30,69,250,MEM,.465
394,Wally Szczerbiak,117,.415,282,44,.415,106,55,29,3,82,161,.415,388,113,.897,126,32,19,900,16,65,479,SF,18,54,98,BOS,.472
395,Donell Taylor,53,.431,123,3,.176,17,45,24,3,39,56,.400,140,11,.524,21,47,1,369,14,34,126,SG,17,25,53,WAS,.411
396,Maurice Taylor,8,.286,28,0,,0,5,30,1,18,8,.286,28,8,.615,13,12,2,103,10,16,24,PF,4,6,28,SAC,.286
397,Sebastian Telfair,139,.402,346,37,.289,128,218,21,11,91,176,.371,474,90,.818,110,78,30,1578,17,166,479,PG,43,98,108,BOS,.410
398,Jason Terry,352,.508,693,162,.438,370,422,29,17,190,514,.484,1063,160,.804,199,81,80,2846,41,170,1350,SG,81,152,231,DAL,.560
399,Etan Thomas,159,.574,277,0,,0,29,28,89,241,159,.574,277,77,.558,138,65,32,1246,136,162,395,C,22,71,377,WAS,.574
400,Kenny Thomas,146,.483,302,0,.000,1,76,29,16,243,146,.482,303,39,.513,76,62,53,1412,134,141,331,PF,43,90,377,SAC,.482
401,Kurt Thomas,126,.488,258,0,.000,1,24,34,29,293,126,.486,259,56,.789,71,67,13,1208,86,156,308,C,24,35,379,PHO,.486
402,Tim Thomas,163,.444,367,136,.382,356,171,29,28,315,299,.414,723,102,.708,144,76,24,2054,63,228,836,PF,55,106,378,LAC,.508
403,Tyrus Thomas,134,.479,280,0,.000,2,40,20,76,180,134,.475,282,106,.606,175,72,4,966,89,162,374,PF,46,94,269,CHI,.475
404,Dijon Thompson,6,.462,13,0,.000,2,2,23,0,5,6,.400,15,5,.833,6,6,0,50,3,2,17,SF,0,1,8,ATL,.400
405,Jamaal Tinsley,285,.409,696,61,.316,193,494,28,25,180,346,.389,889,172,.720,239,72,72,2243,60,190,925,PG,117,200,240,IND,.424
406,Jake Tsakalidis,29,.403,72,0,,0,5,27,12,62,29,.403,72,26,.667,39,36,7,390,42,51,84,C,8,24,104,TOT,.403
407,P.J. Tucker,11,.500,22,0,,0,3,21,0,12,11,.500,22,8,.571,14,17,0,83,11,12,30,SF,2,6,23,TOR,.500
408,Ronny Turiaf,147,.551,267,0,.000,1,63,24,78,171,147,.549,268,89,.664,134,72,1,1087,88,202,383,C,17,52,259,LAL,.549
409,Hedo Turkoglu,236,.435,542,109,.388,281,233,27,16,236,345,.419,823,171,.781,219,73,73,2268,57,221,970,SF,70,143,293,ORL,.485
410,Ime Udoka,148,.502,295,89,.406,219,112,29,17,184,237,.461,514,66,.742,89,75,75,2144,95,207,629,SF,71,73,279,POR,.548
411,Beno Udrih,94,.410,229,33,.287,115,122,24,1,71,127,.369,344,53,.883,60,73,1,948,11,70,340,PG,27,56,82,SAS,.417
412,Anderson Varejao,191,.487,392,0,.000,9,75,24,52,354,191,.476,401,165,.616,268,81,6,1932,191,269,547,C,76,67,545,CLE,.476
413,Jacque Vaughn,70,.424,165,1,.500,2,131,31,2,60,71,.425,167,49,.754,65,64,4,760,8,74,192,PG,24,40,68,SAS,.428
414,Charlie Villanueva,151,.508,297,29,.337,86,36,22,12,166,180,.470,383,73,.820,89,39,17,984,62,108,462,PF,24,54,228,MIL,.508
415,Marcus Vinicius,4,.500,8,3,.429,7,5,22,1,9,7,.467,15,5,.714,7,13,0,103,2,10,22,SF,2,6,11,NOK,.567
416,Jake Voskuhl,121,.475,255,0,,0,44,29,24,172,121,.475,255,77,.681,113,73,9,1043,84,199,319,C,30,56,256,CHA,.475
417,Sasha Vujacic,45,.421,107,60,.373,161,64,22,1,79,105,.392,268,43,.878,49,73,4,935,28,103,313,SG,41,30,107,LAL,.504
418,Dwyane Wade,451,.511,883,21,.266,79,384,25,62,188,472,.491,962,432,.807,535,51,50,1931,51,117,1397,SG,107,216,239,MIA,.502
419,Von Wafer,0,,0,0,.000,1,0,21,0,0,0,.000,1,0,,0,1,0,1,0,0,0,SF,0,0,0,LAC,.000
420,Dajuan Wagner,0,,0,1,1.000,1,1,23,0,0,1,1.000,1,1,.500,2,1,0,7,0,1,4,SG,0,1,0,GSW,1.500
421,Antoine Walker,181,.499,363,84,.275,305,130,30,17,247,265,.397,668,46,.438,105,78,15,1818,92,173,660,PF,48,141,339,MIA,.460
422,Ben Wallace,191,.456,419,1,.200,5,186,32,156,518,192,.453,424,109,.408,267,77,77,2697,303,153,494,C,111,101,821,CHI,.454
423,Gerald Wallace,439,.528,832,39,.325,120,185,24,69,376,478,.502,952,309,.691,447,72,71,2640,142,209,1304,SF,144,160,518,CHA,.523
424,Rasheed Wallace,253,.463,547,104,.351,296,127,32,118,453,357,.423,843,108,.788,137,75,72,2419,90,225,926,C,75,94,543,DET,.485
425,Luke Walton,216,.499,433,48,.387,124,257,26,21,215,264,.474,557,108,.745,145,60,60,1982,87,117,684,SF,60,118,302,LAL,.517
426,Hakim Warrick,373,.530,704,0,.000,8,75,24,30,290,373,.524,712,299,.771,388,82,43,2152,130,232,1045,PF,43,161,420,MEM,.524
427,Earl Watson,171,.420,407,92,.329,280,437,27,23,151,263,.383,687,108,.735,147,77,25,2152,34,152,726,PG,99,167,185,SEA,.450
428,Chris Webber,285,.454,628,4,.364,11,188,33,41,313,289,.452,639,102,.638,160,61,60,1821,124,143,684,PF,60,107,437,TOT,.455
429,Martell Webster,104,.430,242,91,.364,250,52,20,19,197,195,.396,492,93,.705,132,82,27,1759,43,126,574,SF,35,76,240,POR,.489
430,Bonzi Wells,84,.420,200,1,.143,7,31,30,13,94,85,.411,207,46,.561,82,28,1,590,26,62,217,SF,24,57,120,HOU,.413
431,David Wesley,13,.351,37,9,.237,38,37,36,4,32,22,.293,75,20,.714,28,35,5,352,3,32,73,SG,12,17,35,CLE,.353
432,David West,369,.481,767,8,.320,25,114,26,38,298,377,.476,792,187,.824,227,52,52,1900,126,143,949,PF,42,98,424,NOK,.481
433,Delonte West,241,.447,539,65,.365,178,304,23,34,176,306,.427,717,168,.853,197,69,47,2219,32,152,845,SG,74,140,208,BOS,.472
434,James White,16,.471,34,2,.286,7,5,24,1,17,18,.439,41,12,.800,15,6,2,137,3,7,50,SG,3,5,20,SAS,.463
435,Chris Wilcox,433,.533,813,0,.000,6,82,24,38,451,433,.529,819,240,.684,351,82,81,2586,178,248,1106,PF,70,127,629,SEA,.529
436,Damien Wilkins,212,.442,480,50,.410,122,156,27,16,142,262,.435,602,150,.882,170,82,31,2037,87,157,724,SF,92,116,229,SEA,.477
437,Mike Wilks,61,.484,126,5,.333,15,79,27,4,39,66,.468,141,33,.786,42,47,4,534,15,53,170,PG,15,31,54,SEA,.486
438,Aaron Williams,29,.558,52,0,.000,1,7,35,14,58,29,.547,53,18,.818,22,38,7,374,27,56,76,PF,7,18,85,LAC,.547
439,Alvin Williams,0,.000,1,0,.000,1,3,32,0,0,0,.000,2,2,.500,4,2,0,10,1,0,2,PG,2,3,1,LAC,.000
440,Deron Williams,412,.498,828,82,.322,255,745,22,13,226,494,.456,1083,227,.767,296,80,80,2950,41,254,1297,PG,78,246,267,UTA,.494
441,Eric Williams,11,.393,28,8,.421,19,7,34,0,14,19,.404,47,8,.571,14,21,0,121,3,12,54,SF,3,7,17,TOT,.489
442,Jason Williams,135,.493,274,100,.339,295,322,31,1,123,235,.413,569,94,.913,103,61,55,1865,18,68,664,PG,58,100,141,MIA,.501
443,Justin Williams,54,.621,87,0,.000,1,2,22,16,64,54,.614,88,23,.365,63,26,1,333,51,51,131,C,5,15,115,SAC,.614
444,Lou Williams,81,.466,174,12,.324,37,110,20,1,53,93,.441,211,64,.696,92,61,0,688,17,42,262,PG,22,46,70,PHI,.469
445,Marcus Williams,162,.446,363,46,.282,163,260,21,2,134,208,.395,526,72,.847,85,79,2,1315,29,96,534,PG,29,142,163,NJN,.439
446,Marvin Williams,295,.446,661,11,.244,45,121,20,30,253,306,.433,706,216,.815,265,64,63,2179,84,191,839,PF,52,127,337,ATL,.441
447,Mo Williams,389,.474,821,79,.346,228,416,24,6,275,468,.446,1049,159,.855,186,68,68,2472,54,201,1174,PG,85,203,329,MIL,.484
448,Shammond Williams,15,.417,36,20,.400,50,31,31,0,29,35,.407,86,4,.667,6,30,0,345,11,20,94,PG,12,13,40,LAL,.523
449,Shawne Williams,56,.519,108,19,.365,52,22,20,8,50,75,.469,160,11,.550,20,46,3,556,33,69,180,SG,6,24,83,IND,.528
450,Shelden Williams,164,.454,361,2,.500,4,44,23,39,304,166,.455,365,110,.764,144,81,31,1514,131,199,444,PF,52,96,435,ATL,.458
451,Corliss Williamson,236,.512,461,0,.000,2,39,33,15,158,236,.510,463,148,.715,207,68,1,1337,63,183,620,PF,29,97,221,SAC,.510
452,Kevin Willis,5,.385,13,0,,0,1,44,1,6,5,.385,13,2,1.000,2,5,0,43,2,11,12,PF,2,2,8,DAL,.385
453,Metta World Peace,365,.468,780,93,.358,260,235,27,43,352,458,.440,1040,307,.740,415,70,65,2641,102,205,1316,SF,149,146,454,SAC,.485
454,Antoine Wright,91,.474,192,19,.322,59,55,22,10,137,110,.438,251,44,.603,73,63,23,1137,38,120,283,SG,30,43,175,NJN,.476
455,Bracey Wright,18,.450,40,6,.300,20,15,22,1,14,24,.400,60,13,.722,18,19,0,190,7,6,67,SG,9,6,21,MIN,.450
456,Dorell Wright,157,.476,330,5,.147,34,95,21,46,232,162,.445,364,64,.744,86,66,19,1292,40,112,393,SF,41,65,272,MIA,.452
457,Lorenzen Wright,82,.448,183,0,,0,40,31,28,131,82,.448,183,9,.281,32,67,31,1035,85,204,173,C,28,39,216,ATL,.448
