,Player_Name,2P,2P%,2PA,3P,3P%,3PA,AST,Age,BLK,DRB,FG,FG%,FGA,FT,FT%,FTA,Games,Games_Strated,Minutes_Played,ORB,PF,PTS,Position,STL,TOV,TRB,Team,eFG%
0,Shareef Abdur-Rahim,3,.214,14,0,,0,4,31,0,4,3,.214,14,4,1.000,4,6,0,51,6,9,10,PF,1,1,10,SAC,.214
1,Arron Afflalo,89,.461,193,10,.208,48,52,22,8,101,99,.411,241,68,.782,87,75,9,970,36,83,276,SG,31,34,137,DET,.432
2,Maurice Ager,18,.391,46,3,.158,19,8,23,1,9,21,.323,65,6,.500,12,26,3,165,4,17,51,SG,0,6,13,TOT,.346
3,Blake Ahearn,5,.217,23,10,.294,34,19,23,0,18,15,.263,57,30,.968,31,12,0,177,1,20,70,PG,6,16,19,MIA,.351
4,LaMarcus Aldridge,560,.486,1153,1,.143,7,122,22,94,358,561,.484,1160,227,.762,298,76,76,2649,220,240,1350,PF,55,126,578,POR,.484
5,Malik Allen,156,.480,325,1,.500,2,44,29,31,130,157,.480,327,23,.920,25,73,16,1096,66,149,338,PF,19,45,196,TOT,.482
6,Ray Allen,259,.485,534,180,.398,452,225,32,16,193,439,.445,986,215,.907,237,73,73,2624,75,147,1273,SG,65,127,268,BOS,.537
7,Tony Allen,151,.455,332,18,.316,57,114,26,21,134,169,.434,389,138,.762,181,75,11,1373,34,168,494,SG,62,109,168,BOS,.458
8,Lance Allred,1,.250,4,0,,0,0,26,0,1,1,.250,4,1,.500,2,3,0,10,0,1,3,C,0,0,1,CLE,.250
9,Morris Almond,3,.273,11,1,.250,4,3,22,0,2,4,.267,15,4,.667,6,9,0,39,0,5,13,SG,1,2,2,UTA,.300
10,Rafer Alston,221,.427,517,143,.351,407,392,31,18,232,364,.394,924,98,.715,137,74,74,2526,28,139,969,PG,98,160,260,HOU,.471
11,Lou Amundson,8,.500,16,0,,0,0,25,1,5,8,.500,16,2,.286,7,16,0,64,7,13,18,PF,1,2,12,PHI,.500
12,Chris Andersen,2,.286,7,0,,0,0,29,4,7,2,.286,7,2,.500,4,5,0,34,2,6,6,C,0,1,9,NOH,.286
13,Derek Anderson,28,.384,73,19,.365,52,44,33,1,43,47,.376,125,28,.737,38,28,0,396,9,49,141,SG,12,25,52,CHA,.452
14,Carmelo Anthony,670,.509,1317,58,.354,164,259,23,39,393,728,.492,1481,464,.786,590,77,77,2806,178,253,1978,SF,98,253,571,DEN,.511
15,Joel Anthony,28,.467,60,0,,0,3,25,31,55,28,.467,60,29,.592,49,24,1,498,38,55,85,PF,9,17,93,MIA,.467
16,Gilbert Arenas,56,.475,118,22,.282,78,66,26,1,45,78,.398,196,74,.771,96,13,8,425,6,30,252,PG,23,49,51,WAS,.454
17,Trevor Ariza,64,.542,118,5,.278,18,44,22,11,78,69,.507,136,49,.653,75,35,3,546,30,45,192,SF,31,23,108,TOT,.526
18,Darrell Armstrong,17,.415,41,23,.333,69,73,39,2,50,40,.364,110,20,.667,30,50,2,549,17,53,123,PG,28,41,67,NJN,.468
19,Hilton Armstrong,67,.453,148,0,,0,23,23,34,98,67,.453,148,44,.629,70,65,3,732,65,130,178,C,15,59,163,NOH,.453
20,Carlos Arroyo,128,.485,264,29,.345,84,219,28,2,103,157,.451,348,87,.853,102,62,20,1269,10,85,430,PG,26,77,113,ORL,.493
21,Chucky Atkins,17,.395,43,25,.316,79,47,33,1,28,42,.344,122,4,.444,9,24,0,352,3,27,113,SG,9,10,31,DEN,.447
22,James Augustine,18,.529,34,0,,0,2,23,2,14,18,.529,34,4,.500,8,25,0,149,16,18,40,PF,5,6,30,ORL,.529
23,Kelenna Azubuike,190,.485,392,71,.364,195,75,24,34,217,261,.445,587,99,.717,138,81,17,1732,107,159,692,SG,45,58,324,GSW,.505
24,Renaldo Balkman,90,.517,174,1,.083,12,40,23,30,133,91,.489,186,41,.432,95,65,0,952,83,132,224,SF,44,37,216,NYK,.492
25,Marcus Banks,46,.517,89,40,.392,102,61,26,13,41,86,.450,191,27,.771,35,36,3,569,4,65,239,PG,14,37,45,TOT,.555
26,Leandro Barbosa,308,.514,599,164,.389,422,216,25,18,191,472,.462,1021,175,.822,213,82,12,2421,40,195,1283,SG,75,117,231,PHO,.543
27,J.J. Barea,50,.431,116,21,.389,54,58,23,1,43,71,.418,170,28,.800,35,44,9,460,4,48,191,PG,14,35,47,DAL,.479
28,Andrea Bargnani,190,.409,464,90,.345,261,89,22,37,238,280,.386,725,142,.840,169,78,53,1861,50,211,792,PF,23,88,288,TOR,.448
29,Matt Barnes,134,.513,261,53,.293,181,139,27,36,230,187,.423,442,59,.747,79,73,18,1414,94,159,486,PF,48,85,324,GSW,.483
30,Andre Barrett,1,.500,2,1,.333,3,7,25,0,1,2,.400,5,1,.500,2,4,0,25,0,1,6,PG,0,1,1,LAC,.500
31,Earl Barron,131,.417,314,1,.077,13,29,26,8,131,132,.404,327,61,.701,87,46,15,889,67,114,326,C,19,48,198,MIA,.405
32,Brent Barry,29,.604,48,48,.429,112,54,36,3,43,77,.481,160,19,.950,20,31,1,554,12,43,221,SF,17,18,55,SAS,.631
33,Brandon Bass,246,.503,489,0,.000,4,58,22,48,227,246,.499,493,162,.822,197,79,1,1557,120,150,654,C,22,82,347,DAL,.499
34,Maceo Baston,17,.680,25,0,,0,3,32,4,17,17,.680,25,7,.700,10,15,2,103,9,20,41,PF,2,4,26,TOR,.680
35,Shane Battier,126,.504,250,139,.377,369,155,29,90,276,265,.428,619,75,.743,101,80,78,2907,131,196,744,SF,77,78,407,HOU,.540
36,Marco Belinelli,20,.385,52,16,.390,41,15,21,0,11,36,.387,93,7,.778,9,33,0,241,3,15,95,PG,5,12,14,GSW,.473
37,Charlie Bell,111,.413,269,74,.341,217,210,28,2,136,185,.381,486,70,.805,87,68,5,1628,31,121,514,SG,52,76,167,MIL,.457
38,Raja Bell,141,.449,314,176,.401,439,168,31,27,227,317,.421,753,79,.868,91,75,75,2646,47,220,889,SG,54,65,274,PHO,.538
39,Mike Bibby,155,.437,355,93,.375,248,290,29,4,144,248,.411,603,78,.780,100,48,44,1573,16,97,667,PG,54,119,160,TOT,.488
40,Andris Biedrins,340,.626,543,0,,0,75,21,94,488,340,.626,543,116,.620,187,76,59,2078,256,262,796,C,56,85,744,GSW,.626
41,Chauncey Billups,256,.479,535,137,.401,342,529,31,17,170,393,.448,877,401,.918,437,78,78,2522,42,130,1324,PG,101,160,212,DET,.526
42,Steve Blake,140,.409,342,121,.406,298,413,27,4,164,261,.408,640,49,.766,64,81,78,2424,31,133,692,PG,55,113,195,POR,.502
43,Andray Blatche,251,.480,523,3,.231,13,92,21,114,261,254,.474,536,107,.695,154,82,15,1675,164,258,618,PF,53,112,425,WAS,.477
44,Mark Blount,221,.469,471,17,.386,44,41,32,34,194,238,.462,515,88,.638,138,69,46,1542,69,133,581,C,33,70,263,MIA,.479
45,Keith Bogans,93,.520,179,148,.362,409,104,27,10,224,241,.410,588,81,.736,110,82,35,2198,42,164,711,SG,59,53,266,ORL,.536
46,Andrew Bogut,465,.515,903,0,.000,7,199,23,135,518,465,.511,910,189,.587,322,78,78,2720,245,254,1119,C,64,172,763,MIL,.511
47,Matt Bonner,75,.487,154,46,.336,137,32,27,17,139,121,.416,291,38,.864,44,68,3,853,53,111,326,PF,14,39,192,SAS,.495
48,Josh Boone,238,.548,434,0,,0,55,23,61,317,238,.548,434,99,.456,217,70,53,1773,192,155,575,PF,36,68,509,NJN,.548
49,Calvin Booth,9,.333,27,0,,0,8,31,18,32,9,.333,27,6,.600,10,31,0,204,6,35,24,C,6,4,38,PHI,.333
50,Carlos Boozer,709,.547,1296,0,.000,1,233,26,41,647,709,.547,1297,290,.738,393,81,81,2827,197,293,1708,PF,100,210,844,UTA,.547
51,Chris Bosh,497,.496,1002,10,.400,25,171,23,67,409,507,.494,1027,472,.844,559,67,67,2425,174,157,1496,C,63,153,583,TOR,.499
52,Bruce Bowen,84,.394,213,90,.419,215,91,36,22,201,174,.407,428,45,.652,69,81,81,2448,33,177,483,SF,54,46,234,SAS,.512
53,Ryan Bowen,49,.495,99,0,.000,1,25,32,11,45,49,.490,100,16,.552,29,53,4,660,55,77,114,SF,32,15,100,NOH,.490
54,Earl Boykins,47,.367,128,14,.318,44,96,31,0,25,61,.355,172,49,.831,59,36,0,577,9,21,185,PG,13,41,34,CHA,.395
55,Elton Brand,52,.456,114,0,,0,16,28,15,43,52,.456,114,37,.787,47,8,6,274,21,21,141,PF,3,17,64,LAC,.456
56,Corey Brewer,175,.389,450,7,.194,36,111,21,25,210,182,.374,486,88,.800,110,79,35,1803,82,188,459,SF,76,89,292,MIN,.382
57,Ronnie Brewer,343,.587,584,11,.220,50,134,22,19,121,354,.558,634,195,.759,257,76,76,2088,97,110,914,SG,129,69,218,UTA,.567
58,Primoz Brezec,44,.468,94,0,,0,11,28,7,51,44,.468,94,24,.600,40,50,18,475,30,83,112,C,3,24,81,TOT,.468
59,Aaron Brooks,57,.491,116,36,.330,109,87,23,5,43,93,.413,225,42,.857,49,51,0,608,13,69,264,PG,13,44,56,HOU,.493
60,Andre Brown,39,.500,78,0,,0,8,26,4,55,39,.500,78,22,.449,49,33,1,286,37,38,100,PF,7,14,92,MEM,.500
61,Devin Brown,172,.447,385,45,.308,146,175,29,7,198,217,.409,531,107,.754,142,78,20,1762,65,144,586,SG,52,99,263,CLE,.451
62,Kwame Brown,72,.507,142,0,,0,45,25,23,137,72,.507,142,40,.408,98,38,15,713,51,82,184,C,22,51,188,TOT,.507
63,P.J. Brown,14,.350,40,0,.000,1,10,38,8,39,14,.341,41,11,.688,16,18,0,209,29,29,39,PF,5,10,68,BOS,.341
64,Shannon Brown,35,.365,96,9,.300,30,17,22,3,14,44,.349,126,17,.586,29,21,4,240,6,29,114,SG,11,24,20,TOT,.385
65,Kobe Bryant,625,.490,1275,150,.361,415,441,29,40,423,775,.459,1690,623,.840,742,82,82,3192,94,227,2323,SG,151,257,517,LAL,.503
66,Greg Buckner,30,.448,67,15,.300,50,39,31,2,55,45,.385,117,19,.864,22,31,4,520,10,63,124,SG,21,29,65,MIN,.449
67,Caron Butler,373,.492,758,66,.357,185,284,27,20,295,439,.466,943,236,.901,262,58,58,2314,93,160,1180,SF,128,150,388,WAS,.501
68,Rasual Butler,47,.370,127,44,.331,133,36,28,21,84,91,.350,260,26,.839,31,51,8,875,16,66,252,SF,15,10,100,NOH,.435
69,Andrew Bynum,189,.636,297,0,,0,61,20,72,251,189,.636,297,82,.695,118,35,25,1008,105,98,460,C,12,52,356,LAL,.636
70,Jose Calderon,288,.551,523,79,.429,184,678,26,6,202,367,.519,707,109,.908,120,82,56,2484,34,134,922,PG,87,126,236,TOR,.575
71,Marcus Camby,280,.455,615,6,.300,20,259,33,285,807,286,.450,635,143,.708,202,79,79,2758,230,216,721,C,85,118,1037,DEN,.455
72,Brian Cardinal,18,.400,45,25,.309,81,22,30,2,70,43,.341,126,13,.684,19,37,1,440,26,62,124,PF,10,23,96,MEM,.440
73,Rodney Carney,120,.441,272,38,.317,120,32,23,23,99,158,.403,392,55,.679,81,70,6,1039,50,96,409,SF,39,34,149,PHI,.452
74,Matt Carroll,147,.422,348,105,.436,241,73,27,19,193,252,.428,589,111,.804,138,80,18,2016,33,187,720,SG,46,58,226,CHA,.517
75,Anthony Carter,173,.499,347,45,.349,129,388,32,28,173,218,.458,476,64,.753,85,70,67,1960,27,172,545,PG,107,124,200,DEN,.505
76,Vince Carter,489,.482,1014,98,.359,273,389,31,33,341,587,.456,1287,350,.816,429,76,72,2959,112,241,1622,SG,93,181,453,NJN,.494
77,Sam Cassell,210,.461,456,23,.303,76,214,38,6,119,233,.438,532,127,.882,144,55,34,1274,17,98,616,PG,37,97,136,TOT,.460
78,Tyson Chandler,377,.624,604,0,.000,1,81,25,84,606,377,.623,605,175,.593,295,79,79,2783,322,243,929,C,45,136,928,NOH,.623
79,Wilson Chandler,97,.458,212,9,.300,30,33,20,16,89,106,.438,242,34,.630,54,35,16,685,38,83,255,SF,15,27,127,NYK,.457
80,Josh Childress,305,.595,513,22,.367,60,117,24,43,199,327,.571,573,222,.807,275,76,0,2274,174,129,898,SF,71,98,373,ATL,.590
81,Jarron Collins,36,.444,81,0,.000,1,37,29,6,76,36,.439,82,46,.622,74,70,9,702,40,106,118,C,10,22,116,UTA,.439
82,Jason Collins,53,.473,112,0,.000,1,25,29,25,114,53,.469,113,34,.459,74,74,26,1172,64,194,140,C,23,48,178,TOT,.469
83,Mardy Collins,49,.343,143,8,.250,32,89,23,8,56,57,.326,175,23,.605,38,46,8,634,19,56,145,SG,24,56,75,NYK,.349
84,Nick Collison,322,.504,639,0,.000,2,113,27,60,476,322,.502,641,123,.737,167,78,35,2223,254,250,767,PF,47,118,730,SEA,.502
85,Mike Conley,159,.453,351,30,.330,91,222,20,2,118,189,.428,442,90,.732,123,53,46,1381,21,85,498,PG,44,89,139,MEM,.462
86,Brian Cook,45,.378,119,43,.374,115,27,27,12,81,88,.376,234,19,.905,21,51,2,629,28,93,238,PF,13,39,109,TOT,.468
87,Daequan Cook,117,.424,276,79,.332,238,75,20,9,157,196,.381,514,47,.825,57,59,19,1441,20,157,518,SG,23,63,177,MIA,.458
88,Jamal Crawford,394,.439,897,176,.356,494,398,27,17,170,570,.410,1391,329,.864,381,80,80,3190,37,144,1645,SG,81,192,207,NYK,.473
89,Javaris Crittenton,88,.449,196,10,.270,37,51,20,2,83,98,.421,233,72,.692,104,50,0,679,27,47,278,SG,19,55,110,TOT,.442
90,Austin Croshere,39,.513,76,22,.361,61,30,32,6,71,61,.445,137,29,.906,32,44,0,457,33,60,173,PF,8,22,104,GSW,.526
91,Eddy Curry,297,.546,544,0,,0,32,25,29,164,297,.546,544,187,.623,300,59,58,1530,111,157,781,C,14,126,275,NYK,.546
92,Samuel Dalembert,339,.514,660,0,.000,1,45,26,192,545,339,.513,661,186,.707,263,82,82,2724,304,269,864,C,40,155,849,PHI,.513
93,Erick Dampier,178,.643,277,0,,0,63,32,106,332,178,.643,277,84,.575,146,72,64,1755,207,226,440,C,24,80,539,DAL,.643
94,Antonio Daniels,188,.504,373,17,.230,74,340,32,2,180,205,.459,447,170,.776,219,71,63,2161,23,78,597,PG,69,91,203,WAS,.478
95,Marquis Daniels,214,.466,459,27,.265,102,137,27,18,146,241,.430,561,97,.698,139,74,1,1546,66,121,606,SG,79,112,212,IND,.454
96,Jermareo Davidson,51,.408,125,0,,0,13,23,15,41,51,.408,125,18,.643,28,38,2,322,21,46,120,SF,7,17,62,CHA,.408
97,Baron Davis,477,.477,1001,173,.330,525,623,28,43,289,650,.426,1526,318,.750,424,82,82,3196,96,247,1791,PG,191,232,385,GSW,.483
98,Glen Davis,107,.484,221,0,,0,28,22,20,113,107,.484,221,99,.660,150,69,1,940,95,160,313,C,31,65,208,BOS,.484
99,Paul Davis,24,.369,65,0,,0,10,23,6,22,24,.369,65,6,.600,10,22,1,194,25,33,54,PF,6,9,47,LAC,.369
100,Ricky Davis,285,.447,638,135,.405,333,276,28,14,298,420,.433,971,155,.787,197,82,47,2963,55,187,1130,SF,87,191,353,MIA,.502
101,Carlos Delfino,131,.412,318,120,.382,314,145,25,11,293,251,.397,632,116,.744,156,82,0,1928,66,177,738,SG,69,75,359,TOR,.492
102,Luol Deng,421,.482,874,8,.364,22,155,22,29,258,429,.479,896,204,.770,265,63,59,2128,136,117,1070,SF,57,120,394,CHI,.483
103,Boris Diaw,295,.488,605,13,.317,41,317,25,39,281,308,.477,646,96,.744,129,82,19,2308,97,166,725,PF,61,155,378,PHO,.487
104,Yakhouba Diawara,34,.500,68,21,.318,66,37,25,3,39,55,.410,134,22,.710,31,54,14,542,23,61,153,SG,8,16,62,DEN,.489
105,Guillermo Diaz,1,.333,3,0,.000,1,1,22,0,0,1,.250,4,3,.600,5,6,0,18,2,0,5,SG,0,0,2,LAC,.250
106,Dan Dickau,88,.468,188,36,.333,108,172,29,3,84,124,.419,296,68,.829,82,67,8,1040,13,108,352,PG,32,55,97,LAC,.480
107,Kaniel Dickens,1,.333,3,0,,0,1,29,1,1,1,.333,3,0,,0,5,0,12,0,1,2,PF,0,0,1,CLE,.333
108,Travis Diener,85,.431,197,74,.318,233,251,25,4,89,159,.370,430,64,.901,71,66,21,1356,26,107,456,PG,35,55,115,IND,.456
109,Ike Diogu,64,.478,134,0,,0,10,24,3,47,64,.478,134,40,.851,47,30,1,305,38,43,168,PF,7,20,85,IND,.478
110,DeSagana Diop,94,.522,180,0,,0,40,26,88,232,94,.522,180,38,.543,70,79,23,1295,160,146,226,C,26,58,392,TOT,.522
111,Juan Dixon,76,.409,186,30,.417,72,97,29,2,60,106,.411,258,21,.808,26,53,0,668,15,62,263,PG,21,54,75,TOT,.469
112,Michael Doleac,28,.444,63,0,,0,7,30,10,33,28,.444,63,1,.500,2,24,8,257,16,44,57,C,10,12,49,MIN,.444
113,Keyon Dooling,176,.492,358,22,.338,65,133,27,5,94,198,.468,423,163,.845,193,72,1,1334,7,131,581,PG,36,61,101,ORL,.494
114,Quincy Douby,90,.423,213,42,.344,122,53,23,12,66,132,.394,335,48,.923,52,74,0,876,17,80,354,PG,30,59,83,SAC,.457
115,Jared Dudley,154,.502,307,9,.220,41,81,22,10,165,163,.468,348,87,.737,118,73,14,1384,121,128,422,PF,55,50,286,CHA,.481
116,Chris Duhon,79,.418,189,54,.348,155,263,25,2,97,133,.387,344,65,.813,80,66,18,1490,19,92,385,PG,48,71,116,CHI,.465
117,Tim Duncan,585,.498,1174,0,.000,4,218,31,152,644,585,.497,1178,338,.730,463,78,78,2651,237,185,1508,C,56,178,881,SAS,.497
118,Mike Dunleavy,367,.504,728,165,.424,389,288,27,31,365,532,.476,1117,336,.834,403,82,82,2953,59,208,1565,SG,86,190,424,IND,.550
119,Ronald Dupree,1,.333,3,0,,0,1,27,0,7,1,.333,3,2,1.000,2,5,0,21,1,0,4,SF,1,0,8,TOT,.333
120,Kevin Durant,528,.455,1161,59,.288,205,192,19,75,278,587,.430,1366,391,.873,448,80,80,2768,70,122,1624,SG,78,232,348,SEA,.451
121,Monta Ellis,640,.545,1175,12,.231,52,315,22,27,271,652,.531,1227,320,.767,417,81,72,3071,133,195,1636,SG,124,173,404,GSW,.536
122,Francisco Elson,92,.391,235,0,.000,1,24,31,20,150,92,.390,236,26,.703,37,63,5,813,50,96,210,C,15,47,200,TOT,.390
123,Melvin Ely,85,.472,180,0,,0,22,29,18,117,85,.472,180,32,.552,58,52,1,621,28,79,202,C,7,42,145,NOH,.472
124,Maurice Evans,181,.539,336,81,.388,209,81,29,10,126,262,.481,545,59,.711,83,75,47,1720,92,142,664,SG,46,40,218,TOT,.555
125,Reggie Evans,151,.438,345,1,1.000,1,65,27,8,387,152,.439,346,120,.467,257,81,61,1879,224,213,425,PF,86,108,611,PHI,.441
126,Jordan Farmar,177,.546,324,114,.371,307,225,21,5,144,291,.461,631,53,.679,78,82,0,1690,39,105,749,PG,77,108,183,LAL,.552
127,Nick Fazekas,46,.575,80,0,.000,2,11,22,11,55,46,.561,82,15,.682,22,26,0,269,34,25,107,PF,8,13,89,TOT,.561
128,Raymond Felton,356,.447,797,56,.280,200,583,23,12,199,412,.413,997,260,.800,325,79,79,2972,37,184,1140,PG,96,213,236,CHA,.441
129,Kyrylo Fesenko,6,.375,16,0,,0,2,21,3,11,6,.375,16,2,.500,4,9,0,70,14,19,14,C,0,8,25,UTA,.375
130,Michael Finley,183,.453,404,132,.370,357,114,34,10,227,315,.414,761,64,.800,80,82,61,2204,27,93,826,SG,29,56,254,SAS,.501
131,Derek Fisher,227,.453,501,112,.406,276,239,33,3,146,339,.436,777,166,.883,188,82,82,2249,24,188,956,PG,86,90,170,LAL,.508
132,T.J. Ford,231,.488,473,15,.294,51,313,24,0,77,246,.469,524,110,.880,125,51,26,1199,23,93,617,PG,54,102,100,TOR,.484
133,Jeff Foster,205,.554,370,0,.000,3,129,31,32,404,205,.550,373,86,.593,145,77,52,1884,264,221,496,C,56,62,668,IND,.550
134,Randy Foye,137,.436,314,61,.412,148,164,24,3,115,198,.429,462,53,.815,65,39,31,1259,13,102,510,PG,36,79,128,MIN,.495
135,Adonal Foyle,70,.458,153,0,,0,18,32,45,137,70,.458,153,16,.471,34,82,0,774,71,94,156,C,16,32,208,ORL,.458
136,Richie Frahm,13,.448,29,7,.280,25,8,30,0,10,20,.370,54,0,.000,2,10,2,163,4,7,47,SG,2,6,14,LAC,.435
137,Steve Francis,15,.375,40,4,.235,17,30,30,5,15,19,.333,57,13,.565,23,10,3,199,8,25,55,PG,9,14,23,HOU,.368
138,Channing Frye,218,.492,443,3,.300,10,57,24,27,247,221,.488,453,85,.780,109,78,20,1342,107,208,530,C,29,55,354,POR,.491
139,Dan Gadzuric,64,.418,153,0,.000,1,11,29,24,77,64,.416,154,33,.524,63,51,4,534,67,83,161,C,20,34,144,MIL,.416
140,Jorge Garbajosa,2,.222,9,6,.375,16,3,30,0,13,8,.320,25,0,,0,7,0,74,2,2,22,PF,3,1,15,TOR,.440
141,Francisco Garcia,235,.508,463,113,.391,289,128,26,50,212,348,.463,752,162,.779,208,79,20,2096,52,232,971,SF,96,128,264,SAC,.538
142,Thomas Gardner,6,.545,11,3,.250,12,1,22,0,1,9,.391,23,0,.000,2,4,0,45,3,4,21,SG,0,4,4,CHI,.457
143,Kevin Garnett,534,.545,979,0,.000,11,244,31,89,520,534,.539,990,269,.801,336,71,71,2328,135,163,1337,PF,100,138,655,BOS,.539
144,Pat Garrity,19,.442,43,8,.216,37,13,31,1,35,27,.338,80,4,.800,5,31,0,284,9,35,66,PF,6,17,44,ORL,.388
145,Pau Gasol,471,.539,874,4,.250,16,211,27,98,398,475,.534,890,292,.807,362,66,66,2351,155,139,1246,C,30,124,553,TOT,.536
146,Rudy Gay,491,.507,968,134,.346,387,158,21,79,359,625,.461,1355,248,.785,316,81,81,3000,140,230,1632,SF,111,190,499,MEM,.511
147,Mickael Gelabale,53,.442,120,16,.432,37,33,24,9,42,69,.439,157,14,.778,18,39,0,465,16,31,168,SG,10,27,58,SEA,.490
148,Devean George,52,.374,139,22,.324,68,35,30,13,109,74,.357,207,24,.706,34,53,4,821,28,90,194,SF,19,24,137,DAL,.411
149,Daniel Gibson,83,.421,197,118,.440,268,145,21,14,104,201,.432,465,85,.810,105,58,26,1765,30,163,605,PG,47,76,134,CLE,.559
150,Eddie Gill,7,.438,16,5,.333,15,22,29,2,21,12,.387,31,9,1.000,9,14,1,154,1,18,38,PG,7,9,22,TOT,.468
151,Manu Ginobili,297,.499,595,156,.401,389,332,30,33,291,453,.460,984,380,.860,442,74,23,2299,63,173,1442,SG,109,200,354,SAS,.540
152,Gordan Giricek,97,.478,203,36,.364,99,62,30,4,80,133,.440,302,23,.885,26,56,0,831,16,82,325,SG,24,52,96,TOT,.500
153,Ryan Gomes,333,.491,678,59,.330,179,145,25,10,342,392,.457,857,190,.830,229,82,74,2434,133,154,1033,PF,65,96,475,MIN,.492
154,Drew Gooden,332,.452,734,0,.000,6,81,26,53,415,332,.449,740,162,.753,215,69,65,2122,175,203,826,PF,48,122,590,TOT,.449
155,Ben Gordon,322,.445,723,142,.410,346,213,24,8,181,464,.434,1069,266,.908,293,72,27,2291,40,171,1336,SG,55,150,221,CHI,.500
156,Marcin Gortat,8,.471,17,0,,0,2,23,1,8,8,.471,17,2,.667,3,6,0,41,8,4,18,C,1,2,16,ORL,.471
157,Joey Graham,47,.427,110,2,.667,3,15,25,0,49,49,.434,113,38,.844,45,38,3,331,18,47,138,SF,3,23,67,TOR,.442
158,Stephen Graham,27,.614,44,7,.500,14,9,25,1,18,34,.586,58,12,.750,16,22,0,128,4,14,87,SF,4,10,22,IND,.647
159,Danny Granger,366,.468,782,171,.404,423,166,24,84,393,537,.446,1205,322,.852,378,80,80,2876,93,290,1567,SF,95,171,486,IND,.517
160,Aaron Gray,103,.507,203,0,.000,1,41,23,16,98,103,.505,204,56,.566,99,61,1,613,70,117,262,C,21,57,168,CHI,.505
161,Gerald Green,37,.330,112,15,.385,39,29,22,4,51,52,.344,151,34,.829,41,30,0,362,13,45,153,SF,8,32,64,TOT,.394
162,Jeff Green,299,.444,673,21,.276,76,119,21,49,278,320,.427,749,177,.744,238,80,52,2253,101,198,838,SF,46,158,379,SEA,.441
163,Taurean Green,5,.357,14,2,.182,11,11,21,0,10,7,.280,25,11,.917,12,17,0,74,0,5,27,SG-PG,2,9,10,TOT,.320
164,Willie Green,328,.475,691,51,.285,179,151,26,22,150,379,.436,870,112,.757,148,74,74,1970,32,119,921,SG,54,109,182,PHI,.465
165,Orien Greene,3,.300,10,0,.000,1,3,25,1,6,3,.273,11,0,,0,7,2,61,0,9,6,SG,3,7,6,SAC,.273
166,Adrian Griffin,30,.395,76,0,,0,27,33,2,31,30,.395,76,5,.556,9,35,2,307,28,27,65,SG-SF,17,21,59,TOT,.395
167,Richard Hamilton,437,.492,889,62,.440,141,299,29,10,160,499,.484,1030,184,.833,221,72,72,2424,75,171,1244,SG,73,132,235,DET,.515
168,Anfernee Hardaway,14,.341,41,8,.421,19,35,36,1,32,22,.367,60,8,.889,9,16,8,325,3,24,60,SF,19,13,35,MIA,.433
169,Matt Harpring,235,.506,464,2,.200,10,82,31,14,144,237,.500,474,146,.712,205,76,0,1374,96,162,622,SF,45,95,240,UTA,.502
170,Al Harrington,248,.482,515,153,.375,408,132,27,16,332,401,.434,923,147,.774,190,81,59,2190,107,266,1102,C,74,90,439,GSW,.517
171,Othella Harrington,18,.429,42,0,,0,4,34,4,31,18,.429,42,10,.625,16,22,0,166,11,34,46,C,1,11,42,CHA,.429
172,Devin Harris,265,.504,526,56,.335,167,369,24,10,145,321,.463,693,248,.824,301,64,61,2022,28,190,946,PG,90,161,173,TOT,.504
173,Mike Harris,27,.519,52,0,.000,2,3,24,3,30,27,.500,54,8,.615,13,17,0,159,24,16,62,PF,6,9,54,HOU,.500
174,David Harrison,90,.529,170,0,,0,14,25,59,75,90,.529,170,49,.510,96,55,0,702,43,164,229,C,20,58,118,IND,.529
175,Jason Hart,47,.315,149,11,.355,31,86,29,3,50,58,.322,180,38,.844,45,57,0,606,5,75,165,PG,30,28,55,UTA,.353
176,Udonis Haslem,237,.467,507,0,,0,68,27,18,336,237,.467,507,115,.810,142,49,48,1805,107,145,589,PF,39,67,443,MIA,.467
177,Trenton Hassell,55,.437,126,2,.222,9,41,28,3,63,57,.422,135,7,.700,10,63,6,773,20,90,123,SG,13,22,83,TOT,.430
178,Spencer Hawes,142,.478,297,4,.190,21,44,19,40,162,146,.459,318,38,.655,58,71,8,931,68,128,334,C,14,56,230,SAC,.465
179,Chuck Hayes,113,.518,218,0,.000,3,91,24,43,295,113,.511,221,11,.458,24,79,44,1575,132,212,237,PF,85,62,427,HOU,.511
180,Jarvis Hayes,144,.465,310,73,.376,194,62,26,6,143,217,.431,504,45,.750,60,82,1,1287,35,137,552,SF,47,47,178,DET,.503
181,Brendan Haywood,316,.528,599,0,,0,71,28,133,303,316,.528,599,216,.735,294,80,80,2228,273,216,848,C,31,108,576,WAS,.528
182,Luther Head,127,.504,252,79,.351,225,138,25,9,117,206,.432,477,66,.815,81,73,17,1379,18,75,557,SG,44,70,135,HOU,.515
183,Walter Herrmann,36,.450,80,20,.313,64,18,28,1,51,56,.389,144,21,.840,25,45,0,373,22,24,153,PF,7,12,73,TOT,.458
184,Nene Hilario,29,.414,70,0,.000,1,15,25,14,57,29,.408,71,27,.551,49,16,1,266,30,46,85,PF,9,21,87,DEN,.408
185,Grant Hill,325,.535,608,33,.317,104,203,35,56,279,358,.503,712,170,.867,196,70,68,2222,74,153,919,SF,65,96,353,PHO,.526
186,Kirk Hinrich,246,.442,557,84,.350,240,452,27,19,216,330,.414,797,118,.831,142,75,72,2380,28,224,862,PG,87,157,244,CHI,.467
187,Ryan Hollins,46,.489,94,0,,0,14,23,30,54,46,.489,94,55,.671,82,60,1,532,53,96,147,PF,10,25,107,CHA,.489
188,Al Horford,333,.502,663,0,.000,5,124,21,76,537,333,.499,668,155,.731,212,81,77,2540,248,267,821,C,60,137,785,ATL,.499
189,Robert Horry,20,.408,49,18,.257,70,47,37,19,74,38,.319,119,18,.643,28,45,5,583,35,55,112,PF,21,22,109,SAS,.395
190,Eddie House,100,.429,233,117,.393,298,152,29,10,148,217,.409,531,33,.917,36,78,2,1480,19,114,584,PG,59,76,167,BOS,.519
191,Dwight Howard,583,.601,970,0,.000,4,110,22,176,882,583,.599,974,529,.590,897,82,82,3088,279,274,1695,C,74,263,1161,ORL,.599
192,Josh Howard,500,.482,1037,67,.319,210,164,27,32,412,567,.455,1247,312,.813,384,76,76,2757,120,202,1513,SF,59,114,532,DAL,.482
193,Juwan Howard,23,.359,64,0,,0,17,34,2,60,23,.359,64,11,.786,14,50,0,353,21,62,57,PF,5,17,81,DAL,.359
194,Troy Hudson,5,.263,19,4,.333,12,9,31,0,7,9,.290,31,6,1.000,6,9,0,93,0,4,28,PG,3,7,7,GSW,.355
195,Larry Hughes,238,.392,607,67,.345,194,181,29,17,191,305,.381,801,150,.798,188,68,57,2020,39,139,827,PG-SG,99,116,230,TOT,.423
196,Kris Humphries,161,.486,331,0,.000,2,28,22,28,169,161,.483,333,75,.605,124,70,0,925,90,107,397,PF,25,47,259,TOR,.483
197,Lindsey Hunter,15,.395,38,7,.269,26,33,37,2,9,22,.344,64,7,.778,9,24,0,215,4,30,58,PG,13,13,13,DET,.398
198,Steven Hunter,15,.536,28,0,,0,0,26,6,19,15,.536,28,9,.450,20,19,2,120,10,20,39,C,0,7,29,DEN,.536
199,Andre Iguodala,481,.496,970,101,.329,307,391,24,49,361,582,.456,1277,365,.721,506,82,82,3242,85,187,1630,SF,171,214,446,PHI,.495
200,Zydrunas Ilgauskas,417,.475,878,0,.000,1,104,32,120,419,417,.474,879,195,.802,243,73,73,2222,263,247,1029,C,34,135,682,CLE,.474
201,Didier Ilunga-Mbenga,39,.464,84,0,,0,10,27,26,44,39,.464,84,5,.417,12,42,0,326,28,70,83,C,7,12,72,TOT,.464
202,Allen Iverson*,617,.482,1281,95,.345,275,586,32,12,196,712,.458,1556,645,.809,797,82,82,3424,47,109,2164,SG,160,245,243,DEN,.488
203,Royal Ivey,114,.421,271,35,.327,107,160,26,7,80,149,.394,378,85,.726,117,75,20,1437,38,166,418,PG,45,75,118,MIL,.440
204,Jarrett Jack,202,.470,430,65,.342,190,313,24,1,203,267,.431,620,215,.867,248,82,16,2229,31,129,814,SG,61,178,234,POR,.483
205,Bobby Jackson,123,.439,280,81,.358,226,139,34,5,148,204,.403,506,64,.790,81,72,5,1389,33,96,553,SG-PG,45,59,181,TOT,.483
206,Luke Jackson,15,.300,50,11,.367,30,17,26,0,26,26,.325,80,16,.696,23,14,1,228,7,22,79,SF,8,9,33,MIA,.394
207,Stephen Jackson,306,.435,703,182,.363,501,300,29,29,251,488,.405,1204,308,.832,370,73,73,2855,67,171,1466,SF,92,197,318,GSW,.481
208,Casey Jacobsen,23,.535,43,16,.222,72,20,26,1,53,39,.339,115,13,.765,17,53,0,547,12,34,107,SG,5,16,65,MEM,.409
209,Jerome James,1,1.000,1,0,,0,0,32,0,3,1,1.000,1,2,1.000,2,2,0,5,0,0,4,C,0,0,3,NYK,1.000
210,LeBron James,681,.531,1283,113,.315,359,539,23,81,459,794,.484,1642,549,.712,771,75,74,3027,133,165,2250,SF,138,255,592,CLE,.518
211,Mike James,70,.363,193,31,.320,97,60,32,2,55,101,.348,290,39,.813,48,54,1,720,14,56,272,PG,21,36,69,TOT,.402
212,Antawn Jamison,498,.468,1063,120,.339,354,120,31,34,591,618,.436,1417,333,.760,438,79,79,3061,215,195,1689,PF,106,113,806,WAS,.478
213,Marko Jaric,181,.451,401,46,.362,127,311,29,32,184,227,.430,528,121,.742,163,75,56,2189,38,180,621,SG,97,128,222,MIN,.473
214,Al Jefferson,721,.502,1436,0,.000,5,117,23,119,603,721,.500,1441,284,.721,394,82,82,2919,308,222,1726,C,74,167,911,MIN,.500
215,Richard Jefferson,542,.486,1115,77,.362,213,252,27,21,249,619,.466,1328,542,.798,679,82,82,3200,93,225,1857,SF,76,199,342,NJN,.495
216,Jared Jeffries,104,.424,245,4,.160,25,66,26,23,125,108,.400,270,49,.527,93,73,19,1325,118,132,269,SF,36,64,243,NYK,.407
217,Yi Jianlian,213,.427,499,6,.286,21,55,20,56,238,219,.421,520,122,.841,145,66,49,1647,106,153,566,PF,36,90,344,MIL,.427
218,Alexander Johnson,61,.488,125,0,,0,13,24,10,62,61,.488,125,57,.687,83,43,6,549,32,80,179,PF,13,42,94,MIA,.488
219,Amir Johnson,92,.558,165,0,,0,29,20,82,148,92,.558,165,37,.673,55,62,0,764,87,141,221,PF,24,39,235,DET,.558
220,Anthony Johnson,113,.431,262,42,.452,93,262,33,9,115,155,.437,355,35,.814,43,69,52,1531,22,115,387,PG,52,84,137,TOT,.496
221,DerMarr Johnson,4,.800,5,3,.333,9,1,27,0,1,7,.500,14,0,.000,2,5,0,28,0,4,17,SF,1,0,1,SAS,.607
222,Joe Johnson,478,.454,1053,169,.381,444,474,26,18,284,647,.432,1497,316,.834,379,82,82,3343,83,168,1779,SG,84,223,367,ATL,.489
223,Linton Johnson,8,.500,16,1,.333,3,4,27,1,9,9,.474,19,2,1.000,2,8,0,63,5,11,21,PF,0,5,14,TOT,.500
224,Bobby Jones,42,.483,87,18,.340,53,28,24,3,63,60,.429,140,40,.784,51,47,2,531,29,85,178,C-SF,15,28,92,TOT,.493
225,Dahntay Jones,22,.468,47,1,.167,6,12,27,6,28,23,.434,53,34,.667,51,25,0,206,7,28,81,SG,8,10,35,SAC,.443
226,Damon Jones,36,.414,87,115,.417,276,126,31,1,67,151,.416,363,20,.714,28,67,3,1336,5,66,437,SG,19,36,72,CLE,.574
227,Dwayne Jones,25,.543,46,0,.000,1,10,24,25,71,25,.532,47,28,.483,58,56,0,472,69,88,78,PF,10,17,140,CLE,.532
228,Eddie Jones,32,.500,64,34,.293,116,69,36,8,114,66,.367,180,10,.714,14,47,33,922,18,72,176,SG,26,29,132,DAL,.461
229,Fred Jones,108,.450,240,74,.385,192,166,28,18,140,182,.421,432,94,.746,126,70,26,1757,30,140,532,SG,48,78,170,NYK,.507
230,James Jones,52,.426,122,91,.444,205,34,27,15,118,143,.437,327,86,.878,98,58,3,1276,43,96,463,SF,24,28,161,POR,.576
231,Solomon Jones,12,.429,28,0,.000,2,0,23,5,23,12,.400,30,11,.550,20,35,0,145,19,28,35,PF,3,11,42,ATL,.400
232,Chris Kaman,338,.486,696,0,.000,4,107,25,155,538,338,.483,700,202,.762,265,56,55,2083,173,179,878,C,33,164,711,LAC,.483
233,Jason Kapono,186,.489,380,57,.483,118,65,26,2,89,243,.488,498,37,.860,43,81,7,1530,31,131,580,SF,34,58,120,TOR,.545
234,Coby Karl,5,.385,13,4,.308,13,9,24,2,11,9,.346,26,8,.800,10,17,0,71,3,4,30,SG,4,5,14,LAL,.423
235,Viktor Khryapa,12,.400,30,0,.000,1,8,25,0,14,12,.387,31,8,.571,14,9,0,105,6,11,32,PF,6,6,20,CHI,.387
236,Jason Kidd,186,.387,481,119,.381,312,806,34,26,506,305,.385,793,135,.818,165,80,80,2906,94,165,864,PG,136,266,600,TOT,.460
237,Tarence Kinsey,13,.419,31,3,.429,7,2,23,0,9,16,.421,38,5,.833,6,11,0,96,3,11,40,SG,3,3,12,MEM,.461
238,Andrei Kirilenko,231,.540,428,44,.379,116,285,26,109,218,275,.506,544,198,.770,257,72,72,2217,121,165,792,SF,86,140,339,UTA,.546
239,Linas Kleiza,217,.568,382,94,.339,277,95,23,19,241,311,.472,659,164,.770,213,79,13,1889,92,181,880,SF,44,89,333,DEN,.543
240,Brevin Knight,138,.411,336,0,.000,6,328,32,11,127,138,.404,342,62,.873,71,74,39,1674,15,160,338,PG,100,71,142,LAC,.404
241,Kyle Korver,144,.516,279,111,.375,296,101,26,29,151,255,.443,575,119,.915,130,75,0,1732,21,192,740,SG-PF,42,75,172,TOT,.540
242,Nenad Krstic,123,.413,298,0,.000,2,27,24,17,165,123,.410,300,52,.754,69,45,38,812,35,111,298,C,9,41,200,NJN,.410
243,Raef LaFrentz,27,.474,57,0,.000,4,6,31,17,39,27,.443,61,11,.579,19,39,0,291,28,59,65,C,12,10,67,POR,.443
244,Carl Landry,135,.619,218,0,.000,1,21,24,7,111,135,.616,219,72,.661,109,42,0,711,96,98,342,PF,17,26,207,HOU,.616
245,Keith Langford,1,.250,4,0,,0,0,24,0,2,1,.250,4,0,,0,2,0,10,0,1,2,SG,0,0,2,SAS,.250
246,Stephane Lasme,32,.451,71,0,,0,3,25,22,27,32,.451,71,19,.594,32,16,4,303,26,35,83,PF-SF,13,15,53,TOT,.451
247,Acie Law,88,.433,203,7,.206,34,113,23,0,45,95,.401,237,38,.792,48,56,6,865,12,73,235,PG,29,56,57,ATL,.416
248,David Lee,341,.554,616,0,.000,2,95,24,29,482,341,.552,618,194,.819,237,81,29,2356,242,210,876,PF,55,97,724,NYK,.552
249,Rashard Lewis,290,.498,582,226,.409,553,196,28,38,340,516,.455,1135,218,.838,260,81,81,3076,97,214,1476,PF,99,140,437,ORL,.554
250,Kyle Lowry,220,.487,452,36,.257,140,296,21,22,209,256,.432,592,243,.698,348,82,9,2089,41,185,791,PG,92,127,250,MEM,.463
251,Tyronn Lue,74,.443,167,39,.453,86,74,30,1,45,113,.447,253,25,.781,32,50,3,736,9,66,290,PG,11,27,54,TOT,.524
252,Mark Madsen,3,.158,19,0,,0,4,32,2,20,3,.158,19,3,.250,12,20,6,151,18,25,9,PF,3,9,38,MIN,.158
253,Corey Maggette,380,.477,797,78,.384,203,189,28,7,316,458,.458,1000,553,.812,681,70,65,2502,78,210,1547,SF,71,195,394,LAC,.497
254,Jamaal Magloire,18,.327,55,0,,0,7,29,10,70,18,.327,55,20,.455,44,31,2,286,19,50,56,C,1,30,89,TOT,.327
255,Ian Mahinmi,6,.500,12,0,,0,1,21,4,5,6,.500,12,9,1.000,9,6,0,23,0,4,21,C,0,2,5,SAS,.500
256,Stephon Marbury,83,.435,191,28,.378,74,113,30,2,42,111,.419,265,83,.716,116,24,19,805,17,57,333,PG,21,48,59,NYK,.472
257,Shawn Marion,334,.567,589,66,.333,198,138,29,85,507,400,.508,787,106,.707,150,63,62,2315,136,150,972,PF,125,86,643,TOT,.550
258,Sean Marks,22,.564,39,1,.250,4,4,32,10,27,23,.535,43,12,.632,19,19,0,130,9,23,59,C,3,8,36,PHO,.547
259,Donyell Marshall,17,.378,45,15,.283,53,10,34,16,52,32,.327,98,19,.864,22,26,1,340,24,31,98,PF,6,15,76,TOT,.403
260,Darrick Martin,8,.296,27,2,.125,16,21,36,0,4,10,.233,43,5,.833,6,17,0,141,3,12,27,PG,6,1,7,TOR,.256
261,Kenyon Martin,374,.544,688,2,.182,11,90,30,85,356,376,.538,699,123,.580,212,71,71,2159,105,235,877,PF,88,91,461,DEN,.539
262,Kevin Martin,310,.478,648,107,.402,266,129,24,5,225,417,.456,914,502,.869,578,61,57,2216,48,150,1443,SG,62,131,273,SAC,.515
263,Desmond Mason,230,.482,477,0,,0,121,30,30,181,230,.482,477,114,.659,173,59,56,1702,75,106,574,SF,40,83,256,MIL,.482
264,Roger Mason,136,.498,273,130,.398,327,134,27,18,113,266,.443,600,62,.873,71,80,9,1708,17,140,724,PG,40,69,130,WAS,.552
265,Jason Maxiell,240,.539,445,0,.000,1,46,24,94,256,240,.538,446,171,.633,270,82,7,1768,177,183,651,C,21,71,433,DET,.538
266,Rashad McCants,286,.481,595,142,.407,349,162,23,18,156,428,.453,944,116,.748,155,75,24,2020,50,234,1114,SG,66,172,206,MIN,.529
267,Jelani McCoy,1,1.000,1,0,,0,0,30,5,6,1,1.000,1,1,.500,2,6,1,33,1,7,3,C,0,4,7,DEN,1.000
268,Antonio McDyess,293,.490,598,0,.000,2,89,33,53,462,293,.488,600,97,.622,156,78,78,2285,204,246,683,PF,61,75,666,DET,.488
269,Tracy McGrady*,462,.457,1012,86,.292,295,387,28,30,297,548,.419,1307,245,.684,358,66,62,2440,42,91,1427,SG,68,160,339,HOU,.452
270,Dominic McGuire,38,.392,97,1,.167,6,40,22,26,86,39,.379,103,14,.438,32,70,1,695,53,76,93,SG,20,40,139,WAS,.383
271,Jeff McInnis,105,.457,230,3,.158,19,220,33,3,80,108,.434,249,23,.767,30,54,26,1410,16,120,242,PG,23,76,96,CHA,.440
272,Josh McRoberts,6,.667,9,0,.000,1,2,20,0,8,6,.600,10,0,,0,8,0,28,2,1,12,PF,1,2,10,POR,.600
273,Chris Mihm,32,.337,95,0,,0,13,28,14,49,32,.337,95,18,.667,27,23,5,278,28,42,82,C,4,17,77,LAL,.337
274,C.J. Miles,83,.522,159,30,.390,77,53,20,8,62,113,.479,236,41,.788,52,60,13,689,16,98,297,SG,32,27,78,UTA,.542
275,Darko Milicic,219,.439,499,0,.000,1,58,22,114,297,219,.438,500,67,.554,121,70,64,1663,127,185,505,C,32,101,424,MEM,.438
276,Andre Miller,566,.504,1122,3,.088,34,565,31,6,229,569,.492,1156,257,.772,333,82,82,3016,95,181,1398,PG,105,206,324,PHI,.494
277,Brad Miller,309,.484,638,28,.311,90,264,31,74,514,337,.463,728,262,.848,309,72,72,2513,167,247,964,C,69,164,681,SAC,.482
278,Mike Miller,259,.557,465,155,.432,359,240,27,16,416,414,.502,824,164,.774,212,70,70,2474,51,145,1147,SG,35,182,467,MEM,.596
279,Paul Millsap,253,.508,498,0,.000,4,81,22,73,293,253,.504,502,155,.677,229,82,2,1702,167,269,661,PF,72,87,460,UTA,.504
280,Yao Ming*,432,.508,850,0,.000,2,129,27,111,422,432,.507,852,345,.850,406,55,55,2044,172,171,1209,C,25,183,594,HOU,.507
281,Cuttino Mobley,310,.457,678,67,.349,192,202,32,34,225,377,.433,870,163,.819,199,77,38,2702,50,152,984,SG,78,123,275,LAC,.472
282,Nazr Mohammed,272,.516,527,0,.000,1,72,30,60,300,272,.515,528,95,.583,163,82,29,1650,194,230,639,C,45,101,494,TOT,.515
283,Jamario Moon,239,.528,453,40,.328,122,90,27,108,392,279,.485,575,63,.741,85,78,75,2166,92,152,661,SF,80,51,484,TOR,.520
284,Mikki Moore,282,.579,487,0,.000,2,84,32,46,334,282,.577,489,134,.736,182,82,79,2385,160,310,698,PF,35,110,494,SAC,.577
285,Randolph Morris,21,.362,58,0,,0,2,22,2,25,21,.362,58,14,.483,29,18,2,181,12,37,56,C,4,9,37,NYK,.362
286,Alonzo Mourning*,52,.547,95,0,,0,7,37,42,59,52,.547,95,45,.592,76,25,0,389,34,56,149,C,4,25,93,MIA,.547
287,Troy Murphy,221,.484,457,94,.398,236,165,27,32,435,315,.455,693,192,.797,241,75,61,2106,108,217,916,PF,49,96,543,IND,.522
288,Ronald Murray,134,.441,304,20,.317,63,144,28,4,60,154,.420,367,68,.694,98,42,19,874,23,50,396,PG,38,84,83,TOT,.447
289,Dikembe Mutombo*,43,.538,80,0,,0,5,41,48,131,43,.538,80,32,.711,45,39,25,619,68,55,118,C,11,17,199,HOU,.538
290,Bostjan Nachbar,151,.435,347,94,.359,262,88,27,21,204,245,.402,609,154,.786,196,75,1,1660,56,182,738,PF,44,85,260,NJN,.479
291,Eduardo Najera,121,.548,221,53,.361,147,95,31,40,224,174,.473,368,63,.708,89,78,3,1664,113,199,464,PF,69,59,337,DEN,.545
292,Steve Nash,306,.527,581,179,.470,381,898,33,5,254,485,.504,962,222,.906,245,81,81,2780,28,113,1371,PG,53,295,282,PHO,.597
293,Juan Carlos Navarro,152,.455,334,156,.361,432,177,27,1,176,308,.402,766,124,.849,146,82,30,2117,34,94,896,SG,48,134,210,MEM,.504
294,Jameer Nelson,219,.488,449,64,.416,154,383,25,4,215,283,.469,603,125,.828,151,69,62,1961,28,167,755,PG,63,141,243,ORL,.522
295,Rasho Nesterovic,256,.552,464,1,.333,3,82,31,52,212,257,.550,467,37,.755,49,71,39,1486,130,132,552,C,20,60,342,TOR,.551
296,Ira Newble,60,.480,125,16,.327,49,18,33,8,78,76,.437,174,20,.769,26,49,13,698,47,69,188,SG-SF,28,34,125,TOT,.483
297,Demetris Nichols,3,.300,10,3,.231,13,1,23,3,5,6,.261,23,0,,0,14,0,44,0,4,15,SF,0,4,5,TOT,.326
298,Joakim Noah,177,.484,366,0,.000,1,84,22,64,242,177,.482,367,134,.691,194,74,31,1534,174,173,488,C,68,89,416,CHI,.482
299,Andres Nocioni,253,.476,531,126,.364,346,95,28,43,294,379,.432,877,196,.807,243,82,27,2021,48,245,1080,SF,25,133,342,CHI,.504
300,Steve Novak,15,.484,31,34,.479,71,6,24,3,31,49,.480,102,3,.750,4,35,0,264,4,17,135,SF,2,4,35,HOU,.647
301,Dirk Nowitzki,551,.504,1094,79,.359,220,266,29,71,564,630,.479,1314,478,.879,544,77,77,2769,95,198,1817,PF,51,160,659,DAL,.510
302,Patrick O'Bryant,16,.552,29,0,,0,4,21,9,19,16,.552,29,3,.600,5,24,0,99,10,27,35,C,4,7,29,GSW,.552
303,Jermaine O'Neal,225,.444,507,0,.000,5,93,29,87,201,225,.439,512,121,.742,163,42,34,1206,82,129,571,C,20,106,283,IND,.439
304,Shaquille O'Neal*,331,.593,558,0,,0,93,35,88,388,331,.593,558,170,.503,338,61,61,1748,166,228,832,C,32,181,554,TOT,.593
305,Fabricio Oberto,180,.610,295,0,.000,1,95,32,20,277,180,.608,296,37,.607,61,82,64,1644,153,203,397,PF,37,51,430,SAS,.608
306,Lamar Odom,386,.566,682,31,.274,113,273,28,72,622,417,.525,795,229,.698,328,77,77,2921,197,222,1094,PF,75,156,819,LAL,.544
307,Emeka Okafor,460,.535,860,0,,0,70,25,138,621,460,.535,860,213,.570,374,82,82,2718,255,241,1133,C,62,164,876,CHA,.535
308,Mehmet Okur,260,.475,547,114,.388,294,145,28,29,424,374,.445,841,185,.804,230,72,72,2390,132,236,1047,C,55,104,556,UTA,.512
309,Kevin Ollie,29,.426,68,0,.000,1,38,35,0,15,29,.420,69,12,.800,15,40,0,300,4,28,70,SG,10,5,19,PHI,.420
310,Bo Outlaw,2,.667,3,0,,0,0,36,0,0,2,.667,3,0,,0,2,0,7,0,1,4,PF,0,1,0,ORL,.667
311,Travis Outlaw,377,.437,863,40,.396,101,106,23,63,280,417,.433,964,218,.741,294,82,6,2186,96,173,1092,PF,59,107,376,POR,.453
312,Andre Owens,22,.328,67,18,.450,40,47,27,3,34,40,.374,107,25,.735,34,31,7,392,13,37,123,PG,13,24,47,IND,.458
313,Zaza Pachulia,107,.442,242,0,.000,3,36,23,13,159,107,.437,245,108,.706,153,62,5,944,89,140,322,C,24,69,248,ATL,.437
314,Jannero Pargo,189,.406,466,65,.349,186,192,28,5,104,254,.390,652,71,.877,81,80,5,1497,26,123,644,SG,50,93,130,NOH,.439
315,Anthony Parker,262,.499,525,133,.438,304,183,32,17,284,395,.476,829,102,.816,125,82,82,2634,50,157,1025,SG,79,87,334,TOR,.557
316,Smush Parker,46,.434,106,18,.231,78,84,26,6,47,64,.348,184,19,.679,28,28,2,592,4,60,165,PG,24,44,51,TOT,.397
317,Tony Parker,498,.510,977,17,.258,66,411,25,8,191,515,.494,1043,248,.715,347,69,68,2312,30,93,1295,PG,55,164,221,SAS,.502
318,Ruben Patterson,39,.464,84,0,.000,2,17,32,7,40,39,.453,86,24,.558,43,20,5,327,24,37,102,SF,21,27,64,LAC,.453
319,Chris Paul,538,.516,1042,92,.369,249,925,22,4,259,630,.488,1291,332,.851,390,80,80,3006,62,185,1684,PG,217,201,321,NOH,.524
320,Sasha Pavlovic,112,.388,289,34,.298,114,82,24,6,93,146,.362,403,53,.688,77,51,45,1188,35,117,379,SG,29,55,128,CLE,.404
321,Oleksiy Pecherov,27,.415,65,17,.283,60,7,22,5,45,44,.352,125,20,.645,31,35,0,320,21,30,125,C,6,17,66,WAS,.420
322,Kendrick Perkins,214,.617,347,0,.000,1,84,23,114,329,214,.615,348,114,.623,183,78,78,1912,145,242,542,C,31,125,474,BOS,.615
323,Kosta Perovic,3,.300,10,0,,0,1,22,2,7,3,.300,10,4,.667,6,7,0,38,6,6,10,C,0,1,13,GSW,.300
324,Morris Peterson,102,.445,229,113,.394,287,67,30,7,170,215,.417,516,65,.765,85,76,76,1796,36,125,608,SG,47,41,206,NOH,.526
325,Johan Petro,184,.420,438,0,.000,1,32,22,42,272,184,.419,439,64,.736,87,72,28,1310,98,173,432,C,35,73,370,SEA,.419
326,Eric Piatkowski,1,.143,7,11,.423,26,10,37,1,11,12,.364,33,4,1.000,4,16,0,113,1,11,39,SF,0,6,12,PHO,.530
327,Paul Pierce,366,.499,733,143,.392,365,363,30,36,358,509,.464,1098,409,.843,485,80,80,2874,53,200,1570,SF,101,221,411,BOS,.529
328,Mickael Pietrus,104,.510,204,66,.361,183,49,25,43,175,170,.439,387,66,.673,98,66,16,1316,67,200,472,SF,66,48,242,GSW,.525
329,Scot Pollard,12,.522,23,0,,0,3,32,6,23,12,.522,23,15,.682,22,22,0,173,14,43,39,C,3,5,37,BOS,.522
330,James Posey,67,.496,135,106,.380,279,114,31,19,292,173,.418,414,93,.809,115,74,2,1821,30,182,545,PF,72,65,322,BOS,.546
331,Leon Powe,154,.575,268,0,.000,1,15,24,16,132,154,.572,269,137,.710,193,56,5,809,95,127,445,C,15,43,227,BOS,.572
332,Josh Powell,145,.465,312,0,.000,3,47,25,23,216,145,.460,315,63,.724,87,64,25,1228,115,130,353,C,14,65,331,LAC,.460
333,Kasib Powell,27,.435,62,8,.242,33,18,26,2,36,35,.368,95,6,.667,9,11,4,304,8,18,84,SF,9,5,44,MIA,.411
334,Ronnie Price,62,.481,129,26,.347,75,78,24,3,38,88,.431,204,26,.684,38,61,3,588,8,83,228,PG,32,30,46,UTA,.495
335,Tayshaun Prince,368,.463,794,53,.363,146,268,27,33,289,421,.448,940,185,.768,241,82,82,2694,109,90,1080,SF,42,91,398,DET,.476
336,Gabe Pruitt,11,.407,27,3,.250,12,13,21,0,7,14,.359,39,1,.500,2,15,0,95,1,10,32,PG,5,5,8,BOS,.397
337,Joel Przybilla,144,.578,249,0,.000,1,27,28,93,454,144,.576,250,83,.680,122,77,67,1819,195,234,371,C,13,95,649,POR,.576
338,Chris Quinn,94,.439,214,64,.403,159,178,24,4,107,158,.424,373,85,.867,98,60,25,1340,11,90,465,PG,46,55,118,MIA,.509
339,Vladimir Radmanovic,103,.507,203,95,.406,234,123,27,12,159,198,.453,437,52,.800,65,65,41,1483,56,147,543,SF,46,73,215,LAL,.562
340,Shavlik Randolph,4,.286,14,0,,0,3,24,3,2,4,.286,14,0,,0,9,0,27,9,5,8,PF,1,2,11,PHI,.286
341,Zach Randolph,464,.474,978,22,.275,80,140,26,16,526,486,.459,1058,223,.772,289,69,68,2244,184,194,1217,C,59,186,710,NYK,.470
342,Theo Ratliff,41,.488,84,0,.000,1,14,34,37,57,41,.482,85,29,.674,43,26,9,437,32,59,111,C-PF,7,21,89,TOT,.482
343,Michael Redd,420,.475,884,130,.362,359,247,28,13,224,550,.442,1243,402,.820,490,72,71,2702,85,120,1632,SG,65,181,309,MIL,.495
344,J.J. Redick,31,.477,65,17,.395,43,16,23,0,22,48,.444,108,27,.794,34,34,0,276,1,29,140,SG,4,15,23,ORL,.523
345,Chris Richard,41,.471,87,0,,0,18,23,12,83,41,.471,87,16,.593,27,52,3,556,52,83,98,C,10,24,135,MIN,.471
346,Jason Richardson,405,.466,869,243,.406,599,258,27,57,361,648,.441,1468,249,.752,331,82,82,3149,80,241,1788,SF,116,166,441,CHA,.524
347,Jeremy Richardson,9,.360,25,7,.368,19,2,23,0,8,16,.364,44,2,1.000,2,27,1,132,1,13,41,SF-SG,3,6,9,TOT,.443
348,Quentin Richardson,130,.381,341,69,.322,214,116,27,15,259,199,.359,555,60,.682,88,65,65,1841,56,153,527,SF,44,69,315,NYK,.421
349,Luke Ridnour,126,.424,297,21,.296,71,241,26,14,81,147,.399,368,78,.857,91,61,5,1223,13,120,393,PG,37,80,94,SEA,.428
350,Nate Robinson,234,.478,490,97,.332,292,212,23,1,171,331,.423,782,154,.786,196,72,17,1883,51,186,913,PG,60,103,222,NYK,.485
351,Sergio Rodriguez,52,.377,138,17,.293,58,123,21,0,45,69,.352,196,25,.658,38,72,0,628,13,57,180,PG,24,53,58,POR,.395
352,Rajon Rondo,346,.499,694,5,.263,19,393,21,13,244,351,.492,713,107,.611,175,77,77,2306,78,187,814,PG,129,147,322,BOS,.496
353,Malik Rose,64,.370,173,2,.286,7,28,33,7,72,66,.367,180,37,.725,51,49,3,494,31,80,171,PF,16,40,103,NYK,.372
354,Quinton Ross,122,.389,314,9,.429,21,88,26,33,118,131,.391,335,40,.667,60,76,44,1505,54,132,311,SG,43,29,172,LAC,.404
355,Brandon Roy,458,.480,955,73,.340,215,430,23,16,267,531,.454,1170,281,.753,373,74,74,2792,81,147,1416,SG,79,136,348,POR,.485
356,Michael Ruffin,33,.532,62,0,,0,24,31,19,96,33,.532,62,25,.397,63,46,2,632,90,93,91,C,31,19,186,MIL,.532
357,Kareem Rush,126,.410,307,102,.389,262,89,27,19,149,228,.401,569,30,.714,42,71,15,1504,19,108,588,SG,42,62,168,IND,.490
358,John Salmons,342,.504,679,39,.325,120,208,28,31,273,381,.477,799,214,.823,260,81,41,2517,76,171,1015,SG,93,170,349,SAC,.501
359,Cheikh Samb,3,.750,4,0,,0,0,23,2,4,3,.750,4,1,.500,2,4,0,31,3,8,7,C,1,1,7,DET,.750
360,Brian Scalabrine,14,.292,48,15,.326,46,40,29,8,57,29,.309,94,15,.750,20,48,9,512,22,63,88,PF,9,26,79,BOS,.388
361,Luis Scola,345,.517,667,0,.000,3,106,27,19,351,345,.515,670,157,.668,235,82,39,2024,174,235,847,PF,60,105,525,HOU,.515
362,Thabo Sefolosha,151,.453,333,29,.330,88,129,23,30,205,180,.428,421,75,.721,104,69,22,1436,50,128,464,SG,61,93,255,CHI,.462
363,Mouhamed Sene,11,.458,24,0,,0,1,21,7,9,11,.458,24,8,.471,17,13,0,62,7,9,30,C,0,0,16,SEA,.458
364,Ramon Sessions,48,.436,110,3,.429,7,127,21,3,50,51,.436,117,32,.780,41,17,7,450,8,26,137,PG,17,36,58,MIL,.449
365,Bobby Simmons,149,.458,325,60,.351,171,80,27,5,159,209,.421,496,53,.757,70,70,21,1521,67,140,531,SF,50,78,226,MIL,.482
366,Cedric Simmons,4,.286,14,0,,0,0,22,5,12,4,.286,14,0,.000,10,14,0,87,6,8,8,PF,2,6,18,TOT,.286
367,Courtney Sims,0,.000,1,0,,0,1,24,0,1,0,.000,1,0,,0,3,0,11,1,2,0,C,0,0,2,IND,.000
368,Brian Skinner,90,.462,195,2,.667,3,15,31,77,175,92,.465,198,33,.524,63,66,0,844,63,112,219,C,21,39,238,PHO,.470
369,Craig Smith,297,.572,519,0,.000,9,60,24,17,230,297,.563,528,133,.665,200,77,11,1547,123,217,727,PF,36,89,353,MIN,.563
370,J.R. Smith,154,.542,284,157,.403,390,128,22,12,109,311,.461,674,128,.719,178,74,0,1421,43,144,907,SG,62,112,152,DEN,.578
371,Jason Smith,137,.463,296,4,.286,14,20,21,50,153,141,.455,310,54,.659,82,76,1,1107,77,142,340,PF,22,48,230,PHI,.461
372,Joe Smith,312,.480,650,0,.000,3,66,32,47,238,312,.478,653,154,.755,204,77,36,1726,163,186,778,PF,34,71,401,TOT,.478
373,Josh Smith,493,.477,1034,25,.253,99,272,22,227,506,518,.457,1133,333,.710,469,81,81,2873,161,269,1394,PF,123,245,667,ATL,.468
374,Eric Snow,6,.167,36,0,.000,2,42,34,4,16,6,.158,38,10,.455,22,22,5,305,4,30,22,PG,10,10,20,CLE,.158
375,Kirk Snyder,91,.548,166,5,.217,23,64,24,15,96,96,.508,189,64,.727,88,36,18,761,30,55,261,SF-PF,20,52,126,TOT,.521
376,Darius Songaila,214,.460,465,0,.000,2,135,29,16,190,214,.458,467,67,.918,73,80,13,1554,81,181,495,C,53,86,271,WAS,.458
377,Jerry Stackhouse,153,.447,342,60,.326,184,145,33,10,100,213,.405,526,132,.892,148,58,13,1412,33,82,618,SG,28,86,133,DAL,.462
378,DeShawn Stevenson,143,.390,367,158,.383,413,252,26,15,198,301,.386,780,157,.797,197,82,82,2564,37,110,917,SG,65,102,235,WAS,.487
379,Peja Stojakovic,220,.438,502,231,.441,524,96,30,10,267,451,.440,1026,130,.929,140,77,77,2711,64,127,1263,SF,57,61,331,NOH,.552
380,Awvee Storey,39,.476,82,0,.000,7,16,30,1,23,39,.438,89,14,.483,29,26,0,259,31,41,92,SG,7,10,54,MIL,.438
381,Damon Stoudamire,70,.372,188,50,.336,149,165,34,2,98,120,.356,337,27,.794,34,60,33,1037,20,76,317,PG,30,80,118,TOT,.430
382,Salim Stoudamire,36,.379,95,29,.341,85,28,25,5,20,65,.361,180,41,.820,50,35,0,402,4,34,200,PG,7,21,24,ATL,.442
383,Amar'e Stoudemire,709,.601,1180,5,.161,31,118,25,163,541,714,.590,1211,556,.805,691,79,79,2677,178,294,1989,C,64,174,719,PHO,.592
384,D.J. Strawberry,23,.343,67,6,.240,25,30,22,6,19,29,.315,92,9,.474,19,33,0,270,9,36,73,SG,12,11,28,PHO,.348
385,Rodney Stuckey,150,.410,366,3,.188,16,160,21,6,97,153,.401,382,127,.814,156,57,2,1081,32,113,436,PG,49,78,129,DET,.404
386,Robert Swift,6,.353,17,0,,0,1,22,6,12,6,.353,17,2,1.000,2,8,4,98,6,16,14,C,5,10,18,SEA,.353
387,Stromile Swift,135,.513,263,0,.000,2,26,28,54,135,135,.509,265,73,.670,109,56,4,844,64,113,343,PF,15,51,199,TOT,.509
388,Wally Szczerbiak,221,.438,504,90,.413,218,104,30,12,183,311,.431,722,149,.851,175,75,2,1736,34,103,861,SF,23,76,217,TOT,.493
389,Sebastian Telfair,191,.432,442,32,.281,114,355,22,11,119,223,.401,556,78,.743,105,60,51,1933,16,171,556,PG,59,111,135,MIN,.430
390,Jason Terry,335,.519,645,136,.375,363,264,30,18,178,471,.467,1008,191,.857,223,82,34,2579,30,170,1269,SG,88,92,208,DAL,.535
391,Billy Thomas,0,.000,1,4,.250,16,0,32,0,2,4,.235,17,2,1.000,2,11,0,42,0,4,14,SF,1,4,2,TOT,.353
392,Kenny Thomas,16,.421,38,0,,0,13,30,1,43,16,.421,38,0,.000,5,23,3,281,18,38,32,PF,6,21,61,SAC,.421
393,Kurt Thomas,195,.494,395,0,.000,1,67,35,57,377,195,.492,396,53,.663,80,70,48,1584,130,188,443,C-PF,56,46,507,TOT,.492
394,Tim Thomas,208,.479,434,83,.306,271,171,30,29,261,291,.413,705,115,.752,153,63,51,1940,62,192,780,PF,40,98,323,LAC,.472
395,Tyrus Thomas,185,.426,434,1,.167,6,90,21,72,240,186,.423,440,129,.741,174,74,27,1330,102,170,502,PF,48,77,342,CHI,.424
396,Al Thornton,331,.447,741,43,.331,130,98,24,43,260,374,.429,871,214,.743,288,79,31,2158,98,195,1005,PF,46,128,358,LAC,.454
397,Jamaal Tinsley,136,.422,322,40,.284,141,326,29,10,117,176,.380,463,72,.720,100,39,36,1293,24,97,464,PG,66,130,141,IND,.423
398,Alando Tucker,7,.389,18,1,.250,4,0,23,1,4,8,.364,22,5,.833,6,6,0,48,4,2,22,SF,0,0,8,PHO,.386
399,Ronny Turiaf,188,.475,396,0,.000,1,128,25,108,211,188,.474,397,140,.753,186,78,21,1458,95,199,516,C,28,72,306,LAL,.474
400,Hedo Turkoglu,390,.485,804,166,.400,415,409,28,25,388,556,.456,1219,324,.829,391,82,82,3026,83,244,1602,SF,74,246,471,ORL,.524
401,Ime Udoka,98,.467,210,61,.370,165,63,30,17,192,159,.424,375,44,.759,58,73,0,1316,36,127,423,PF,56,58,228,SAS,.505
402,Beno Udrih,275,.482,571,53,.387,137,282,25,10,183,328,.463,708,125,.850,147,65,51,2080,34,138,834,PG,56,148,217,SAC,.501
403,Anderson Varejao,136,.464,293,0,.000,2,53,25,26,265,136,.461,295,49,.598,82,48,13,1320,134,134,321,C,37,59,399,CLE,.461
404,Jacque Vaughn,118,.432,273,3,.300,10,159,32,1,61,121,.428,283,61,.763,80,74,9,1139,13,97,306,PG,23,54,74,SAS,.433
405,Charlie Villanueva,299,.475,629,55,.297,185,78,23,35,321,354,.435,814,123,.783,157,76,31,1829,145,174,886,PF,30,107,466,MIL,.469
406,Marcus Vinicius,4,.500,8,5,.417,12,2,23,1,7,9,.450,20,5,.455,11,13,0,69,1,4,28,SF,1,3,8,NOH,.575
407,Jake Voskuhl,37,.463,80,0,,0,13,30,21,67,37,.463,80,24,.828,29,44,0,386,30,83,98,C,9,29,97,MIL,.463
408,Sasha Vujacic,101,.476,212,118,.437,270,72,23,5,135,219,.454,482,76,.835,91,72,0,1279,19,107,632,SG,36,52,154,LAL,.577
409,Dwyane Wade,417,.485,860,22,.286,77,354,26,37,169,439,.469,937,354,.758,467,51,49,1954,45,137,1254,SG,87,224,214,MIA,.480
410,Von Wafer,13,.371,35,4,.154,26,7,22,3,18,17,.279,61,8,.667,12,29,0,154,1,7,46,SG,2,13,19,TOT,.311
411,Antoine Walker,75,.401,187,61,.324,188,45,31,8,112,136,.363,375,35,.530,66,46,1,892,56,80,368,PF,33,46,168,MIN,.444
412,Ben Wallace,138,.397,348,0,.000,4,105,33,117,370,138,.392,352,72,.426,169,72,72,2205,234,121,348,C-PF,88,67,604,TOT,.392
413,Gerald Wallace,337,.491,687,71,.321,221,216,25,58,315,408,.449,908,313,.731,428,62,59,2376,58,189,1200,PF,131,180,373,CHA,.488
414,Rasheed Wallace,264,.476,555,112,.356,315,137,33,129,427,376,.432,870,115,.767,150,77,76,2346,84,213,979,C,91,86,511,DET,.497
415,Luke Walton,187,.475,394,28,.333,84,218,27,18,206,215,.450,478,77,.706,109,74,31,1729,85,133,535,SF,60,100,291,LAL,.479
416,Hakim Warrick,315,.521,605,13,.271,48,53,25,28,233,328,.502,653,183,.704,260,75,30,1754,123,156,852,PF,36,85,356,MEM,.512
417,Darius Washington,17,.472,36,4,.333,12,15,22,0,16,21,.438,48,7,.538,13,18,0,146,4,16,53,SG,5,14,20,SAS,.479
418,Darryl Watkins,5,.333,15,0,,0,0,23,2,7,5,.333,15,2,.400,5,9,0,71,5,8,12,C,2,7,12,SAC,.333
419,C.J. Watson,34,.453,75,9,.346,26,35,23,0,19,43,.426,101,23,.793,29,32,0,368,13,19,118,PG,15,18,32,GSW,.470
420,Earl Watson,290,.472,615,49,.371,132,531,28,11,182,339,.454,747,111,.766,145,78,73,2269,43,158,838,PG,69,175,225,SEA,.487
421,Chris Webber,15,.484,31,0,,0,18,34,6,30,15,.484,31,5,.417,12,9,8,126,2,17,35,PF,4,11,32,GSW,.484
422,Martell Webster,154,.454,339,123,.388,317,90,21,28,242,277,.422,656,122,.735,166,75,70,2132,54,159,799,SF,42,83,296,POR,.516
423,Bonzi Wells,240,.462,519,12,.240,50,97,31,32,247,252,.443,569,146,.643,227,73,7,1562,84,157,662,SG,75,103,331,TOT,.453
424,David West,623,.487,1280,6,.240,25,177,27,99,495,629,.482,1305,300,.850,353,76,76,2870,180,208,1564,PF,62,165,675,NOH,.484
425,Delonte West,148,.435,340,48,.356,135,229,24,29,162,196,.413,475,67,.736,91,61,31,1533,31,103,507,PG,59,117,193,TOT,.463
426,Mario West,21,.467,45,0,.000,4,13,23,4,22,21,.429,49,17,.654,26,64,2,269,26,61,59,SG,12,9,48,ATL,.429
427,Chris Wilcox,334,.526,635,0,.000,3,74,25,36,307,334,.524,638,160,.645,248,62,55,1739,126,174,828,PF,46,103,433,SEA,.524
428,Damien Wilkins,221,.427,518,50,.323,155,150,28,19,173,271,.403,673,106,.736,144,76,31,1843,72,128,698,SF,62,89,245,SEA,.440
429,Mike Wilks,14,.500,28,3,.375,8,14,28,0,14,17,.472,36,4,1.000,4,15,0,188,5,13,41,PG,9,9,19,TOT,.514
430,Aaron Williams,27,.491,55,0,,0,9,36,15,46,27,.491,55,14,.778,18,30,5,297,15,44,68,C,12,13,61,LAC,.491
431,Deron Williams,483,.533,907,83,.395,210,862,23,23,209,566,.507,1117,330,.803,411,82,82,3059,34,200,1545,PG,90,279,243,UTA,.544
432,Jason Williams,114,.415,275,97,.353,275,307,32,5,118,211,.384,550,69,.863,80,67,53,1886,12,93,588,PG,83,91,130,MIA,.472
433,Justin Williams,13,.448,29,0,,0,0,23,5,29,13,.448,29,8,.308,26,23,0,123,20,17,34,C,5,4,49,TOT,.448
434,Lou Williams,264,.441,599,55,.359,153,253,21,13,126,319,.424,752,227,.783,290,80,0,1862,41,130,920,PG,81,125,167,PHI,.461
435,Marcus Williams,57,.377,151,54,.380,142,140,22,3,87,111,.379,293,37,.787,47,53,7,854,14,52,313,PG,25,75,101,NJN,.471
436,Marcus Williams,5,.250,20,0,,0,3,21,1,8,5,.250,20,0,,0,11,0,36,4,3,10,PF-SF,1,0,12,TOT,.250
437,Marvin Williams,423,.466,908,1,.100,10,137,21,33,338,424,.462,918,336,.822,409,80,80,2765,119,225,1185,SF,81,127,457,ATL,.462
438,Mo Williams,352,.512,688,89,.385,231,419,25,10,193,441,.480,919,166,.856,194,66,66,2410,37,188,1137,PG,78,182,230,MIL,.528
439,Sean Williams,164,.538,305,0,,0,28,21,106,207,164,.538,305,81,.609,133,73,29,1278,115,193,409,C,28,70,322,NJN,.538
440,Shawne Williams,116,.494,235,43,.314,137,59,21,26,122,159,.427,372,76,.717,106,65,3,967,54,132,437,SF,26,58,176,IND,.485
441,Shelden Williams,92,.438,210,0,.000,2,19,24,21,137,92,.434,212,71,.676,105,64,0,776,68,110,255,PF,22,35,205,TOT,.434
442,Loren Woods,3,.600,5,0,,0,2,29,0,1,3,.600,5,0,,0,7,0,17,0,2,6,C,0,0,1,HOU,.600
443,Metta World Peace,352,.475,741,84,.380,221,199,28,38,227,436,.453,962,212,.719,295,57,54,2172,101,159,1168,SF,133,148,328,SAC,.497
444,Antoine Wright,104,.475,219,32,.291,110,80,23,21,107,136,.413,329,46,.687,67,56,10,1232,40,127,350,SG,28,50,147,TOT,.462
445,Brandan Wright,62,.554,112,0,,0,9,20,22,61,62,.554,112,27,.675,40,38,6,376,38,36,151,PF,6,13,99,GSW,.554
446,Dorell Wright,139,.493,282,4,.364,11,60,22,41,172,143,.488,293,57,.826,69,44,34,1104,48,79,347,SF,29,29,220,MIA,.495
447,Julian Wright,80,.552,145,10,.417,24,40,20,12,84,90,.533,169,33,.635,52,57,1,640,33,43,223,SF,29,34,117,NOH,.562
448,Lorenzen Wright,6,.286,21,0,,0,4,32,3,30,6,.286,21,3,.500,6,18,1,161,8,31,15,C,3,4,38,TOT,.286
449,Nick Young,170,.450,378,40,.400,100,63,22,7,92,210,.439,478,101,.815,124,75,2,1158,23,130,561,SG,35,94,115,WAS,.481
450,Thaddeus Young,258,.548,471,6,.316,19,58,19,8,192,264,.539,490,76,.738,103,74,22,1554,120,126,610,PF,73,64,312,PHI,.545
