,Player_Name,2P,2P%,2PA,3P,3P%,3PA,AST,Age,BLK,DRB,FG,FG%,FGA,FT,FT%,FTA,Games,Games_Strated,Minutes_Played,ORB,PF,PTS,Position,STL,TOV,TRB,Team,eFG%
0,Alex Acker,23,.411,56,7,.350,20,12,26,4,16,30,.395,76,5,.500,10,25,0,199,8,9,72,SG,5,7,24,TOT,.441
1,Hassan Adams,4,.308,13,0,,0,1,24,1,6,4,.308,13,3,.500,6,12,0,52,1,4,11,SG,1,4,7,TOR,.308
2,Arron Afflalo,88,.456,193,43,.402,107,44,23,13,104,131,.437,300,58,.817,71,74,8,1234,30,144,363,SG,28,43,134,DET,.508
3,Maurice Ager,15,.405,37,0,.000,6,3,24,2,7,15,.349,43,4,.500,8,20,0,97,3,17,34,SG,1,4,10,NJN,.349
4,Blake Ahearn,0,.000,2,2,.500,4,2,24,0,1,2,.333,6,2,1.000,2,3,0,19,0,3,8,PG,1,1,1,SAS,.500
5,Alexis Ajinca,25,.373,67,0,.000,2,3,20,6,21,25,.362,69,20,.714,28,31,4,182,9,34,70,PF,7,12,30,CHA,.362
6,LaMarcus Aldridge,594,.489,1215,7,.250,28,157,23,77,371,601,.484,1243,261,.781,334,81,81,3004,234,207,1470,PF,77,121,605,POR,.486
7,Joe Alexander,86,.432,199,16,.348,46,42,22,29,71,102,.416,245,58,.699,83,59,0,716,44,107,278,SF,15,52,115,MIL,.449
8,Malik Allen,73,.432,169,0,.000,1,35,30,12,68,73,.429,170,10,.476,21,49,3,579,35,89,156,PF,7,20,103,MIL,.429
9,Ray Allen,300,.542,554,199,.409,486,218,33,13,212,499,.480,1040,237,.952,249,79,79,2876,66,157,1434,SG,69,134,278,BOS,.575
10,Tony Allen,131,.510,257,6,.222,27,66,27,23,82,137,.482,284,79,.725,109,46,2,887,22,98,359,SG,54,77,104,BOS,.493
11,Morris Almond,28,.438,64,5,.294,17,7,23,4,27,33,.407,81,21,.808,26,25,1,255,9,31,92,SG,4,16,36,UTA,.438
12,Rafer Alston,204,.417,489,112,.338,331,406,32,10,194,316,.385,820,156,.750,208,77,76,2447,33,135,900,PG,108,140,227,TOT,.454
13,Lou Amundson,134,.538,249,0,.000,1,28,26,65,142,134,.536,250,53,.442,120,76,0,1044,128,154,321,PF,32,56,270,PHO,.536
14,Chris Andersen,158,.560,282,2,.200,10,31,30,175,279,160,.548,292,130,.718,181,71,1,1460,163,174,452,C,41,69,442,DEN,.551
15,Ryan Anderson,91,.417,218,69,.365,189,52,20,20,207,160,.393,407,98,.845,116,66,30,1312,104,157,487,PF,44,63,311,NJN,.478
16,Carmelo Anthony,472,.455,1037,63,.371,170,222,24,24,344,535,.443,1207,371,.793,468,66,66,2277,106,195,1504,SF,75,199,450,DEN,.469
17,Joel Anthony,57,.483,118,0,,0,27,26,93,108,57,.483,118,30,.652,46,65,28,1048,89,139,144,C,20,41,197,MIA,.483
18,Gilbert Arenas,4,.250,16,2,.286,7,20,27,1,8,6,.261,23,12,.750,16,2,2,63,1,4,26,PG,0,1,9,WAS,.304
19,Trevor Ariza,213,.526,405,61,.319,191,145,23,24,241,274,.460,596,120,.710,169,82,20,1999,111,166,729,SF,137,87,352,LAL,.511
20,Hilton Armstrong,138,.566,244,0,.000,2,29,24,45,114,138,.561,246,62,.633,98,70,29,1092,81,181,338,C,26,80,195,NOH,.561
21,Darrell Arthur,191,.440,434,0,.000,2,43,20,52,238,191,.438,436,40,.667,60,76,64,1464,108,206,422,PF,52,47,346,MEM,.438
22,Chucky Atkins,19,.339,56,15,.263,57,59,34,2,19,34,.301,113,15,.938,16,33,0,412,5,27,98,PG,10,23,24,TOT,.367
23,D.J. Augustin,159,.424,375,108,.439,246,250,21,2,116,267,.430,621,208,.893,233,72,12,1908,17,140,850,PG,42,119,133,CHA,.517
24,Kelenna Azubuike,298,.469,635,94,.448,210,117,25,50,258,392,.464,845,185,.808,229,74,51,2375,112,183,1063,SF,57,95,370,GSW,.520
25,Renaldo Balkman,108,.568,190,2,.286,7,34,24,23,117,110,.558,197,42,.646,65,53,10,780,86,98,264,PF,47,35,203,DEN,.563
26,Marcus Banks,18,.474,38,3,.158,19,28,27,2,17,21,.368,57,11,.611,18,22,0,206,1,26,56,PG,11,14,18,TOT,.395
27,Leandro Barbosa,276,.532,519,90,.375,240,162,26,7,147,366,.482,759,171,.881,194,70,11,1705,34,115,993,SG,82,93,181,PHO,.542
28,J.J. Barea,191,.474,403,55,.357,154,269,24,5,141,246,.442,557,70,.753,93,79,15,1600,36,121,617,SG,37,105,177,DAL,.491
29,Andrea Bargnani,312,.468,667,119,.409,291,94,23,97,346,431,.450,958,221,.831,266,78,59,2453,70,242,1202,PF,34,135,416,TOR,.512
30,Matt Barnes,168,.505,333,117,.343,341,212,28,26,342,285,.423,674,101,.743,136,77,40,2082,79,209,788,PF,52,130,421,PHO,.510
31,Brent Barry,21,.512,41,49,.374,131,78,37,3,77,70,.407,172,19,.950,20,56,1,857,17,45,208,SG,24,48,94,HOU,.549
32,Brandon Bass,252,.502,502,0,.000,6,43,23,55,238,252,.496,508,182,.867,210,81,0,1574,129,140,686,C,27,86,367,DAL,.496
33,Maceo Baston,25,.556,45,0,.000,1,7,33,10,30,25,.543,46,17,.630,27,27,0,217,22,39,67,PF,6,12,52,IND,.543
34,Tony Battie,156,.497,314,2,.222,9,31,32,25,186,158,.489,323,54,.659,82,77,3,1202,92,112,372,PF,26,46,278,ORL,.492
35,Shane Battier,54,.462,117,91,.384,237,137,30,54,233,145,.410,354,55,.821,67,60,59,2031,52,114,436,SG,48,49,285,HOU,.538
36,Nicolas Batum,99,.513,193,62,.369,168,74,20,40,136,161,.446,361,42,.808,52,79,76,1454,84,139,426,SF,50,50,220,POR,.532
37,Jerryd Bayless,62,.383,162,7,.259,27,78,20,2,49,69,.365,189,83,.806,103,53,0,655,8,81,228,PG,16,56,57,POR,.384
38,Michael Beasley,419,.478,876,33,.407,81,83,20,37,329,452,.472,957,186,.772,241,81,19,2009,110,184,1123,PF,41,121,439,MIA,.490
39,Marco Belinelli,88,.473,186,52,.397,131,88,22,1,61,140,.442,317,40,.769,52,42,23,882,10,73,372,SG,36,59,71,GSW,.524
40,Charlie Bell,130,.458,284,87,.363,240,151,29,7,102,217,.414,524,66,.825,80,70,23,1783,32,138,587,SG,50,76,134,MIL,.497
41,Raja Bell,185,.448,413,114,.421,271,142,32,8,202,299,.437,684,87,.853,102,67,66,2315,41,166,799,SG,50,86,243,TOT,.520
42,Mike Bibby,270,.468,577,167,.390,428,392,30,11,240,437,.435,1005,135,.789,171,79,79,2740,38,145,1176,PG,98,128,278,ATL,.518
43,Andris Biedrins,308,.579,532,0,.000,1,121,22,96,470,308,.578,533,119,.551,216,62,58,1863,223,236,735,C,63,110,693,GSW,.578
44,Chauncey Billups,248,.425,583,162,.408,397,506,32,18,207,410,.418,980,418,.913,458,79,79,2789,32,161,1400,PG,93,177,239,TOT,.501
45,Steve Blake,137,.429,319,140,.427,328,348,28,4,145,277,.428,647,63,.840,75,69,69,2188,28,126,757,PG,69,108,173,POR,.536
46,Andray Blatche,292,.479,609,5,.238,21,118,22,74,252,297,.471,630,114,.704,162,71,36,1703,126,211,713,C,53,117,378,WAS,.475
47,Mark Blount,19,.373,51,11,.407,27,4,33,7,31,30,.385,78,8,.615,13,20,0,207,10,17,79,C,1,14,41,MIA,.455
48,Keith Bogans,45,.425,106,74,.339,218,64,28,4,171,119,.367,324,52,.912,57,65,15,1272,31,105,364,SG,43,41,202,TOT,.481
49,Andrew Bogut,183,.577,317,0,,0,72,24,37,252,183,.577,317,56,.571,98,36,33,1124,117,130,422,C,23,86,369,MIL,.577
50,Matt Bonner,148,.552,268,118,.440,268,82,28,26,289,266,.496,536,17,.739,23,81,67,1928,97,190,667,PF,47,37,386,SAS,.606
51,Josh Boone,113,.528,214,0,,0,31,24,48,154,113,.528,214,32,.376,85,62,7,995,104,106,258,C,22,31,258,NJN,.528
52,Calvin Booth,5,.500,10,0,,0,0,32,2,6,5,.500,10,6,.750,8,8,0,56,5,10,16,C,1,1,11,TOT,.500
53,Carlos Boozer,251,.490,512,0,,0,79,27,7,274,251,.490,512,97,.698,139,37,37,1197,111,132,599,PF,39,79,385,UTA,.490
54,Chris Bosh,603,.497,1214,12,.245,49,191,24,77,556,615,.487,1263,504,.817,617,77,77,2928,215,189,1746,C,67,174,771,TOR,.492
55,Bruce Bowen,37,.416,89,42,.429,98,40,37,13,129,79,.422,187,14,.538,26,80,10,1506,16,123,214,SF,36,25,145,SAS,.535
56,Ryan Bowen,22,.579,38,0,,0,9,33,5,14,22,.579,38,3,.600,5,21,3,219,10,37,47,SF,14,5,24,NOH,.579
57,Elton Brand,163,.447,365,0,,0,37,29,45,177,163,.447,365,73,.676,108,29,23,920,77,78,399,PF,17,68,254,PHI,.447
58,Corey Brewer,32,.410,78,5,.417,12,25,22,3,31,37,.411,90,14,.737,19,15,8,307,18,37,93,SF,15,13,49,MIN,.439
59,Ronnie Brewer,399,.537,743,22,.259,85,179,23,30,199,421,.508,828,247,.702,352,81,80,2605,101,128,1111,SF,138,110,300,UTA,.522
60,Aaron Brooks,203,.428,474,113,.366,309,238,24,8,124,316,.404,783,149,.866,172,80,35,1998,33,152,894,PG,46,125,157,HOU,.476
61,Andre Brown,1,.143,7,0,,0,1,27,0,5,1,.143,7,2,1.000,2,4,0,41,7,9,4,PF,1,5,12,CHA,.143
62,Bobby Brown,96,.417,230,45,.346,130,117,24,3,38,141,.392,360,34,.791,43,68,2,931,14,95,361,SG-PG,21,63,52,TOT,.454
63,Dee Brown,11,.440,25,7,.292,24,36,24,0,22,18,.367,49,3,.600,5,19,11,261,7,28,46,PG,10,17,29,TOT,.439
64,Devin Brown,83,.384,216,28,.289,97,54,30,5,88,111,.355,313,78,.780,100,63,5,869,31,81,328,SG,32,54,119,NOH,.399
65,Kwame Brown,90,.533,169,0,,0,32,26,24,199,90,.533,169,63,.516,122,58,30,999,91,138,243,C,24,50,290,DET,.533
66,Shannon Brown,64,.500,128,14,.378,37,38,23,7,33,78,.473,165,32,.821,39,48,0,477,11,42,202,SG,22,38,44,TOT,.515
67,Kobe Bryant,682,.496,1376,118,.351,336,399,30,37,339,800,.467,1712,483,.856,564,82,82,2960,90,189,2201,SG,120,210,429,LAL,.502
68,Greg Buckner,48,.444,108,13,.255,51,57,32,8,98,61,.384,159,20,.800,25,63,0,878,32,108,155,SF,29,38,130,MEM,.425
69,Caron Butler,426,.487,875,65,.310,210,290,28,20,296,491,.453,1085,345,.858,402,67,67,2585,118,165,1392,SG,106,210,414,WAS,.482
70,Rasual Butler,208,.468,444,140,.390,359,75,29,61,222,348,.433,803,86,.782,110,82,74,2614,49,159,922,SF,51,59,271,NOH,.521
71,Andrew Bynum,281,.560,502,0,,0,71,21,90,261,281,.560,502,152,.707,215,50,50,1446,137,157,714,C,18,85,398,LAL,.560
72,Will Bynum,153,.474,323,3,.158,19,157,26,2,56,156,.456,342,95,.798,119,57,1,803,19,85,410,PG,34,76,75,DET,.461
73,Jose Calderon,238,.538,442,82,.406,202,607,27,7,178,320,.497,644,151,.981,154,68,68,2333,16,114,873,PG,74,143,194,TOR,.561
74,Marcus Camby,253,.514,492,1,.250,4,127,34,132,529,254,.512,496,132,.725,182,62,55,1925,161,129,641,C,51,93,690,LAC,.513
75,Brian Cardinal,35,.455,77,30,.326,92,76,31,13,103,65,.385,169,30,.857,35,64,4,909,39,135,190,PF,37,48,142,MIN,.473
76,Rodney Carney,97,.492,197,79,.350,226,26,24,29,90,176,.416,423,50,.758,66,67,6,1199,36,94,481,SG,45,43,126,MIN,.509
77,Matt Carroll,52,.441,118,13,.245,53,27,28,6,62,65,.380,171,21,.840,25,55,10,616,7,67,164,SG,21,33,69,TOT,.418
78,Anthony Carter,146,.490,298,21,.239,88,364,33,13,165,167,.433,386,57,.731,78,78,5,1787,40,142,412,PG,96,155,205,DEN,.460
79,Vince Carter,437,.459,953,151,.385,392,376,32,38,336,588,.437,1345,335,.817,410,80,80,2946,74,234,1662,SG,82,166,410,NJN,.493
80,Mario Chalmers,164,.467,351,114,.367,311,403,22,8,191,278,.420,662,148,.767,193,82,82,2626,37,240,818,PG,160,165,228,MIA,.506
81,Tyson Chandler,160,.565,283,0,,0,22,26,56,230,160,.565,283,77,.579,133,45,45,1445,163,144,397,C,15,70,393,NOH,.565
82,Wilson Chandler,352,.476,740,103,.328,314,170,21,75,354,455,.432,1054,171,.795,215,82,70,2735,91,250,1184,SF,71,139,445,NYK,.481
83,Speedy Claxton,2,.286,7,0,,0,3,30,0,0,2,.286,7,1,.500,2,2,0,15,0,1,5,PG,0,0,0,ATL,.286
84,Jarron Collins,16,.457,35,0,,0,7,30,1,17,16,.457,35,8,.727,11,26,3,201,20,35,40,C,2,9,37,UTA,.457
85,Jason Collins,22,.314,70,0,,0,11,30,13,42,22,.314,70,13,.464,28,31,22,422,28,73,57,C,9,12,70,MIN,.314
86,Mardy Collins,92,.426,216,13,.419,31,111,24,10,76,105,.425,247,28,.609,46,48,14,890,31,80,251,PG-SG,31,58,107,TOT,.451
87,Nick Collison,243,.570,426,0,.000,2,66,28,50,308,243,.568,428,98,.721,136,71,40,1831,181,239,584,C,51,73,489,OKC,.568
88,Mike Conley,235,.458,513,88,.406,217,354,21,8,251,323,.442,730,161,.817,197,82,61,2508,25,146,895,PG,90,143,276,MEM,.503
89,Brian Cook,15,.326,46,13,.433,30,5,28,3,25,28,.368,76,5,.833,6,30,0,171,7,26,74,PF,3,13,32,TOT,.454
90,Daequan Cook,89,.356,250,153,.387,395,71,21,10,170,242,.375,645,49,.875,56,75,4,1833,19,125,686,SF,39,42,189,MIA,.494
91,Jamal Crawford,277,.441,628,142,.360,394,288,28,13,170,419,.410,1022,300,.872,344,65,65,2479,23,92,1280,PG-SG,57,148,193,TOT,.479
92,Joe Crawford,2,.333,6,1,.250,4,1,22,0,3,3,.300,10,2,1.000,2,2,0,23,1,2,9,SF,1,0,4,NYK,.350
93,Javaris Crittenton,129,.478,270,2,.133,15,150,21,6,109,131,.460,285,53,.576,92,63,10,1174,57,101,317,PG-SG,40,82,166,TOT,.463
94,Austin Croshere,9,.375,24,5,.333,15,9,33,1,23,14,.359,39,7,.583,12,14,0,100,11,5,40,PF,1,6,34,TOT,.423
95,Eddy Curry,2,1.000,2,0,,0,0,26,0,4,2,1.000,2,1,.333,3,3,0,12,0,5,5,C,0,2,4,NYK,1.000
96,Samuel Dalembert,216,.500,432,0,.000,2,18,27,146,487,216,.498,434,91,.734,124,82,82,2036,214,248,523,C,33,117,701,PHI,.498
97,Erick Dampier,182,.650,280,0,,0,77,33,95,349,182,.650,280,90,.638,141,80,80,1836,216,191,454,C,24,74,565,DAL,.650
98,Antonio Daniels,77,.438,176,22,.367,60,177,33,1,72,99,.419,236,80,.800,100,74,9,1021,5,55,300,PG,26,62,77,TOT,.466
99,Marquis Daniels,293,.489,599,18,.200,90,114,28,26,168,311,.451,689,93,.721,129,54,43,1700,80,120,733,SF,62,94,248,IND,.464
100,Jermareo Davidson,17,.486,35,0,,0,1,24,3,24,17,.486,35,8,.471,17,14,0,111,10,12,42,SF,2,5,34,GSW,.486
101,Baron Davis,256,.406,631,99,.302,328,501,29,35,192,355,.370,959,159,.757,210,65,60,2248,46,193,968,PG,108,193,238,LAC,.422
102,Glen Davis,197,.443,445,2,.400,5,69,23,19,180,199,.442,450,130,.730,178,76,16,1637,121,230,530,C,53,71,301,BOS,.444
103,Paul Davis,40,.412,97,0,.000,1,12,24,3,39,40,.408,98,27,.794,34,27,1,320,28,44,107,PF,10,13,67,LAC,.408
104,Ricky Davis,48,.358,134,35,.315,111,82,29,5,51,83,.339,245,31,.861,36,36,9,785,9,63,232,SG,19,39,60,LAC,.410
105,Luol Deng,257,.450,571,8,.400,20,94,23,25,215,265,.448,591,152,.796,191,49,46,1665,80,85,690,SF,60,72,295,CHI,.455
106,Boris Diaw,373,.531,703,75,.414,181,333,26,53,314,448,.507,884,101,.687,147,81,59,2754,118,202,1072,PF,61,215,432,TOT,.549
107,Yakhouba Diawara,25,.463,54,51,.313,163,27,26,6,56,76,.350,217,10,.526,19,63,21,851,26,75,213,SF,13,16,82,MIA,.468
108,Travis Diener,28,.459,61,46,.390,118,122,26,5,80,74,.413,179,12,.800,15,55,0,719,6,42,206,PG,26,21,86,IND,.542
109,Ike Diogu,38,.528,72,1,.500,2,3,25,3,30,39,.527,74,40,.755,53,29,1,215,26,23,119,PF,3,12,56,TOT,.534
110,DeSagana Diop,74,.433,171,0,,0,32,27,56,159,74,.433,171,22,.333,66,75,1,1036,114,128,170,C,29,39,273,TOT,.433
111,Juan Dixon,76,.420,181,25,.333,75,118,30,6,59,101,.395,256,34,.872,39,50,6,816,8,74,261,PG,35,70,67,WAS,.443
112,Keyon Dooling,162,.446,363,99,.421,235,270,28,8,131,261,.436,598,127,.825,154,77,18,2074,24,135,748,PG,71,105,155,NJN,.519
113,Joey Dorsey,1,.500,2,0,,0,1,25,0,1,1,.500,2,0,,0,3,0,6,0,0,2,PF,0,0,1,HOU,.500
114,Quincy Douby,28,.438,64,14,.304,46,25,24,5,26,42,.382,110,17,.895,19,27,0,300,6,27,115,PG,5,13,32,TOT,.445
115,Chris Douglas-Roberts,78,.476,164,3,.250,12,52,22,7,36,81,.460,176,51,.823,62,44,3,585,14,34,216,SG,12,31,50,NJN,.469
116,Goran Dragic,68,.400,170,20,.370,54,111,22,3,70,88,.393,224,50,.769,65,55,1,728,33,87,246,PG,29,73,103,PHO,.438
117,Jared Dudley,107,.507,211,29,.392,74,56,23,8,123,136,.477,285,71,.676,105,68,7,1155,82,105,372,SF,57,43,205,TOT,.528
118,Chris Duhon,160,.449,356,127,.391,325,566,26,7,201,287,.421,681,179,.856,209,79,78,2906,45,126,880,PG,72,221,246,NYK,.515
119,Tim Duncan,558,.505,1105,0,.000,2,264,32,126,599,558,.504,1107,334,.692,483,75,75,2524,201,173,1450,C,38,165,800,SAS,.504
120,Mike Dunleavy,61,.430,142,32,.356,90,44,28,9,54,93,.401,232,53,.815,65,18,14,495,14,36,271,SG,12,38,68,IND,.470
121,Kevin Durant,564,.486,1160,97,.422,230,205,20,53,405,661,.476,1390,452,.863,524,74,74,2885,77,134,1871,SF,96,225,482,OKC,.510
122,Monta Ellis,186,.460,404,8,.308,26,93,23,8,94,194,.451,430,78,.830,94,25,25,892,14,67,474,SG,39,67,108,GSW,.460
123,Francisco Elson,82,.497,165,1,.250,4,32,32,36,129,83,.491,169,33,.846,39,59,23,977,100,144,200,C,36,48,229,MIL,.494
124,Melvin Ely,37,.389,95,0,,0,18,30,9,34,37,.389,95,23,.639,36,31,4,373,30,58,97,C,2,23,64,NOH,.389
125,Maurice Evans,110,.470,234,98,.395,248,54,30,10,155,208,.432,482,60,.822,73,80,25,1840,88,163,574,SF,50,43,243,ATL,.533
126,Reggie Evans,79,.446,177,0,.000,1,26,28,8,226,79,.444,178,104,.594,175,79,7,1137,135,161,262,PF,41,69,361,PHI,.444
127,Jordan Farmar,112,.421,266,49,.336,146,155,22,10,95,161,.391,412,45,.584,77,65,0,1192,22,105,416,PG,57,87,117,LAL,.450
128,Desmon Farmer,1,.500,2,3,.250,12,2,27,0,6,4,.286,14,2,1.000,2,3,0,54,0,6,13,SG,0,4,6,SAS,.393
129,Raymond Felton,383,.437,876,59,.285,207,553,24,30,256,442,.408,1083,219,.805,272,82,81,3086,54,191,1162,PG,126,228,310,CHA,.435
130,Rudy Fernandez,109,.470,232,159,.399,398,159,23,12,160,268,.425,630,120,.839,143,78,4,1993,47,111,815,SG,69,86,207,POR,.552
131,Kyrylo Fesenko,21,.583,36,0,,0,4,22,15,23,21,.583,36,7,.333,21,21,1,156,14,35,49,C,7,9,37,UTA,.583
132,Michael Finley,170,.459,370,131,.411,319,114,35,17,244,301,.437,689,51,.823,62,81,77,2336,26,82,784,SF,37,61,270,SAS,.532
133,Derek Fisher,172,.446,386,120,.397,302,261,34,6,163,292,.424,688,110,.846,130,82,82,2441,25,187,814,PG,95,72,188,LAL,.512
134,T.J. Ford,378,.467,809,35,.337,104,392,25,16,200,413,.452,913,245,.872,281,74,49,2258,59,180,1106,PG,89,180,259,IND,.472
135,Jeff Foster,175,.506,346,2,.286,7,130,32,49,293,177,.501,353,96,.658,146,74,26,1828,215,229,452,C,53,88,508,IND,.504
136,Randy Foye,288,.428,673,111,.360,308,303,25,26,180,399,.407,981,230,.846,272,70,61,2494,34,201,1139,SG,72,150,214,MIN,.463
137,Adonal Foyle,7,.636,11,0,,0,1,33,8,17,7,.636,11,3,.500,6,10,0,62,9,5,17,C,0,3,26,TOT,.636
138,Channing Frye,102,.436,234,11,.333,33,24,25,16,99,113,.423,267,26,.722,36,63,1,746,41,106,263,PF,17,29,140,POR,.444
139,Dan Gadzuric,117,.483,242,0,.000,2,39,30,43,160,117,.480,244,37,.544,68,67,26,941,95,162,271,C,32,41,255,MIL,.480
140,Danilo Gallinari,24,.453,53,32,.444,72,15,20,4,42,56,.448,125,26,.963,27,28,2,412,13,48,170,SG,14,15,55,NYK,.576
141,Francisco Garcia,207,.466,444,88,.398,221,150,27,67,162,295,.444,665,146,.820,178,65,36,1975,56,196,824,SF,80,112,218,SAC,.510
142,Thomas Gardner,5,.385,13,4,.174,23,2,23,1,7,9,.250,36,2,.500,4,16,0,98,0,4,24,SG,4,3,7,ATL,.306
143,Kevin Garnett,391,.534,732,2,.250,8,144,32,68,407,393,.531,740,111,.841,132,57,57,1772,78,128,899,PF,63,90,485,BOS,.532
144,Marc Gasol,350,.530,660,0,.000,1,143,24,90,404,350,.530,661,275,.733,375,82,75,2521,201,265,975,C,63,164,605,MEM,.530
145,Pau Gasol,591,.567,1043,1,.500,2,284,28,81,518,592,.567,1045,343,.781,439,81,81,2999,262,172,1528,C,52,157,780,LAL,.567
146,Rudy Gay,487,.477,1020,85,.351,242,135,22,59,328,572,.453,1262,264,.767,344,79,78,2945,109,221,1493,SF,98,203,437,MEM,.487
147,Devean George,32,.485,66,22,.289,76,15,31,11,53,54,.380,142,17,.773,22,43,17,708,25,57,147,SF,23,17,78,DAL,.458
148,Daniel Gibson,98,.402,244,108,.382,283,132,22,16,124,206,.391,527,66,.767,86,75,0,1795,31,163,586,PG,44,61,155,CLE,.493
149,J.R. Giddens,2,.667,3,0,,0,0,23,0,1,2,.667,3,0,,0,6,0,8,2,1,4,SF,1,1,3,BOS,.667
150,Eddie Gill,4,.667,6,2,.667,3,11,30,1,4,6,.667,9,0,,0,6,0,43,0,10,14,PG,3,5,4,MIL,.778
151,Manu Ginobili,154,.546,282,69,.330,209,157,31,16,174,223,.454,491,168,.884,190,44,7,1181,24,90,683,SG,64,88,198,SAS,.524
152,Ryan Gomes,314,.456,689,106,.372,285,135,26,22,286,420,.431,974,146,.807,181,82,76,2614,106,183,1092,SF,63,128,392,MIN,.486
153,Drew Gooden,237,.472,502,0,.000,4,48,27,18,249,237,.468,506,131,.840,156,51,28,1264,113,144,605,PF,30,76,362,TOT,.468
154,Ben Gordon,425,.476,893,173,.410,422,279,25,22,231,598,.455,1315,330,.864,382,82,76,2999,52,184,1699,SG,71,200,283,CHI,.521
155,Eric Gordon,280,.496,564,131,.389,337,215,20,35,156,411,.456,901,299,.854,350,78,65,2677,45,172,1252,SG,78,164,201,LAC,.529
156,Marcin Gortat,105,.565,186,1,1.000,1,14,24,53,190,106,.567,187,26,.578,45,63,3,794,96,111,239,PF,18,25,286,ORL,.570
157,Joey Graham,228,.491,464,3,.188,16,48,26,12,197,231,.481,480,132,.825,160,78,10,1541,95,191,597,SF,35,74,292,TOR,.484
158,Stephen Graham,86,.453,190,20,.303,66,33,26,4,75,106,.414,256,50,.806,62,52,6,684,21,82,282,SG,10,45,96,IND,.453
159,Danny Granger,389,.470,827,182,.404,450,183,25,97,292,571,.447,1277,404,.878,460,67,66,2424,49,207,1728,SF,69,165,341,IND,.518
160,Aaron Gray,81,.488,166,0,.000,1,46,24,18,136,81,.485,167,34,.576,59,56,18,715,84,135,196,C,14,40,220,CHI,.485
161,Gerald Green,65,.485,134,14,.304,46,15,23,5,40,79,.439,180,27,.844,32,38,12,376,14,51,199,SG,10,33,54,DAL,.478
162,Jeff Green,380,.463,821,96,.389,247,155,22,33,399,476,.446,1068,242,.788,307,78,78,2873,120,202,1290,PF,81,173,519,OKC,.491
163,Willie Green,235,.473,497,51,.317,161,158,27,13,97,286,.435,658,62,.729,85,81,60,1828,29,154,685,SG,53,64,126,PHI,.473
164,Donte Greene,51,.375,136,26,.260,100,30,20,14,67,77,.326,236,29,.853,34,55,4,725,19,68,209,SF,16,37,86,SAC,.381
165,Hamed Haddadi,15,.484,31,0,,0,8,23,12,31,15,.484,31,18,.600,30,19,0,120,16,20,48,C,1,9,47,MEM,.484
166,Malik Hairston,24,.500,48,0,.000,1,13,21,7,17,24,.490,49,2,.286,7,15,0,155,11,19,50,SG,6,12,28,SAS,.490
167,Richard Hamilton,396,.464,853,70,.368,190,297,30,4,163,466,.447,1043,223,.848,263,67,51,2279,44,176,1225,SG,40,133,207,DET,.480
168,Matt Harpring,111,.464,239,0,.000,2,28,32,9,76,111,.461,241,55,.764,72,63,2,693,47,102,277,SG,29,29,123,UTA,.461
169,Al Harrington,361,.487,742,171,.364,470,102,28,22,356,532,.439,1212,234,.793,295,73,56,2546,99,227,1469,PF,88,161,455,TOT,.509
170,Devin Harris,391,.477,819,64,.291,220,476,25,13,201,455,.438,1039,496,.820,605,69,69,2494,30,164,1470,PG,114,212,231,NJN,.469
171,Jason Hart,30,.341,88,0,.000,6,48,30,4,33,30,.319,94,18,.783,23,39,2,348,13,39,78,PG,12,22,46,TOT,.319
172,Udonis Haslem,333,.518,643,0,,0,85,28,25,449,333,.518,643,128,.753,170,75,75,2560,169,204,794,PF,43,82,618,MIA,.518
173,Trenton Hassell,84,.459,183,2,.250,8,51,29,16,96,86,.450,191,20,.800,25,53,31,1094,50,92,194,SF,21,30,146,NJN,.455
174,Spencer Hawes,333,.486,685,40,.348,115,149,20,93,401,373,.466,800,90,.662,136,77,51,2259,148,249,876,C,44,160,549,SAC,.491
175,Chuck Hayes,42,.385,109,0,.000,4,42,25,19,176,42,.372,113,7,.368,19,71,1,858,74,134,91,C,34,25,250,HOU,.372
176,Jarvis Hayes,163,.489,333,94,.385,244,54,27,7,240,257,.445,577,36,.692,52,74,1,1832,27,162,644,SF,52,49,267,NJN,.527
177,Brendan Haywood,24,.480,50,0,,0,8,29,15,31,24,.480,50,10,.476,21,6,5,175,13,14,58,C,4,9,44,WAS,.480
178,Luther Head,35,.389,90,20,.370,54,58,26,2,46,55,.382,144,19,.792,24,32,4,498,6,37,149,PG-SG,17,25,52,TOT,.451
179,Walter Herrmann,41,.471,87,41,.342,120,22,29,4,79,82,.396,207,19,.760,25,59,0,630,28,43,224,SF,7,17,107,DET,.495
180,Roy Hibbert,198,.471,420,0,,0,49,22,76,128,198,.471,420,98,.667,147,70,42,1009,115,215,494,C,20,55,243,IND,.471
181,J.J. Hickson,100,.515,194,0,,0,9,20,30,113,100,.515,194,45,.672,67,62,0,705,52,81,245,C,14,45,165,CLE,.515
182,Nene Hilario,427,.607,704,1,.200,5,108,26,101,415,428,.604,709,266,.723,368,77,76,2510,183,278,1123,C,95,147,598,DEN,.604
183,George Hill,126,.421,299,24,.329,73,136,22,21,128,150,.403,372,114,.781,146,77,7,1270,30,150,438,PG,45,74,158,SAS,.435
184,Grant Hill,366,.547,669,24,.316,76,186,36,54,341,390,.523,745,181,.808,224,82,68,2445,64,182,985,SF,90,126,405,PHO,.540
185,Steven Hill,1,1.000,1,0,,0,0,23,0,1,1,1.000,1,0,,0,1,0,2,2,0,2,PF,0,0,3,OKC,1.000
186,Kirk Hinrich,114,.456,250,69,.408,169,197,28,19,107,183,.437,419,68,.791,86,51,4,1339,16,126,503,SG,66,87,123,CHI,.519
187,Ryan Hollins,50,.532,94,0,,0,7,24,32,51,50,.532,94,43,.597,72,45,3,444,46,78,143,C,7,24,97,TOT,.532
188,Al Horford,312,.526,593,0,.000,1,163,22,95,479,312,.525,594,149,.727,205,67,67,2242,145,190,773,C,53,103,624,ATL,.525
189,Eddie House,98,.445,220,151,.444,340,92,30,7,146,249,.445,560,42,.792,53,81,0,1479,11,113,691,PG,61,55,157,BOS,.579
190,Dwight Howard,560,.573,977,0,.000,2,112,23,231,757,560,.572,979,504,.594,849,79,79,2821,336,270,1624,C,77,240,1093,ORL,.572
191,Josh Howard,295,.480,615,58,.345,168,83,28,30,204,353,.451,783,172,.782,220,52,51,1663,59,135,936,SF,55,89,263,DAL,.488
192,Juwan Howard,75,.510,147,0,,0,26,35,6,46,75,.510,147,23,.676,34,42,2,472,30,71,173,SF-PF,7,26,76,TOT,.510
193,Larry Hughes,149,.409,364,75,.389,193,119,30,14,143,224,.402,557,117,.807,145,55,20,1479,16,96,640,SF-SG,72,71,159,TOT,.469
194,Kris Humphries,38,.422,90,0,,0,10,23,6,46,38,.422,90,38,.792,48,29,0,265,24,31,114,SF,8,8,70,TOR,.422
195,Lindsey Hunter,11,.324,34,16,.333,48,37,38,1,10,27,.329,82,3,.600,5,28,0,266,2,28,73,PG,20,19,12,CHI,.427
196,Othello Hunter,11,.550,20,0,,0,1,22,5,15,11,.550,20,0,.000,5,16,0,92,9,11,22,PF,2,2,24,ATL,.550
197,Andre Iguodala,462,.521,886,80,.307,261,434,25,36,379,542,.473,1147,377,.724,521,82,82,3269,92,152,1541,SF,131,222,471,PHI,.507
198,Zydrunas Ilgauskas,327,.477,685,15,.385,39,64,33,84,333,342,.472,724,139,.799,174,65,65,1765,157,183,838,C,28,90,490,CLE,.483
199,Didier Ilunga-Mbenga,27,.482,56,0,.000,1,9,28,24,22,27,.474,57,7,.875,8,23,0,181,9,33,61,C,10,13,31,LAL,.474
200,Allen Iverson*,320,.435,735,28,.283,99,283,33,6,143,348,.417,834,271,.781,347,57,53,2093,30,86,995,PG-SG,88,146,173,TOT,.434
201,Royal Ivey,30,.319,94,39,.342,114,43,27,7,57,69,.332,208,34,.791,43,71,0,861,19,76,211,SG,36,23,76,PHI,.425
202,Jarrett Jack,308,.487,632,78,.353,221,338,25,17,232,386,.453,853,224,.852,263,82,53,2716,44,179,1074,SG,88,184,276,IND,.498
203,Bobby Jackson,133,.462,288,60,.305,197,143,35,4,158,193,.398,485,86,.851,101,71,10,1484,42,100,532,PG,62,66,200,SAC,.460
204,Darnell Jackson,37,.440,84,0,.000,2,8,23,4,55,37,.430,86,24,.686,35,51,2,430,32,77,98,PF,10,14,87,CLE,.430
205,Stephen Jackson,310,.448,692,103,.338,305,381,30,31,233,413,.414,997,294,.826,356,59,59,2339,70,153,1223,SF,88,229,303,GSW,.466
206,Jerome James,3,.375,8,0,,0,0,33,1,2,3,.375,8,0,,0,2,0,10,1,2,6,C,1,1,3,NYK,.375
207,LeBron James,657,.535,1229,132,.344,384,587,24,93,507,789,.489,1613,594,.780,762,81,81,3054,106,139,2304,SF,137,241,613,CLE,.530
208,Mike James,128,.388,330,69,.375,184,201,33,6,108,197,.383,514,68,.829,82,61,50,1649,25,108,531,PG,44,94,133,TOT,.450
209,Antawn Jamison,562,.501,1122,112,.351,319,153,32,25,525,674,.468,1441,341,.754,452,81,81,3096,196,218,1801,PF,95,125,721,WAS,.507
210,Marko Jaric,37,.316,117,11,.393,28,74,30,11,42,48,.331,145,29,.707,41,53,0,605,23,62,136,SG,29,49,65,MEM,.369
211,Nathan Jawai,1,.250,4,0,,0,0,22,0,1,1,.250,4,0,,0,6,0,19,1,3,2,PF,0,2,2,TOR,.250
212,Al Jefferson,485,.499,971,0,.000,4,79,24,83,376,485,.497,975,186,.738,252,50,50,1836,172,141,1156,C,39,92,548,MIN,.497
213,Dontell Jefferson,10,.500,20,1,.500,2,9,25,1,11,11,.500,22,6,.667,9,6,0,84,1,9,29,SG,4,6,12,CHA,.523
214,Richard Jefferson,421,.453,930,116,.397,292,199,28,14,317,537,.439,1222,417,.805,518,82,82,2939,57,252,1607,SF,66,165,374,MIL,.487
215,Jared Jeffries,119,.456,261,1,.083,12,80,27,33,103,120,.440,273,55,.611,90,56,36,1310,128,153,296,SF,47,65,231,NYK,.441
216,Yi Jianlian,143,.397,360,48,.343,140,60,21,36,259,191,.382,500,95,.772,123,61,52,1421,67,157,525,PF,29,70,326,NJN,.430
217,Amir Johnson,97,.595,163,0,,0,20,21,60,130,97,.595,163,23,.657,35,62,24,911,102,171,217,PF,20,33,232,DET,.595
218,Anthony Johnson,102,.411,248,52,.391,133,200,34,5,118,154,.404,381,61,.753,81,80,12,1481,29,111,421,PG,46,82,147,ORL,.472
219,Joe Johnson,471,.468,1006,149,.360,414,455,27,19,281,620,.437,1420,299,.826,362,79,79,3124,65,176,1688,SG,84,195,346,ATL,.489
220,Linton Johnson,3,.333,9,1,.500,2,2,28,0,5,4,.364,11,0,,0,10,0,55,3,7,9,PF,1,2,8,TOT,.409
221,Trey Johnson,0,.000,5,0,,0,0,24,0,1,0,.000,5,4,1.000,4,4,0,14,0,4,4,SG,0,1,1,CLE,.000
222,Dahntay Jones,143,.448,319,11,.647,17,78,28,19,110,154,.458,336,110,.728,151,79,71,1426,58,199,429,SG,49,68,168,DEN,.475
223,Damon Jones,0,.000,6,11,.393,28,7,32,0,6,11,.324,34,0,,0,18,0,108,0,4,33,PG,3,6,6,MIL,.485
224,Dwayne Jones,4,.571,7,0,,0,0,25,1,6,4,.571,7,4,.667,6,6,0,52,6,6,12,PF,0,4,12,CHA,.571
225,Fred Jones,75,.441,170,54,.367,147,188,29,11,103,129,.407,317,66,.815,81,52,21,1495,23,112,378,SF,53,66,126,LAC,.492
226,James Jones,22,.415,53,33,.344,96,20,28,14,50,55,.369,149,26,.839,31,40,1,630,12,58,169,SF,12,12,62,MIA,.480
227,Solomon Jones,66,.606,109,1,.500,2,15,24,34,90,67,.604,111,53,.716,74,63,0,675,52,125,188,C,7,27,142,ATL,.608
228,DeAndre Jordan,93,.633,147,0,,0,11,20,59,165,93,.633,147,42,.385,109,53,13,771,72,96,228,C,11,41,237,LAC,.633
229,Chris Kaman,161,.528,305,0,,0,46,26,45,172,161,.528,305,51,.680,75,31,24,921,75,93,373,C,17,84,247,LAC,.528
230,Jason Kapono,163,.435,375,98,.428,229,105,27,3,137,261,.432,604,34,.810,42,80,12,1831,26,144,654,SG,22,70,163,TOR,.513
231,Jason Kidd,126,.427,295,131,.406,323,702,35,39,415,257,.416,618,86,.819,105,81,81,2886,85,168,731,PG,160,185,500,DAL,.522
232,Tarence Kinsey,24,.471,51,7,.389,18,10,24,0,28,31,.449,69,33,.868,38,50,3,277,10,34,102,SG,12,22,38,CLE,.500
233,Andrei Kirilenko,236,.475,497,20,.274,73,175,27,77,235,256,.449,570,244,.785,311,67,10,1831,84,127,776,PF,83,121,319,UTA,.467
234,Linas Kleiza,202,.533,379,87,.326,267,64,24,14,235,289,.447,646,148,.725,204,82,7,1824,92,155,813,SF,31,82,327,DEN,.515
235,Brevin Knight,66,.361,183,0,.000,6,190,33,4,75,66,.349,189,48,.750,64,74,0,938,13,98,180,PG,68,66,88,UTA,.349
236,Kyle Korver,142,.485,293,103,.386,267,137,27,30,223,245,.438,560,112,.882,127,78,2,1874,35,170,705,SF,47,90,258,UTA,.529
237,Kosta Koufos,94,.508,185,0,,0,20,19,31,88,94,.508,185,36,.706,51,48,7,565,50,70,224,C,12,26,138,UTA,.508
238,Nenad Krstic,191,.469,407,0,,0,29,25,49,168,191,.469,407,63,.797,79,46,29,1141,85,114,445,C,21,45,253,OKC,.469
239,Rob Kurz,36,.387,93,15,.395,38,20,23,19,48,51,.389,131,40,.800,50,40,5,442,33,78,157,SF,14,16,81,GSW,.447
240,Carl Landry,239,.576,415,1,.333,3,39,25,31,219,240,.574,418,157,.813,193,69,0,1467,124,166,638,PF,26,68,343,HOU,.575
241,Acie Law,43,.391,110,9,.310,29,86,24,3,52,52,.374,139,49,.817,60,55,1,560,6,43,162,PG,11,29,58,ATL,.406
242,Courtney Lee,161,.478,337,82,.404,203,91,23,14,160,243,.450,540,78,.830,94,77,42,1939,18,157,646,SG,76,69,178,ORL,.526
243,David Lee,522,.551,948,0,.000,3,174,25,22,695,522,.549,951,249,.755,330,81,74,2824,256,260,1293,C,80,150,951,NYK,.549
244,Rashard Lewis,258,.482,535,220,.397,554,205,29,51,361,478,.439,1089,225,.836,269,79,79,2859,92,194,1401,PF,81,158,453,ORL,.540
245,Shaun Livingston,31,.517,60,0,,0,20,23,2,25,31,.517,60,9,.900,10,12,1,231,3,12,71,PG,7,9,28,TOT,.517
246,Brook Lopez,448,.532,842,0,.000,2,86,20,151,440,448,.531,844,172,.793,217,82,75,2501,225,257,1068,C,44,147,665,NJN,.531
247,Robin Lopez,71,.522,136,0,.000,1,8,20,41,66,71,.518,137,47,.691,68,60,7,614,52,97,189,C,11,28,118,PHO,.518
248,Kevin Love,314,.469,669,2,.105,19,84,20,50,460,316,.459,688,265,.789,336,81,37,2048,274,205,899,C,35,118,734,MIN,.461
249,Kyle Lowry,164,.488,336,25,.255,98,275,22,17,163,189,.435,434,181,.801,226,77,21,1679,26,146,584,PG,69,117,189,TOT,.464
250,Tyronn Lue,44,.440,100,27,.435,62,60,31,0,40,71,.438,162,14,.737,19,44,0,521,6,54,183,PG,8,23,46,TOT,.522
251,Mark Madsen,3,.214,14,0,,0,4,33,1,8,3,.214,14,0,.000,4,19,1,116,10,18,6,C,1,3,18,MIN,.214
252,Corey Maggette,268,.497,539,24,.253,95,92,29,8,233,292,.461,634,342,.824,415,51,19,1588,49,192,950,PF,44,120,282,GSW,.479
253,Jamaal Magloire,65,.496,131,0,,0,22,30,25,140,65,.496,131,29,.483,60,55,12,709,82,121,159,C,11,32,222,MIA,.496
254,Stephon Marbury,32,.372,86,6,.240,25,75,31,3,26,38,.342,111,6,.462,13,23,4,414,2,34,88,PG,10,37,28,BOS,.369
255,Shawn Marion,372,.506,735,10,.189,53,139,30,66,409,382,.485,788,117,.796,147,69,68,2470,180,132,891,SF,88,105,589,TOT,.491
256,Sean Marks,78,.503,155,2,.200,10,14,33,33,125,80,.485,165,30,.682,44,60,5,838,62,121,192,C,7,35,187,NOH,.491
257,Donyell Marshall,8,.444,18,25,.455,55,15,35,5,34,33,.452,73,3,.500,6,25,0,189,6,24,94,PF,4,6,40,PHI,.623
258,Cartier Martin,18,.409,44,10,.303,33,13,24,4,26,28,.364,77,20,.800,25,33,1,266,7,33,86,SF,8,9,33,CHA,.429
259,Kenyon Martin,304,.498,610,14,.368,38,132,31,74,314,318,.491,648,119,.604,197,66,66,2111,81,201,769,PF,96,104,395,DEN,.502
260,Kevin Martin,226,.423,534,115,.415,277,138,25,8,154,341,.420,811,457,.867,527,51,46,1947,29,116,1254,SG,61,146,183,SAC,.491
261,Desmond Mason,124,.440,282,0,.000,3,46,31,30,116,124,.435,285,46,.541,85,39,19,1064,41,96,294,SG,15,56,157,OKC,.435
262,Roger Mason,183,.428,428,166,.421,394,173,28,12,235,349,.425,822,105,.890,118,82,71,2496,16,160,969,SG,40,100,251,SAS,.526
263,Jason Maxiell,184,.577,319,0,.000,1,24,25,63,155,184,.575,320,84,.532,158,78,4,1408,169,157,452,C,25,45,324,DET,.575
264,Sean May,38,.392,97,1,1.000,1,10,24,4,49,39,.398,98,14,.700,20,24,12,301,20,32,93,PF,5,26,69,CHA,.403
265,O.J. Mayo,417,.461,905,145,.384,378,262,21,13,252,562,.438,1283,247,.879,281,82,82,3120,56,204,1516,SG,91,226,308,MEM,.495
266,Luc Mbah a Moute,227,.466,487,0,.000,4,87,22,45,298,227,.462,491,140,.729,192,82,52,2114,189,204,594,PF,87,100,487,MIL,.462
267,Rashad McCants,129,.431,299,63,.333,189,68,24,14,89,192,.393,488,107,.759,141,58,3,1101,21,103,554,SG,47,64,110,TOT,.458
268,Antonio McDyess,268,.510,525,0,,0,83,34,50,422,268,.510,525,60,.698,86,62,30,1866,185,191,596,PF,41,51,607,DET,.510
269,JaVale McGee,191,.494,387,0,,0,23,21,75,174,191,.494,387,107,.660,162,75,14,1143,120,155,489,C,33,61,294,WAS,.494
270,Tracy McGrady*,144,.391,368,44,.376,117,175,29,15,134,188,.388,485,125,.801,156,35,35,1181,20,38,545,SG,42,69,154,HOU,.433
271,Dominic McGuire,138,.431,320,2,.500,4,198,23,74,315,140,.432,324,74,.725,102,79,57,2072,113,153,356,SF,62,92,428,WAS,.435
272,Josh McRoberts,35,.479,73,0,.000,10,16,21,16,48,35,.422,83,10,.769,13,33,0,279,26,41,80,PF,12,12,74,IND,.422
273,Pops Mensah-Bonsu,39,.386,101,0,.000,2,6,25,5,58,39,.379,103,33,.688,48,22,0,283,55,43,111,PF,9,19,113,TOT,.379
274,Chris Mihm,15,.375,40,0,,0,10,29,6,19,15,.375,40,6,.857,7,18,0,105,15,23,36,C,1,10,34,LAL,.375
275,C.J. Miles,195,.509,383,63,.352,179,107,21,15,122,258,.459,562,78,.876,89,72,72,1623,45,187,657,SG,46,64,167,UTA,.515
276,Darius Miles,47,.505,93,1,.167,6,17,27,20,38,48,.485,99,23,.742,31,34,0,298,19,32,120,SF,11,21,57,MEM,.490
277,Darko Milicic,137,.515,266,0,,0,34,23,51,181,137,.515,266,59,.562,105,61,15,1034,83,134,333,C,22,48,264,MEM,.515
278,Andre Miller,477,.483,988,15,.283,53,534,32,14,245,492,.473,1041,338,.826,409,82,82,2976,123,196,1337,PG,109,199,368,PHI,.480
279,Brad Miller,269,.482,558,23,.411,56,234,32,36,395,292,.476,614,224,.824,272,70,43,2100,150,223,831,C,52,130,545,TOT,.494
280,Mike Miller,179,.554,323,85,.378,225,326,28,31,410,264,.482,548,109,.732,149,73,47,2356,73,139,722,SF,30,145,483,MIN,.559
281,Paul Millsap,400,.537,745,0,.000,4,138,23,73,403,400,.534,749,228,.699,326,76,38,2290,251,288,1028,PF,78,129,654,UTA,.534
282,Yao Ming*,565,.548,1031,1,1.000,1,137,28,150,557,566,.548,1032,381,.866,440,77,77,2589,204,257,1514,C,30,234,761,HOU,.549
283,Cuttino Mobley,51,.459,111,12,.343,35,12,33,2,20,63,.432,146,13,.722,18,11,11,365,9,21,151,SG,15,18,29,LAC,.473
284,Nazr Mohammed,41,.406,101,0,,0,8,31,16,44,41,.406,101,22,.550,40,39,1,341,35,63,104,C,5,23,79,CHA,.406
285,Jamario Moon,157,.540,291,65,.355,183,95,28,60,307,222,.468,474,68,.850,80,80,60,2068,58,133,577,SF,86,43,365,TOT,.537
286,Mikki Moore,114,.553,206,0,,0,53,33,19,182,114,.553,206,48,.787,61,70,20,1202,76,208,276,PF-C,17,48,258,TOT,.553
287,Randolph Morris,7,.412,17,0,,0,2,23,1,16,7,.412,17,4,1.000,4,23,0,89,4,25,18,C,2,7,20,ATL,.412
288,Adam Morrison,48,.378,127,32,.333,96,41,24,4,62,80,.359,223,17,.739,23,52,5,711,18,77,209,SF,9,32,80,TOT,.430
289,Anthony Morrow,169,.483,350,86,.467,184,80,23,12,121,255,.478,534,80,.870,92,67,17,1515,78,130,676,SG,36,52,199,GSW,.558
290,Troy Murphy,203,.496,409,161,.450,358,172,28,34,715,364,.475,767,152,.826,184,73,73,2482,146,226,1041,PF,58,114,861,IND,.580
291,Ronald Murray,268,.485,553,87,.360,242,158,29,17,146,355,.447,795,177,.760,233,80,2,1975,22,173,974,SG,88,128,168,ATL,.501
292,Dikembe Mutombo*,5,.385,13,0,,0,0,42,11,21,5,.385,13,6,.667,9,9,2,96,12,11,16,C,0,6,33,HOU,.385
293,Eduardo Najera,28,.571,49,5,.200,25,19,32,4,50,33,.446,74,8,.364,22,27,0,319,17,50,79,PF,10,18,67,NJN,.480
294,Steve Nash,320,.529,605,108,.439,246,717,34,10,204,428,.503,851,196,.933,210,74,74,2484,19,108,1160,PG,55,248,223,PHO,.566
295,DeMarcus Nelson,24,.471,51,0,.000,3,13,23,2,18,24,.444,54,5,.357,14,13,5,171,6,24,53,PG,9,15,24,GSW,.444
296,Jameer Nelson,185,.529,350,82,.453,181,226,26,3,125,267,.503,531,86,.887,97,42,42,1309,20,123,702,PG,51,83,145,ORL,.580
297,Rasho Nesterovic,224,.514,436,0,.000,1,109,32,38,147,224,.513,437,25,.781,32,70,19,1214,93,171,473,C,30,63,240,IND,.513
298,Demetris Nichols,3,.429,7,0,.000,2,1,24,1,2,3,.333,9,1,.500,2,4,0,14,0,1,7,SF,0,0,2,TOT,.333
299,Joakim Noah,207,.558,371,0,.000,1,106,23,110,362,207,.556,372,123,.676,182,80,55,1938,244,238,537,C,49,82,606,CHI,.556
300,Andres Nocioni,175,.449,390,124,.399,311,102,29,33,307,299,.427,701,145,.792,183,76,18,1991,54,261,867,PF-SF,39,113,361,TOT,.515
301,Steve Novak,57,.518,110,119,.416,286,40,25,5,106,176,.444,396,21,.913,23,71,3,1161,19,71,492,PF,20,23,125,LAC,.595
302,Dirk Nowitzki,713,.493,1446,61,.359,170,197,30,63,593,774,.479,1616,485,.890,545,81,81,3050,88,176,2094,PF,61,157,681,DAL,.498
303,Patrick O'Bryant,45,.549,82,0,.000,2,11,22,19,53,45,.536,84,11,.550,20,39,3,255,13,61,101,C,6,22,66,TOT,.536
304,Jermaine O'Neal,365,.475,769,0,.000,1,122,30,136,307,365,.474,770,175,.788,222,68,61,2027,126,211,905,C,29,144,433,TOT,.474
305,Shaquille O'Neal*,512,.610,840,0,.000,1,126,36,108,446,512,.609,841,309,.595,519,75,75,2252,187,253,1333,C,49,168,633,PHO,.609
306,Fabricio Oberto,61,.592,103,0,.000,1,59,33,11,77,61,.587,104,20,.571,35,54,11,677,65,95,142,C,7,38,142,SAS,.587
307,Greg Oden,198,.564,351,0,,0,31,21,69,255,198,.564,351,144,.637,226,61,39,1314,169,238,540,C,25,87,424,POR,.564
308,Lamar Odom,313,.522,600,33,.320,103,204,29,98,461,346,.492,703,160,.623,257,78,32,2316,176,235,885,PF,77,138,637,LAL,.516
309,Emeka Okafor,433,.561,772,0,,0,53,26,136,552,433,.561,772,219,.593,369,82,81,2691,275,247,1085,C,48,144,827,CHA,.561
310,Mehmet Okur,341,.497,686,90,.446,202,120,29,53,433,431,.485,888,273,.817,334,72,72,2409,124,219,1225,C,54,132,557,UTA,.536
311,Kevin Ollie,61,.409,149,0,.000,1,117,36,4,62,61,.407,150,80,.833,96,50,21,850,13,79,202,PG,19,34,75,MIN,.407
312,Travis Outlaw,296,.482,614,89,.377,236,83,24,57,261,385,.453,850,175,.723,242,81,6,2246,70,168,1034,SF,47,94,331,POR,.505
313,Zaza Pachulia,159,.502,317,0,.000,3,57,24,26,263,159,.497,320,163,.709,230,77,26,1473,173,208,481,C,35,91,436,ATL,.497
314,Anthony Parker,227,.442,513,94,.390,241,269,33,15,272,321,.426,754,121,.834,145,80,71,2637,45,145,857,SG,100,114,317,TOR,.488
315,Tony Parker,620,.518,1198,19,.292,65,496,26,4,196,639,.506,1263,284,.782,363,72,71,2456,27,110,1581,PG,67,186,223,SAS,.513
316,Chris Paul,567,.525,1079,64,.364,176,861,23,10,363,631,.503,1255,455,.868,524,78,78,3002,69,212,1781,PG,216,231,432,NOH,.528
317,Sasha Pavlovic,68,.430,158,48,.410,117,72,25,16,96,116,.422,275,25,.463,54,66,12,1053,31,122,305,SF,22,48,127,CLE,.509
318,Oleksiy Pecherov,25,.431,58,14,.326,43,2,23,3,41,39,.386,101,24,.828,29,32,0,277,35,34,116,C,6,10,76,WAS,.455
319,Kendrick Perkins,276,.580,476,0,.000,2,96,24,150,415,276,.577,478,96,.600,160,76,76,2253,204,253,648,C,22,165,619,BOS,.577
320,Morris Peterson,40,.408,98,33,.388,85,16,31,2,71,73,.399,183,12,.632,19,43,9,515,13,51,191,SG,15,15,84,NOH,.489
321,Johan Petro,73,.420,174,0,.000,2,16,23,15,116,73,.415,176,16,.552,29,49,22,559,42,107,162,C,19,28,158,TOT,.415
322,Paul Pierce,421,.480,877,119,.391,304,294,31,27,401,540,.457,1181,459,.830,553,81,81,3035,56,215,1658,SF,80,228,457,BOS,.508
323,Mickael Pietrus,96,.473,203,80,.359,223,65,26,24,132,176,.413,426,78,.709,110,54,25,1329,44,126,510,SG,31,56,176,ORL,.507
324,James Posey,100,.476,210,116,.369,314,82,32,21,324,216,.412,524,120,.822,146,75,0,2140,38,216,668,SG,58,79,362,NOH,.523
325,Leon Powe,177,.524,338,0,,0,46,25,38,200,177,.524,338,184,.689,267,70,7,1227,145,192,538,PF,24,76,345,BOS,.524
326,Josh Powell,106,.444,239,0,,0,27,26,17,105,106,.444,239,38,.760,50,60,1,703,71,98,250,PF,9,51,176,LAL,.444
327,Ronnie Price,58,.408,142,19,.311,61,108,25,5,57,77,.379,203,34,.756,45,52,17,738,12,74,207,PG,39,61,69,UTA,.426
328,Tayshaun Prince,403,.458,879,56,.397,141,253,28,51,348,459,.450,1020,189,.778,243,82,82,3057,128,104,1163,SF,44,101,476,DET,.477
329,Gabe Pruitt,17,.321,53,14,.292,48,39,22,3,34,31,.307,101,17,.810,21,47,0,366,9,34,93,SG,15,19,43,BOS,.376
330,Joel Przybilla,168,.627,268,0,.000,1,27,29,97,513,168,.625,269,112,.663,169,82,43,1952,204,215,448,C,34,78,717,POR,.625
331,Chris Quinn,62,.408,152,56,.409,137,132,25,2,67,118,.408,289,47,.810,58,66,0,962,8,79,339,PG,24,33,75,MIA,.505
332,Vladimir Radmanovic,91,.446,204,105,.401,262,81,28,15,177,196,.421,466,43,.741,58,78,31,1445,45,111,540,SF,46,98,222,TOT,.533
333,Anthony Randolph,199,.466,427,0,.000,4,49,19,74,235,199,.462,431,101,.716,141,63,22,1129,128,141,499,PF,42,80,363,GSW,.462
334,Shavlik Randolph,7,.583,12,1,1.000,1,0,25,1,8,8,.615,13,1,.250,4,10,0,37,10,4,18,PF,0,6,18,POR,.654
335,Zach Randolph,383,.494,776,32,.330,97,103,27,16,347,415,.475,873,179,.734,244,50,45,1757,157,133,1041,PF-C,43,114,504,TOT,.494
336,Theo Ratliff,34,.531,64,0,,0,9,35,47,82,34,.531,64,21,.600,35,46,0,579,46,77,89,C,17,14,128,PHI,.531
337,Michael Redd,179,.503,356,70,.366,191,88,29,2,83,249,.455,547,131,.814,161,33,32,1203,24,45,699,SG,35,53,107,MIL,.519
338,J.J. Redick,50,.417,120,67,.374,179,73,24,1,101,117,.391,299,81,.871,93,64,5,1111,8,72,382,SG,21,54,109,ORL,.503
339,Jason Richardson,336,.518,649,129,.397,325,146,28,28,242,465,.477,974,153,.769,199,72,71,2410,77,146,1212,SG,76,95,319,TOT,.544
340,Jeremy Richardson,8,.250,32,6,.353,17,3,24,0,13,14,.286,49,3,.500,6,12,0,93,1,6,37,SF,0,3,14,ORL,.347
341,Quentin Richardson,142,.420,338,120,.365,329,117,28,7,248,262,.393,667,89,.761,117,72,51,1894,71,132,733,SG,47,74,319,NYK,.483
342,Luke Ridnour,195,.420,464,55,.350,157,365,27,16,185,250,.403,621,133,.869,153,72,50,2033,33,200,688,PG,92,128,218,MIL,.447
343,Anthony Roberson,18,.462,39,26,.321,81,20,25,1,16,44,.367,120,5,1.000,5,29,0,276,6,18,119,PG,10,8,22,TOT,.475
344,Nate Robinson,324,.504,643,125,.325,385,301,24,6,192,449,.437,1028,249,.841,296,74,11,2209,98,206,1272,PG,95,139,290,NYK,.498
345,Sergio Rodriguez,92,.428,215,37,.325,114,286,22,2,87,129,.392,329,61,.792,77,80,13,1225,43,133,356,PG,54,119,130,POR,.448
346,Rajon Rondo,368,.518,711,15,.313,48,659,22,11,316,383,.505,759,172,.642,268,80,80,2642,100,193,953,PG,149,209,416,BOS,.514
347,Derrick Rose,558,.491,1136,16,.222,72,512,20,18,221,574,.475,1208,197,.788,250,81,80,3000,96,125,1361,PG,66,202,317,CHI,.482
348,Malik Rose,45,.363,124,0,.000,7,36,34,3,79,45,.344,131,40,.784,51,38,0,470,17,72,130,SF-PF,10,36,96,TOT,.344
349,Quinton Ross,66,.386,171,33,.375,88,47,27,14,97,99,.382,259,34,.810,42,68,7,1164,29,114,265,SF,32,36,126,MEM,.446
350,Brandon Roy,550,.501,1098,83,.377,220,400,24,22,266,633,.480,1318,416,.824,505,78,78,2903,104,127,1765,SG,88,152,370,POR,.512
351,Michael Ruffin,2,.286,7,0,,0,0,32,1,5,2,.286,7,2,1.000,2,11,0,35,6,7,6,PF,3,2,11,POR,.286
352,Brandon Rush,165,.451,366,78,.373,209,66,23,37,199,243,.423,575,46,.697,66,75,19,1803,34,128,610,SG,38,75,233,IND,.490
353,Kareem Rush,10,.400,25,10,.303,33,15,28,1,15,20,.345,58,4,1.000,4,25,1,199,0,10,54,SG,5,10,15,PHI,.431
354,John Salmons,390,.493,791,126,.417,302,249,29,24,274,516,.472,1093,288,.830,347,79,74,2959,59,182,1446,SF,83,165,333,TOT,.530
355,Cheikh Samb,6,.207,29,0,.000,3,1,24,10,14,6,.188,32,3,.429,7,18,0,83,10,7,15,C,3,3,24,TOT,.188
356,Brian Scalabrine,24,.453,53,24,.393,61,18,30,10,43,48,.421,114,16,.889,18,39,8,504,7,73,136,C,7,12,50,BOS,.526
357,Luis Scola,424,.533,796,0,.000,3,123,28,11,520,424,.531,799,196,.760,258,82,82,2488,200,261,1044,PF,68,123,720,HOU,.531
358,Thabo Sefolosha,128,.474,270,24,.276,87,111,24,45,188,152,.426,357,61,.836,73,66,36,1453,54,104,389,SF-SG,75,64,242,TOT,.459
359,Mouhamed Sene,6,.667,9,0,,0,0,22,3,9,6,.667,9,8,.800,10,6,0,29,5,2,20,C,1,4,14,TOT,.667
360,Ramon Sessions,339,.457,741,6,.176,34,452,22,7,205,345,.445,775,281,.794,354,79,39,2173,64,158,977,PG,83,152,269,MIL,.449
361,Walter Sharpe,4,.444,9,0,.000,2,0,22,2,3,4,.364,11,0,.000,2,8,0,20,0,3,8,PF,0,0,3,DET,.364
362,Bobby Simmons,81,.453,179,117,.447,262,92,28,10,205,198,.449,441,43,.741,58,71,44,1729,72,186,556,SF,50,62,277,NJN,.582
363,Cedric Simmons,11,.440,25,0,,0,2,23,4,11,11,.440,25,7,.438,16,18,0,84,5,8,29,PF,1,2,16,TOT,.440
364,Courtney Sims,3,.500,6,0,,0,0,25,0,2,3,.500,6,0,,0,2,0,13,2,1,6,C,0,1,4,TOT,.500
365,Sean Singletary,21,.350,60,10,.400,25,29,23,0,25,31,.365,85,18,.857,21,37,2,303,10,45,90,PG,11,23,35,TOT,.424
366,James Singleton,104,.575,181,13,.325,40,17,27,28,161,117,.529,221,67,.859,78,62,6,884,89,110,314,PF,26,36,250,DAL,.559
367,Brian Skinner,92,.453,203,0,.000,2,27,32,52,131,92,.449,205,30,.638,47,51,21,843,72,94,214,PF,17,43,203,LAC,.449
368,Craig Smith,289,.563,513,0,.000,1,79,25,19,186,289,.562,514,168,.677,248,74,31,1460,98,184,746,PF,31,105,284,MIN,.562
369,J.R. Smith,244,.491,497,180,.397,453,227,23,14,254,424,.446,950,205,.754,272,81,18,2245,43,190,1233,SG,78,150,297,DEN,.541
370,Joe Smith,153,.469,326,3,.429,7,41,33,40,174,156,.468,333,59,.720,82,57,3,1102,89,122,374,C,17,25,263,TOT,.473
371,Josh Smith,392,.514,762,26,.299,87,169,23,111,364,418,.492,849,211,.588,359,69,69,2421,134,184,1073,PF,94,161,498,ATL,.508
372,Will Solomon,77,.484,159,28,.326,86,133,30,4,52,105,.429,245,25,.735,34,53,9,712,12,71,263,PG,27,54,64,TOT,.486
373,Darius Songaila,243,.533,456,0,.000,1,94,30,20,152,243,.532,457,80,.889,90,77,29,1521,75,200,566,C,64,74,227,WAS,.532
374,Marreese Speights,250,.506,494,2,.250,8,30,21,56,170,252,.502,502,102,.773,132,79,2,1263,123,181,608,C,27,46,293,PHI,.504
375,Jerry Stackhouse,13,.317,41,3,.158,19,12,34,1,12,16,.267,60,7,1.000,7,10,1,162,5,6,42,SG,4,9,17,DAL,.292
376,DeShawn Stevenson,37,.363,102,35,.271,129,98,27,2,65,72,.312,231,32,.533,60,32,25,886,11,43,211,SG,21,32,76,WAS,.387
377,Peja Stojakovic,142,.424,335,145,.378,384,75,31,3,220,287,.399,719,93,.894,104,61,59,2089,44,101,812,SF,52,51,264,NOH,.500
378,Amar'e Stoudemire,401,.540,742,3,.429,7,104,26,57,314,404,.539,749,323,.835,387,53,53,1948,116,163,1134,PF,49,150,430,PHO,.541
379,Rodney Stuckey,378,.453,835,23,.295,78,387,22,11,206,401,.439,913,233,.803,290,79,65,2517,69,217,1058,PG,78,173,275,DET,.452
380,Robert Swift,37,.521,71,0,,0,9,23,17,68,37,.521,71,12,.750,16,26,10,343,21,50,86,C,5,8,89,OKC,.521
381,Stromile Swift,23,.418,55,1,1.000,1,3,29,8,30,24,.429,56,13,.500,26,19,0,185,16,40,62,PF,4,16,46,TOT,.438
382,Wally Szczerbiak,110,.478,230,69,.411,168,82,31,10,189,179,.450,398,90,.849,106,74,5,1527,43,130,517,SF,28,55,232,CLE,.536
383,Mike Taylor,97,.427,227,13,.325,40,106,23,0,65,110,.412,267,56,.691,81,51,5,771,22,84,289,PG,36,73,87,LAC,.436
384,Sebastian Telfair,194,.399,486,73,.346,211,343,23,12,95,267,.383,697,131,.819,160,75,43,2095,32,184,738,PG,73,146,127,MIN,.435
385,Jason Terry,374,.525,712,167,.366,456,251,31,20,138,541,.463,1168,198,.880,225,74,11,2491,39,141,1447,SG,97,119,177,DAL,.535
386,Etan Thomas,32,.485,66,0,,0,6,30,18,41,32,.485,66,16,.696,23,26,7,306,25,35,80,C,3,18,66,WAS,.485
387,Kenny Thomas,3,.375,8,0,,0,1,31,1,11,3,.375,8,0,,0,8,0,62,4,9,6,PF,6,1,15,SAC,.375
388,Kurt Thomas,153,.507,302,0,.000,2,66,36,58,271,153,.503,304,37,.822,45,79,10,1404,134,170,343,PF,34,42,405,SAS,.503
389,Tim Thomas,111,.446,249,78,.413,189,68,31,11,159,189,.432,438,89,.736,121,64,6,1247,42,144,545,PF,31,70,201,TOT,.521
390,Tyrus Thomas,305,.453,674,3,.333,9,77,22,151,360,308,.451,683,238,.783,304,79,61,2175,148,220,857,PF,91,129,508,CHI,.453
391,Jason Thompson,356,.502,709,0,.000,8,93,22,59,372,356,.497,717,198,.692,286,82,56,2303,234,314,910,PF,46,146,606,SAC,.497
392,Al Thornton,449,.462,972,20,.253,79,103,25,62,246,469,.446,1051,236,.754,313,71,67,2654,122,227,1194,SF,59,130,368,LAC,.456
393,Anthony Tolliver,10,.417,24,9,.220,41,17,23,1,29,19,.292,65,5,.500,10,19,0,208,12,16,52,PF,5,7,41,SAS,.362
394,Alando Tucker,44,.449,98,8,.348,23,12,24,1,12,52,.430,121,26,.788,33,30,1,282,19,14,138,SG,5,14,31,PHO,.463
395,Ronny Turiaf,186,.512,363,0,.000,3,166,26,168,272,186,.508,366,98,.790,124,79,26,1696,88,243,470,C,34,70,360,GSW,.508
396,Hedo Turkoglu,289,.445,649,134,.356,376,375,29,19,365,423,.413,1025,314,.807,389,77,77,2815,45,218,1294,SF,64,204,410,ORL,.478
397,Ime Udoka,69,.426,162,41,.328,125,54,31,12,159,110,.383,287,28,.609,46,67,3,1035,28,86,289,SF,36,38,187,SAS,.455
398,Beno Udrih,286,.491,583,35,.310,113,342,26,12,174,321,.461,696,123,.820,150,73,72,2270,46,192,800,PG,81,158,220,SAC,.486
399,Roko Ukic,112,.427,262,11,.177,62,153,24,2,48,123,.380,324,44,.733,60,72,0,890,27,77,301,PG,30,60,75,TOR,.397
400,Anderson Varejao,270,.538,502,0,.000,2,81,26,66,415,270,.536,504,154,.616,250,81,42,2306,166,239,694,PF,75,80,581,CLE,.536
401,Jacque Vaughn,23,.311,74,1,1.000,1,55,33,0,18,24,.320,75,16,.889,18,30,0,292,4,26,65,PG,6,15,22,SAS,.327
402,Charlie Villanueva,398,.479,831,89,.345,258,137,24,56,366,487,.447,1089,201,.838,240,78,47,2095,154,254,1264,PF,50,138,520,MIL,.488
403,Jake Voskuhl,12,.267,45,0,,0,8,31,4,38,12,.267,45,11,.786,14,38,1,240,21,60,35,C,3,17,59,TOR,.267
404,Sasha Vujacic,74,.416,178,81,.363,223,113,24,7,116,155,.387,401,70,.921,76,80,0,1293,19,154,461,SG,77,35,135,LAL,.488
405,Dwyane Wade,766,.524,1461,88,.317,278,589,27,106,309,854,.491,1739,590,.765,771,79,79,3048,89,178,2386,SG,173,272,398,MIA,.516
406,Von Wafer,165,.474,348,64,.390,164,71,23,8,94,229,.447,512,88,.752,117,63,11,1225,19,71,610,SG,40,59,113,HOU,.510
407,Henry Walker,36,.632,57,0,.000,1,13,21,2,21,36,.621,58,16,.696,23,29,0,216,8,51,88,SF,6,18,29,BOS,.621
408,Ben Wallace,69,.445,155,0,,0,44,34,75,226,69,.445,155,27,.422,64,56,53,1314,136,82,165,PF,48,34,362,CLE,.445
409,Gerald Wallace,350,.515,680,39,.298,131,189,26,67,441,389,.480,811,365,.804,454,71,71,2669,112,210,1182,SF,121,148,553,CHA,.504
410,Rasheed Wallace,189,.471,401,113,.354,319,91,34,86,434,302,.419,720,78,.772,101,66,63,2123,56,197,795,C,62,59,490,DET,.498
411,Luke Walton,117,.468,250,17,.298,57,177,28,10,125,134,.436,307,41,.719,57,65,34,1166,55,105,326,SF,32,69,180,LAL,.464
412,Hakim Warrick,335,.500,670,5,.217,23,66,26,39,277,340,.491,693,266,.711,374,82,7,2029,129,170,951,PF,48,98,406,MEM,.494
413,C.J. Watson,209,.473,442,48,.400,120,206,24,4,153,257,.457,562,168,.870,193,77,18,1883,39,137,730,PG,96,92,192,GSW,.500
414,Earl Watson,154,.418,368,20,.235,85,391,29,11,147,174,.384,453,80,.755,106,68,18,1776,36,137,448,PG,50,156,183,OKC,.406
415,Kyle Weaver,81,.529,153,32,.344,93,101,22,25,99,113,.459,246,41,.707,58,56,19,1166,31,81,299,SG,47,69,130,OKC,.524
416,Martell Webster,0,,0,0,.000,1,0,22,0,0,0,.000,1,0,,0,1,0,5,0,0,0,SF,0,0,0,POR,.000
417,Sonny Weems,8,.364,22,0,.000,3,3,22,0,4,8,.320,25,3,.375,8,12,0,55,0,8,19,SG,1,6,4,DEN,.320
418,David West,604,.477,1267,6,.240,25,173,28,68,486,610,.472,1292,367,.884,415,76,76,2982,160,207,1593,PF,49,163,646,NOH,.474
419,Delonte West,194,.490,396,91,.399,228,226,25,13,172,285,.457,624,90,.833,108,64,64,2152,31,125,751,SG,94,92,203,CLE,.530
420,Mario West,13,.394,33,1,1.000,1,19,24,4,32,14,.412,34,14,.467,30,53,3,269,24,35,43,SG,18,13,56,ATL,.426
421,Russell Westbrook,401,.415,966,35,.271,129,435,20,16,221,436,.398,1095,349,.815,428,82,65,2668,178,191,1256,PG,110,274,399,OKC,.414
422,D.J. White,26,.520,50,0,,0,6,22,5,22,26,.520,50,10,.769,13,7,0,130,10,10,62,PF,3,3,32,OKC,.520
423,James White,2,.667,3,1,.500,2,1,26,1,0,3,.600,5,0,,0,4,0,11,0,2,7,SF,1,3,0,HOU,.700
424,Chris Wilcox,184,.503,366,0,.000,4,47,26,16,181,184,.497,370,79,.564,140,62,6,1049,96,137,447,C,26,75,277,TOT,.497
425,Damien Wilkins,50,.355,141,27,.375,72,37,29,7,50,77,.362,213,37,.804,46,41,14,636,20,55,218,SG,22,37,70,OKC,.425
426,Deron Williams,393,.518,758,70,.310,226,725,24,20,171,463,.471,984,326,.849,384,68,68,2505,24,134,1322,PG,73,228,195,UTA,.506
427,Jawad Williams,3,.500,6,2,.333,6,0,25,0,1,5,.417,12,0,,0,10,0,20,1,2,12,SF,1,1,2,CLE,.500
428,Lou Williams,273,.438,624,63,.286,220,242,22,14,129,336,.398,844,304,.790,385,81,0,1919,36,128,1039,SG,85,151,165,PHI,.435
429,Marcus Williams,2,.182,11,2,.333,6,13,23,1,4,4,.235,17,2,.333,6,9,0,54,0,6,12,PG,1,4,4,GSW,.294
430,Marcus Williams,2,1.000,2,0,,0,0,22,0,0,2,1.000,2,0,,0,2,0,3,0,1,4,PF,0,0,0,SAS,1.000
431,Marvin Williams,230,.493,467,55,.355,155,81,22,39,272,285,.458,622,220,.806,273,61,59,2093,110,127,845,SF,57,70,382,ATL,.502
432,Mo Williams,343,.486,706,183,.436,420,329,26,9,232,526,.467,1126,208,.912,228,81,81,2834,47,215,1443,PG,69,179,279,CLE,.548
433,Sean Williams,30,.417,72,0,,0,13,22,29,45,30,.417,72,20,.625,32,33,0,366,34,72,80,PF,7,20,79,NJN,.417
434,Shawne Williams,15,.385,39,1,.059,17,2,22,9,27,16,.286,56,9,.818,11,15,0,170,19,19,42,SF,2,5,46,DAL,.295
435,Shelden Williams,70,.452,155,0,.000,2,12,25,18,104,70,.446,157,46,.730,63,45,0,512,49,64,186,PF,22,34,153,TOT,.446
436,Metta World Peace,263,.402,654,153,.399,383,229,29,24,294,416,.401,1037,196,.748,262,69,55,2452,65,155,1181,SF,105,140,359,HOU,.475
437,Antoine Wright,134,.475,282,45,.302,149,77,24,27,105,179,.415,431,71,.747,95,65,53,1552,31,172,474,SF,46,54,136,DAL,.468
438,Brandan Wright,130,.537,242,0,.000,4,21,21,37,95,130,.528,246,63,.741,85,39,23,688,62,74,323,PF,22,23,157,GSW,.528
439,Dorell Wright,8,.400,20,0,,0,2,23,0,18,8,.400,20,2,.333,6,6,0,73,2,8,18,SF,2,6,20,MIA,.400
440,Julian Wright,107,.502,213,2,.095,21,43,21,19,106,109,.466,234,17,.567,30,54,19,772,46,49,237,SF,35,43,152,NOH,.470
441,Lorenzen Wright,10,.370,27,0,,0,3,33,5,18,10,.370,27,3,.375,8,17,2,125,7,17,23,C,4,9,25,CLE,.370
442,Nick Young,280,.473,592,56,.341,164,95,23,20,119,336,.444,756,164,.850,193,82,5,1837,31,140,892,SG,39,92,150,WAS,.481
443,Thaddeus Young,419,.526,796,56,.341,164,86,20,23,238,475,.495,960,139,.735,189,75,71,2580,139,165,1145,PF,100,118,377,PHI,.524
444,Sun Yue,3,.600,5,0,.000,6,2,23,1,0,3,.273,11,0,,0,10,0,28,0,10,6,SG,1,3,0,LAL,.273
