,Player_Name,2P,2P%,2PA,3P,3P%,3PA,AST,Age,BLK,DRB,FG,FG%,FGA,FT,FT%,FTA,Games,Games_Strated,Minutes_Played,ORB,PF,PTS,Position,STL,TOV,TRB,Team,eFG%
0,Arron Afflalo,164,.488,336,108,.434,249,138,24,30,193,272,.465,585,72,.735,98,82,75,2221,59,225,724,SG,46,74,252,DEN,.557
1,Alexis Ajinca,5,.500,10,0,,0,0,21,1,3,5,.500,10,0,.000,1,6,0,30,1,5,10,C,1,2,4,CHA,.500
2,LaMarcus Aldridge,574,.498,1153,5,.313,16,160,24,48,435,579,.495,1169,230,.757,304,78,78,2922,192,231,1393,PF,67,104,627,POR,.497
3,Joe Alexander,1,.200,5,0,.000,1,2,23,1,3,1,.167,6,2,.667,3,8,0,29,2,9,4,SF,1,0,5,CHI,.167
4,Malik Allen,45,.409,110,1,.167,6,16,31,5,46,46,.397,116,12,.923,13,51,3,456,36,68,105,PF,11,22,82,DEN,.401
5,Ray Allen,319,.556,574,145,.363,399,210,34,25,208,464,.477,973,231,.913,253,80,80,2819,45,182,1304,SG,64,129,253,BOS,.551
6,Tony Allen,129,.520,248,0,.000,5,72,28,19,93,129,.510,253,72,.605,119,54,8,889,52,109,330,SG,59,66,145,BOS,.510
7,Rafer Alston,97,.349,278,58,.345,168,176,33,10,116,155,.348,446,59,.728,81,52,38,1421,13,103,427,PG,50,95,129,TOT,.413
8,Lou Amundson,152,.553,275,0,.000,1,31,27,73,218,152,.551,276,67,.545,123,79,0,1168,128,169,371,PF,24,57,346,PHO,.551
9,Chris Andersen,142,.573,248,0,.000,3,33,31,143,336,142,.566,251,164,.695,236,76,0,1695,147,171,448,PF,42,59,483,DEN,.566
10,David Andersen,120,.458,262,27,.346,78,44,29,12,154,147,.432,340,46,.687,67,63,0,891,54,119,367,C,15,37,208,HOU,.472
11,Antonio Anderson,1,.333,3,0,,0,0,24,0,0,1,.333,3,0,,0,1,0,15,1,1,2,SF,0,1,1,OKC,.333
12,Ryan Anderson,91,.514,177,78,.370,211,37,21,14,132,169,.436,388,71,.866,82,63,6,911,70,81,487,PF,25,56,202,ORL,.536
13,Carmelo Anthony,629,.478,1315,59,.316,187,222,25,30,302,688,.458,1502,508,.830,612,69,69,2634,152,225,1943,SF,88,209,454,DEN,.478
14,Joel Anthony,76,.478,159,0,,0,12,27,109,126,76,.478,159,66,.717,92,80,16,1322,123,158,218,C,20,45,249,MIA,.478
15,Gilbert Arenas,190,.437,435,63,.348,181,230,28,9,116,253,.411,616,153,.739,207,32,32,1169,17,95,722,PG,41,117,133,WAS,.462
16,Trevor Ariza,258,.436,592,136,.334,407,276,24,40,325,394,.394,999,148,.649,228,72,71,2629,78,162,1072,SF,126,161,403,HOU,.462
17,Hilton Armstrong,28,.359,78,0,.000,1,21,25,12,54,28,.354,79,15,.469,32,33,0,335,27,59,71,PF-C,15,22,81,TOT,.354
18,Carlos Arroyo,171,.489,350,7,.280,25,225,30,6,104,178,.475,375,76,.844,90,72,35,1585,26,102,439,PG,36,54,130,MIA,.484
19,Darrell Arthur,63,.434,145,0,.000,1,15,21,14,73,63,.432,146,17,.567,30,32,1,457,37,60,143,PF,14,22,110,MEM,.432
20,Chucky Atkins,35,.417,84,22,.301,73,91,35,0,24,57,.363,157,25,.926,27,40,11,644,5,53,161,PG,17,32,29,DET,.433
21,D.J. Augustin,98,.381,257,70,.393,178,193,22,5,86,168,.386,435,102,.779,131,80,2,1472,11,127,508,PG,45,74,97,CHA,.467
22,Jeff Ayres,43,.662,65,0,,0,1,22,16,73,43,.662,65,18,.900,20,39,4,405,25,76,104,C,7,12,98,POR,.662
23,Kelenna Azubuike,38,.623,61,10,.370,27,10,26,9,29,48,.545,88,19,.679,28,9,7,231,12,16,125,SF,5,7,41,GSW,.602
24,Renaldo Balkman,6,.545,11,0,.000,7,7,25,2,19,6,.333,18,2,.333,6,13,1,91,4,16,14,SF,8,6,23,DEN,.333
25,Marcus Banks,32,.653,49,7,.292,24,26,28,2,20,39,.534,73,24,.828,29,22,0,244,3,30,109,PG,12,20,23,TOR,.582
26,Leandro Barbosa,111,.485,229,44,.324,136,64,27,12,58,155,.425,365,64,.877,73,44,5,786,11,71,418,PG,23,46,69,PHO,.485
27,J.J. Barea,176,.476,370,56,.357,157,258,25,6,129,232,.440,527,76,.844,90,78,18,1546,17,119,596,PG,35,102,146,DAL,.493
28,Andrea Bargnani,416,.509,818,121,.372,325,93,24,111,388,537,.470,1143,181,.774,234,80,80,2799,105,215,1376,PF,25,120,493,TOR,.523
29,Matt Barnes,205,.586,350,66,.319,207,134,29,30,339,271,.487,557,108,.740,146,81,58,2097,106,185,716,SF,59,112,445,ORL,.546
30,Earl Barron,30,.441,68,0,,0,8,28,4,46,30,.441,68,22,.759,29,7,6,232,31,24,82,C,4,11,77,NYK,.441
31,Brandon Bass,119,.511,233,0,,0,19,24,27,73,119,.511,233,52,.825,63,50,3,648,54,69,290,PF,12,31,127,ORL,.511
32,Tony Battie,13,.361,36,1,.250,4,3,33,2,19,14,.350,40,7,.700,10,15,0,134,4,19,36,C,4,3,23,NJN,.363
33,Shane Battier,77,.458,168,101,.362,279,164,31,76,238,178,.398,447,77,.726,106,67,62,2168,74,139,534,SG,53,64,312,HOU,.511
34,Nicolas Batum,85,.625,136,54,.409,132,44,21,25,109,139,.519,268,43,.843,51,37,25,918,32,83,375,SF,24,27,141,POR,.619
35,Jerryd Bayless,171,.437,391,29,.315,92,172,21,5,102,200,.414,483,201,.831,242,74,11,1304,18,152,630,SG,26,94,120,POR,.444
36,Michael Beasley,440,.469,938,28,.275,102,100,21,49,375,468,.450,1040,192,.800,240,78,78,2328,123,221,1156,PF,80,131,498,MIA,.463
37,Rodrigue Beaubois,110,.582,189,45,.409,110,74,21,12,66,155,.518,299,42,.808,52,56,16,700,12,84,397,PG,29,54,78,DAL,.594
38,Marco Belinelli,94,.425,221,60,.380,158,89,23,5,81,154,.406,379,101,.835,121,66,1,1121,14,80,469,SG,42,60,95,TOR,.485
39,Charlie Bell,96,.395,243,73,.365,200,104,30,12,101,169,.381,443,48,.716,67,71,39,1611,31,136,459,SG,39,54,132,MIL,.464
40,Raja Bell,16,.471,34,12,.444,27,13,33,2,18,28,.459,61,3,1.000,3,6,5,180,5,15,71,SG,4,5,23,TOT,.557
41,Jonathan Bender,26,.426,61,14,.359,39,16,29,17,37,40,.400,100,24,.923,26,25,1,292,15,33,118,SF,2,28,52,NYK,.470
42,Mike Bibby,142,.444,320,126,.389,324,310,31,3,164,268,.416,644,68,.861,79,80,80,2195,20,157,730,PG,67,90,184,ATL,.514
43,Andris Biedrins,81,.591,137,0,,0,57,23,44,196,81,.591,137,4,.160,25,33,29,763,63,117,166,C,20,32,259,GSW,.591
44,Chauncey Billups,245,.441,555,157,.386,407,409,33,9,203,402,.418,962,466,.910,512,73,73,2490,25,153,1427,PG,82,177,228,DEN,.499
45,DeJuan Blair,275,.558,493,0,.000,2,65,20,39,326,275,.556,495,88,.547,161,82,23,1494,200,224,638,PF,50,112,526,SAS,.556
46,Steve Blake,101,.443,228,116,.395,294,380,29,6,166,217,.416,522,36,.750,48,80,38,2159,21,123,586,PG,58,128,187,TOT,.527
47,Andray Blatche,465,.487,955,13,.295,44,170,23,71,351,478,.478,999,174,.744,234,81,36,2256,158,218,1143,PF,85,182,509,WAS,.485
48,Keith Bogans,50,.490,102,70,.357,196,95,29,12,151,120,.403,298,37,.740,50,79,50,1559,25,156,347,SF,45,53,176,SAS,.520
49,Andrew Bogut,473,.521,908,0,.000,2,127,25,175,493,473,.520,910,149,.629,237,69,69,2229,208,222,1095,C,39,131,701,MIL,.520
50,Matt Bonner,76,.539,141,90,.390,231,68,29,24,162,166,.446,372,35,.729,48,65,8,1161,52,109,457,PF,30,39,214,SAS,.567
51,Josh Boone,117,.525,223,0,,0,29,25,48,191,117,.525,223,19,.328,58,63,28,1045,124,111,253,PF,30,37,315,NJN,.525
52,Carlos Boozer,617,.562,1098,0,,0,247,28,36,693,617,.562,1098,285,.742,384,78,78,2673,181,270,1519,PF,84,212,874,UTA,.562
53,Chris Bosh,592,.521,1136,8,.364,22,166,25,68,554,600,.518,1158,470,.797,590,70,70,2526,205,170,1678,C,43,169,759,TOR,.522
54,Ryan Bowen,1,1.000,1,0,,0,0,34,0,1,1,1.000,1,2,1.000,2,1,0,8,1,2,4,SF,1,0,2,OKC,1.000
55,Earl Boykins,153,.446,343,19,.317,60,171,33,3,58,172,.427,403,77,.865,89,67,1,1117,17,48,440,PG,24,69,75,WAS,.450
56,Elton Brand,412,.481,857,0,.000,1,109,30,80,282,412,.480,858,172,.738,233,76,57,2297,179,232,996,PF,82,131,461,PHI,.480
57,Corey Brewer,327,.459,712,82,.346,237,193,23,29,209,409,.431,949,166,.648,256,82,82,2482,70,224,1066,SG,117,164,279,MIN,.474
58,Ronnie Brewer,201,.505,398,8,.258,31,154,24,15,142,209,.487,429,85,.639,133,58,53,1742,45,80,511,SG,91,53,187,TOT,.497
59,Primoz Brezec,9,.346,26,0,,0,1,30,3,13,9,.346,26,1,.167,6,21,0,95,12,19,19,C,1,2,25,TOT,.346
60,Jon Brockman,55,.534,103,0,,0,22,22,5,108,55,.534,103,37,.597,62,52,4,654,105,115,147,PF,15,23,213,SAC,.534
61,Aaron Brooks,366,.454,806,209,.398,525,434,25,14,161,575,.432,1331,245,.822,298,82,82,2919,54,199,1604,PG,69,232,215,HOU,.511
62,Bobby Brown,62,.446,139,26,.265,98,88,25,1,29,88,.371,237,13,.867,15,45,0,519,9,42,215,PG,15,46,38,TOT,.426
63,Derrick Brown,66,.471,140,2,.286,7,19,22,10,47,68,.463,147,48,.667,72,57,0,535,31,53,186,SF,21,19,78,CHA,.469
64,Devin Brown,78,.396,197,58,.354,164,65,31,6,95,136,.377,361,69,.802,86,50,37,1060,29,72,399,SG,33,62,124,TOT,.457
65,Kwame Brown,62,.504,123,0,.000,1,22,27,12,124,62,.500,124,33,.337,98,48,1,660,53,93,157,C,15,43,177,DET,.500
66,Shannon Brown,191,.474,403,62,.328,189,108,24,31,153,253,.427,592,99,.818,121,82,7,1700,30,129,667,SG,57,67,183,LAL,.480
67,Kobe Bryant,617,.487,1268,99,.329,301,365,31,20,313,716,.456,1569,439,.811,541,73,73,2835,78,187,1970,SG,113,233,391,LAL,.488
68,Chase Budinger,157,.497,316,92,.369,249,88,21,11,182,249,.441,565,67,.770,87,74,4,1488,38,85,657,SF,34,48,220,HOU,.522
69,Caron Butler,408,.450,906,42,.290,145,156,29,24,357,450,.428,1051,264,.838,315,74,74,2783,104,193,1206,SF-SG,116,160,461,TOT,.448
70,Rasual Butler,211,.482,438,145,.336,432,116,30,68,201,356,.409,870,122,.841,145,82,64,2702,39,121,979,SF,36,79,240,LAC,.493
71,Andrew Bynum,392,.571,687,0,.000,1,68,22,94,364,392,.570,688,193,.739,261,65,65,1977,177,193,977,C,35,115,541,LAL,.570
72,Will Bynum,225,.470,479,12,.218,55,283,27,7,118,237,.444,534,142,.798,178,63,20,1667,24,143,628,PG,55,115,142,DET,.455
73,Jose Calderon,206,.519,397,68,.398,171,404,28,7,119,274,.482,568,83,.798,104,68,39,1817,23,135,699,PG,47,99,142,TOR,.542
74,Marcus Camby,236,.478,494,2,.286,7,186,35,146,622,238,.475,501,78,.639,122,74,74,2314,249,161,556,PF-C,95,91,871,TOT,.477
75,Brian Cardinal,11,.407,27,3,.333,9,24,32,3,22,14,.389,36,17,.944,18,29,0,267,7,56,48,PF,9,7,29,MIN,.431
76,Rodney Carney,72,.490,147,41,.304,135,37,25,20,111,113,.401,282,52,.825,63,68,0,857,26,79,319,SG,25,21,137,PHI,.473
77,DeMarre Carroll,88,.407,216,0,.000,6,33,23,9,97,88,.396,222,33,.623,53,71,1,795,53,107,209,SF,28,24,150,MEM,.396
78,Matt Carroll,14,.452,31,4,.211,19,6,29,0,8,18,.360,50,6,1.000,6,25,0,121,4,13,46,SG,5,7,12,DAL,.400
79,Anthony Carter,59,.500,118,17,.270,63,160,34,13,72,76,.420,181,11,.846,13,54,7,859,17,72,180,PG,39,58,89,DEN,.467
80,Vince Carter,315,.456,691,119,.367,324,236,33,18,260,434,.428,1015,257,.840,306,75,74,2310,33,189,1244,SG,53,106,293,ORL,.486
81,Omri Casspi,225,.480,469,75,.369,203,95,21,17,274,300,.446,672,117,.672,174,77,31,1931,75,125,792,SF,54,98,349,SAC,.502
82,Mario Chalmers,107,.491,218,75,.318,236,246,23,12,110,182,.401,454,82,.745,110,73,22,1807,25,175,521,PG,91,123,135,MIA,.483
83,Tyson Chandler,109,.574,190,0,,0,16,27,55,206,109,.574,190,115,.732,157,51,27,1163,114,138,333,C,17,91,320,CHA,.574
84,Wilson Chandler,372,.524,710,40,.267,150,138,22,49,255,412,.479,860,129,.806,160,65,64,2320,93,184,993,SG,46,108,348,NYK,.502
85,Earl Clark,54,.370,146,2,.400,5,21,22,13,44,56,.371,151,26,.722,36,51,0,383,18,25,140,PF,7,23,62,PHO,.377
86,Jarron Collins,12,.387,31,0,,0,6,31,3,40,12,.387,31,10,.400,25,34,10,261,22,42,34,C,2,10,62,PHO,.387
87,Jason Collins,8,.364,22,0,.000,1,4,31,2,9,8,.348,23,0,.000,2,24,0,115,5,21,16,C,3,5,14,ATL,.348
88,Mardy Collins,43,.387,111,4,.235,17,44,25,1,37,47,.367,128,13,.619,21,43,0,470,13,45,111,SG,23,32,50,LAC,.383
89,Darren Collison,330,.490,674,46,.400,115,432,22,4,151,376,.477,789,148,.851,174,76,37,2109,41,92,946,PG,78,202,192,NOH,.506
90,Nick Collison,181,.593,305,1,.250,4,38,29,48,232,182,.589,309,74,.692,107,75,5,1557,152,230,439,C,37,63,384,OKC,.591
91,Mike Conley,287,.464,618,82,.387,212,425,22,12,161,369,.445,830,139,.743,187,80,80,2569,30,178,959,PG,109,170,191,MEM,.494
92,Will Conroy,3,.429,7,0,.000,3,7,27,0,3,3,.300,10,0,.000,2,5,0,36,0,5,6,PG,0,4,3,HOU,.300
93,Brian Cook,5,.357,14,2,.222,9,1,29,2,8,7,.304,23,5,.714,7,15,0,44,1,5,21,PF,0,6,9,HOU,.348
94,Daequan Cook,41,.323,127,40,.317,126,43,22,10,73,81,.320,253,21,.840,25,45,3,691,9,50,223,SG,14,24,82,MIA,.399
95,Jamal Crawford,333,.491,678,163,.382,427,238,29,12,167,496,.449,1105,270,.857,315,79,0,2460,34,132,1425,SG,61,137,201,ATL,.523
96,Dante Cunningham,106,.500,212,0,.000,2,14,22,22,106,106,.495,214,31,.646,48,63,2,707,54,97,243,PF,24,15,160,POR,.495
97,Eddy Curry,8,.381,21,0,,0,0,27,1,9,8,.381,21,10,.588,17,7,0,62,4,13,26,C,0,13,13,NYK,.381
98,JamesOn Curry,0,,0,0,,0,0,24,0,0,0,,0,0,,0,1,0,0,0,0,0,PG,0,0,0,LAC,
99,Stephen Curry,362,.474,763,166,.437,380,472,21,19,308,528,.462,1143,177,.885,200,80,77,2896,48,252,1399,PG,152,243,356,GSW,.535
100,Samuel Dalembert,285,.545,523,0,,0,64,28,151,545,285,.545,523,97,.729,133,82,80,2124,239,252,667,C,42,123,784,PHI,.545
101,Erick Dampier,132,.629,210,1,.333,3,31,34,77,272,133,.624,213,61,.604,101,55,47,1280,128,153,328,C,15,61,400,DAL,.627
102,Marquis Daniels,118,.534,221,6,.214,28,66,29,6,68,124,.498,249,34,.607,56,51,4,937,27,91,288,SF,27,42,95,BOS,.510
103,Baron Davis,330,.459,719,82,.277,296,598,30,43,214,412,.406,1015,239,.821,291,75,73,2523,52,210,1145,PG,126,211,266,LAC,.446
104,Glen Davis,122,.444,275,0,.000,4,35,24,14,104,122,.437,279,96,.696,138,54,1,933,101,132,340,PF,21,53,205,BOS,.437
105,Paul Davis,2,.500,4,0,,0,3,25,1,0,2,.500,4,1,.500,2,2,0,8,0,0,5,PF,0,0,0,WAS,.500
106,Ricky Davis,46,.455,101,16,.381,42,39,30,3,47,62,.434,143,18,.581,31,36,2,499,10,39,158,SF,11,29,57,LAC,.490
107,Austin Daye,108,.540,200,29,.305,95,34,21,26,140,137,.464,295,46,.821,56,69,4,915,34,114,349,SF,25,48,174,DET,.514
108,Carlos Delfino,165,.450,367,134,.367,365,202,27,21,343,299,.408,732,93,.782,119,75,66,2279,51,138,825,SF,80,119,394,MIL,.500
109,Luol Deng,441,.474,931,32,.386,83,143,24,61,381,473,.466,1014,252,.764,330,70,69,2651,131,129,1230,SF,66,134,512,CHI,.482
110,DeMar DeRozan,251,.506,496,4,.250,16,53,20,18,157,255,.498,512,148,.763,194,77,65,1664,66,176,662,SG,43,62,223,TOR,.502
111,Boris Diaw,307,.541,567,66,.320,206,325,27,57,293,373,.483,773,113,.769,147,82,82,2906,131,219,925,PF,60,178,424,CHA,.525
112,Yakhouba Diawara,1,.250,4,1,.167,6,3,27,0,3,2,.200,10,0,,0,6,2,44,1,8,5,SG,1,3,4,MIA,.250
113,Travis Diener,1,.333,3,1,.143,7,8,27,0,3,2,.200,10,1,.250,4,9,0,51,0,2,6,PG,4,0,3,TOT,.250
114,DeSagana Diop,15,.517,29,0,,0,5,28,14,41,15,.517,29,2,.222,9,27,0,262,24,31,32,C,5,12,65,CHA,.517
115,Keyon Dooling,70,.419,167,59,.376,157,135,29,0,46,129,.398,324,47,.770,61,53,8,971,8,82,364,PG,34,59,54,NJN,.489
116,Joey Dorsey,9,.450,20,0,,0,2,26,2,27,9,.450,20,5,.417,12,15,0,106,16,21,23,PF,3,6,43,TOT,.450
117,Toney Douglas,111,.514,216,68,.389,175,112,23,3,68,179,.458,391,55,.809,68,56,12,1087,40,116,481,PG,42,55,108,NYK,.545
118,Chris Douglas-Roberts,241,.464,519,14,.259,54,93,23,19,153,255,.445,573,133,.847,157,67,38,1730,45,101,657,SF,55,97,198,NJN,.457
119,Goran Dragic,148,.488,303,74,.394,188,241,23,8,133,222,.452,491,117,.736,159,80,2,1442,38,131,635,PG,48,126,171,PHO,.527
120,Jared Dudley,105,.461,228,120,.458,262,115,24,16,182,225,.459,490,104,.754,138,82,1,1991,99,162,674,SF,81,68,281,PHO,.582
121,Chris Duhon,78,.404,193,90,.349,258,378,27,3,150,168,.373,451,68,.716,95,67,59,2072,28,83,494,PG,59,110,178,NYK,.472
122,Tim Duncan,559,.522,1071,2,.182,11,246,33,117,567,561,.518,1082,271,.725,374,78,77,2438,221,152,1395,C,45,140,788,SAS,.519
123,Mike Dunleavy,154,.478,322,75,.318,236,103,29,15,211,229,.410,558,133,.842,158,67,15,1486,25,105,666,SF,38,72,236,IND,.478
124,Kevin Durant,666,.506,1317,128,.365,351,231,21,84,518,794,.476,1668,756,.900,840,82,82,3239,105,171,2472,SF,112,271,623,OKC,.514
125,Wayne Ellington,126,.441,286,64,.395,162,74,22,5,126,190,.424,448,61,.871,70,76,1,1384,33,72,505,SG,20,74,159,MIN,.496
126,Monta Ellis,554,.470,1178,77,.338,228,340,24,25,210,631,.449,1406,292,.753,388,64,64,2647,47,189,1631,SG,143,244,257,GSW,.476
127,Francisco Elson,5,.333,15,0,,0,2,33,0,8,5,.333,15,2,.400,5,12,0,66,6,7,12,C,1,1,14,TOT,.333
128,Maurice Evans,118,.527,224,57,.337,169,48,31,17,95,175,.445,393,46,.754,61,79,5,1317,59,125,453,SF,34,20,154,ATL,.518
129,Reggie Evans,34,.493,69,0,,0,8,29,4,75,34,.493,69,27,.450,60,28,1,311,30,44,95,PF,14,22,105,TOR,.493
130,Tyreke Evans,497,.485,1024,36,.255,141,414,20,26,314,533,.458,1165,348,.748,465,72,72,2677,66,204,1450,SG,109,216,380,SAC,.473
131,Jordan Farmar,138,.483,286,86,.376,229,127,23,11,117,224,.435,515,57,.671,85,82,0,1474,14,109,591,PG,52,72,131,LAL,.518
132,Raymond Felton,328,.475,690,60,.385,156,446,25,22,235,388,.459,846,132,.763,173,80,80,2643,53,172,968,PG,123,168,288,CHA,.494
133,Rudy Fernandez,62,.395,157,98,.368,266,127,24,11,129,160,.378,423,85,.867,98,62,2,1441,35,87,503,SG,62,72,164,POR,.494
134,Kyrylo Fesenko,52,.553,94,0,.000,1,15,23,19,57,52,.547,95,24,.421,57,49,5,408,33,78,128,C,6,24,90,UTA,.547
135,Michael Finley,49,.480,102,32,.390,82,43,36,6,65,81,.440,184,8,.533,15,46,7,709,6,33,202,SF,10,21,71,TOT,.527
136,Derek Fisher,134,.401,334,78,.348,224,201,35,9,145,212,.380,558,113,.856,132,82,82,2227,25,202,615,PG,90,78,170,LAL,.450
137,Jonny Flynn,320,.434,737,77,.358,215,356,20,2,167,397,.417,952,223,.826,270,81,81,2339,24,98,1094,PG,82,233,191,MIN,.457
138,T.J. Ford,178,.484,368,8,.160,50,180,26,11,108,186,.445,418,104,.770,135,47,32,1189,41,102,484,PG,44,90,149,IND,.455
139,Jeff Foster,22,.489,45,0,.000,1,21,33,4,47,22,.478,46,5,.556,9,16,3,255,34,45,49,C,3,14,81,IND,.478
140,Randy Foye,193,.442,437,63,.346,182,228,26,10,114,256,.414,619,129,.890,145,70,38,1667,16,123,704,PG,33,94,130,WAS,.464
141,Channing Frye,145,.466,311,172,.439,392,113,26,74,361,317,.451,703,98,.810,121,81,41,2190,66,263,904,C,64,73,427,PHO,.573
142,Dan Gadzuric,39,.438,89,0,,0,12,31,13,54,39,.438,89,10,.400,25,32,6,314,38,63,88,C,9,15,92,MIL,.438
143,Sundiata Gaines,31,.554,56,7,.269,26,39,23,0,23,38,.463,82,23,.500,46,32,0,217,6,17,106,PG,12,14,29,UTA,.506
144,Danilo Gallinari,206,.469,439,186,.381,488,135,21,58,333,392,.423,927,251,.818,307,81,74,2747,65,191,1221,SF,75,110,398,NYK,.523
145,Francisco Garcia,59,.504,117,23,.390,59,45,28,19,55,82,.466,176,15,.882,17,25,4,575,11,49,202,SG,10,21,66,SAC,.531
146,Kevin Garnett,401,.523,767,1,.200,5,185,33,57,428,402,.521,772,185,.837,221,69,69,2060,78,170,990,PF,68,101,506,BOS,.521
147,Marc Gasol,378,.582,650,0,.000,1,165,25,109,432,378,.581,651,252,.670,376,69,69,2469,208,254,1008,C,69,135,640,MEM,.581
148,Pau Gasol,452,.539,839,0,.000,5,218,29,113,491,452,.536,844,286,.790,362,65,65,2403,243,152,1190,C,37,143,734,LAL,.536
149,Rudy Gay,534,.492,1086,66,.327,202,153,23,64,357,600,.466,1288,301,.753,400,80,80,3175,115,201,1567,SF,118,169,472,MEM,.491
150,Alonzo Gee,21,.420,50,7,.778,9,7,22,1,18,28,.475,59,18,.621,29,11,2,182,15,13,81,SG,7,10,33,WAS,.534
151,Devean George,41,.494,83,48,.390,123,32,32,10,93,89,.432,206,16,.696,23,45,4,761,21,89,242,SF,41,15,114,GSW,.549
152,Daniel Gibson,54,.454,119,71,.477,149,70,23,7,60,125,.466,268,34,.694,49,56,10,1068,13,79,355,PG,25,36,73,CLE,.599
153,Taj Gibson,311,.494,629,0,,0,70,24,104,385,311,.494,629,113,.646,175,82,70,2204,226,282,735,PF,50,114,611,CHI,.494
154,J.R. Giddens,28,.560,50,0,.000,10,13,24,2,35,28,.467,60,13,.565,23,32,1,239,16,29,69,SF,9,17,51,TOT,.467
155,Trey Gilder,1,1.000,1,0,,0,0,25,0,1,1,1.000,1,0,,0,2,0,5,0,0,2,SF,1,0,1,MEM,1.000
156,Manu Ginobili,266,.481,553,132,.377,350,370,32,24,216,398,.441,903,309,.870,355,75,21,2150,68,154,1237,SG,103,154,284,SAS,.514
157,Ryan Gomes,253,.475,533,74,.372,199,124,27,16,272,327,.447,732,104,.825,126,76,64,2210,76,155,832,SF,62,95,348,MIN,.497
158,Drew Gooden,287,.483,594,1,.125,8,47,28,58,335,288,.478,602,186,.861,216,70,33,1755,207,194,763,C-PF,41,108,542,TOT,.479
159,Ben Gordon,216,.465,465,75,.321,234,166,26,6,93,291,.416,699,198,.861,230,62,17,1730,26,147,855,SG,49,118,119,DET,.470
160,Eric Gordon,233,.503,463,119,.371,321,186,21,14,135,352,.449,784,222,.742,299,62,60,2229,25,96,1045,SG,69,144,160,LAC,.525
161,Marcin Gortat,121,.540,224,0,.000,3,17,25,70,237,121,.533,227,51,.680,75,81,0,1088,104,138,293,C,17,46,341,ORL,.533
162,Joey Graham,103,.545,189,2,.154,13,22,27,7,84,105,.520,202,54,.740,73,63,18,759,39,104,266,SF,23,43,123,DEN,.525
163,Stephen Graham,103,.542,190,16,.320,50,23,27,10,111,119,.496,240,42,.646,65,70,8,804,24,94,296,SG,20,36,135,CHA,.529
164,Danny Granger,330,.471,701,158,.361,438,171,26,51,275,488,.428,1139,363,.848,428,62,62,2278,67,183,1497,SF,94,157,342,IND,.498
165,Aaron Gray,42,.512,82,0,,0,22,25,11,61,42,.512,82,20,.714,28,32,0,311,45,54,104,C,9,18,106,TOT,.512
166,Danny Green,9,.529,17,6,.273,22,5,22,3,9,15,.385,39,4,.667,6,20,0,115,8,9,40,SG,6,5,17,CLE,.462
167,Jeff Green,381,.503,758,104,.333,312,134,23,72,378,485,.453,1070,165,.740,223,82,82,3043,112,221,1239,PF,104,135,490,OKC,.502
168,Willie Green,201,.494,407,47,.346,136,152,28,11,109,248,.457,543,95,.833,114,73,18,1553,20,135,638,SG,32,67,129,PHI,.500
169,Donte Greene,175,.473,370,69,.377,183,71,21,53,181,244,.441,553,90,.643,140,76,50,1630,53,150,647,SF,41,93,234,SAC,.504
170,Taylor Griffin,4,.500,8,0,.000,2,1,23,2,2,4,.400,10,2,.500,4,8,0,32,0,4,10,SF,0,1,2,PHO,.400
171,Hamed Haddadi,24,.407,59,0,.000,3,10,24,14,49,24,.387,62,14,.737,19,36,0,240,26,57,62,C,1,20,75,MEM,.387
172,Malik Hairston,38,.585,65,2,.182,11,16,22,9,36,40,.526,76,17,.567,30,47,0,317,13,29,99,SG,4,11,49,SAS,.539
173,Marcus Haislip,7,.438,16,3,.600,5,0,29,2,6,10,.476,21,2,.400,5,10,0,44,4,5,25,SF,0,3,10,SAS,.548
174,Richard Hamilton,252,.435,579,41,.297,138,202,31,3,92,293,.409,717,204,.846,241,46,46,1552,30,115,831,SG,30,115,122,DET,.437
175,Tyler Hansbrough,81,.367,221,0,.000,4,28,24,8,78,81,.360,225,84,.743,113,29,1,511,60,70,246,PF,17,21,138,IND,.360
176,James Harden,140,.424,330,93,.375,248,137,20,20,197,233,.403,578,194,.808,240,76,0,1738,47,200,753,SG,80,106,244,OKC,.484
177,Al Harrington,308,.496,621,140,.342,409,110,29,26,317,448,.435,1030,240,.757,317,72,15,2195,88,209,1276,PF,62,132,405,NYK,.503
178,Devin Harris,296,.444,667,60,.276,217,423,26,18,179,356,.403,884,308,.798,386,64,61,2221,24,178,1080,PG,79,181,203,NJN,.437
179,Mike Harris,11,.379,29,0,.000,1,3,26,1,14,11,.367,30,7,.636,11,13,0,96,10,14,29,PF,5,9,24,TOT,.367
180,Jason Hart,1,.500,2,0,,0,6,31,1,2,1,.500,2,0,,0,5,0,22,0,4,2,PG,2,3,2,TOT,.500
181,Udonis Haslem,312,.494,632,0,,0,52,29,23,462,312,.494,632,147,.762,193,78,0,2177,167,174,771,PF,30,75,629,MIA,.494
182,Trenton Hassell,90,.421,214,0,.000,5,50,30,9,96,90,.411,219,52,.754,69,52,31,1106,56,91,232,SF,17,47,152,NJN,.411
183,Spencer Hawes,286,.494,579,26,.299,87,158,21,83,291,312,.468,666,73,.689,106,72,59,1904,145,200,723,C,32,131,436,SAC,.488
184,Chuck Hayes,161,.489,329,0,,0,139,26,43,314,161,.489,329,36,.545,66,82,82,1773,151,219,358,C,73,74,465,HOU,.489
185,Jarvis Hayes,78,.523,149,60,.335,179,40,28,9,99,138,.421,328,14,.778,18,45,19,1033,9,91,350,SF,29,28,108,NJN,.512
186,Brendan Haywood,276,.563,490,0,.000,1,43,30,158,437,276,.562,491,152,.620,245,77,67,2355,278,209,704,C,26,99,715,TOT,.562
187,Luther Head,99,.481,206,37,.352,105,72,27,9,74,136,.437,311,48,.828,58,47,10,813,6,53,357,SG,18,54,80,IND,.497
188,Gerald Henderson,33,.388,85,4,.211,19,13,22,9,40,37,.356,104,35,.745,47,43,0,355,15,25,113,SG,10,14,55,CHA,.375
189,Roy Hibbert,384,.495,776,3,.500,6,158,23,131,287,387,.495,782,169,.754,224,81,69,2035,177,285,946,C,30,145,464,IND,.497
190,J.J. Hickson,289,.555,521,0,.000,1,40,21,39,290,289,.554,522,111,.681,163,81,73,1691,110,132,689,PF,36,92,400,CLE,.554
191,Nene Hilario,421,.589,715,0,.000,2,203,27,82,461,421,.587,717,293,.704,416,82,82,2755,166,281,1135,C,115,125,627,DEN,.587
192,George Hill,278,.505,550,75,.399,188,226,23,26,163,353,.478,738,183,.772,237,78,43,2276,42,222,964,PG,69,101,205,SAS,.529
193,Grant Hill,301,.483,623,35,.438,80,193,37,36,371,336,.478,703,205,.817,251,81,81,2430,74,165,912,SF,60,108,445,PHO,.503
194,Jordan Hill,99,.497,199,0,.000,2,20,22,21,99,99,.493,201,46,.676,68,47,0,624,76,92,244,PF,14,30,175,TOT,.493
195,Kirk Hinrich,204,.431,473,104,.371,280,330,29,24,236,308,.409,753,85,.752,113,74,53,2481,24,204,805,SG,85,113,260,CHI,.478
196,Jrue Holiday,168,.465,361,62,.390,159,280,19,18,135,230,.442,520,65,.756,86,73,51,1767,56,153,587,PG,79,156,191,PHI,.502
197,Ryan Hollins,169,.560,302,0,.000,1,51,25,38,128,169,.558,303,109,.690,158,73,27,1223,79,199,447,C,19,95,207,MIN,.558
198,Al Horford,466,.551,846,1,1.000,1,189,23,91,563,467,.551,847,213,.789,270,81,81,2845,236,225,1148,C,59,122,799,ATL,.552
199,Eddie House,94,.412,228,79,.348,227,85,31,7,96,173,.380,455,48,.923,52,68,0,1217,13,81,473,PG-SG,40,47,109,TOT,.467
200,Dwight Howard,510,.617,827,0,.000,7,144,24,228,798,510,.612,834,483,.592,816,82,82,2843,284,287,1503,C,75,274,1082,ORL,.612
201,Josh Howard,134,.444,302,23,.267,86,48,29,11,95,157,.405,388,109,.784,139,35,12,918,30,91,446,SF,26,46,125,TOT,.434
202,Juwan Howard,191,.511,374,0,.000,1,61,36,10,227,191,.509,375,55,.786,70,73,27,1632,108,191,437,C,27,72,335,POR,.509
203,Lester Hudson,16,.432,37,5,.313,16,13,25,3,11,21,.396,53,11,.846,13,25,0,131,7,12,58,PG,8,14,18,TOT,.443
204,Larry Hughes,94,.381,247,43,.309,139,137,31,15,119,137,.355,386,94,.832,113,45,16,1115,23,70,411,SG,52,75,142,TOT,.411
205,Kris Humphries,180,.442,407,0,.000,1,32,24,48,258,180,.441,408,127,.668,190,69,0,1221,120,145,487,PF,36,66,378,TOT,.441
206,Chris Hunter,109,.512,213,0,.000,4,37,25,35,111,109,.502,217,52,.754,69,60,9,783,56,132,270,C,13,30,167,GSW,.502
207,Lindsey Hunter,4,.235,17,1,.077,13,9,39,0,13,5,.167,30,2,1.000,2,13,0,122,1,12,13,PG,1,4,14,CHI,.183
208,Othello Hunter,4,.333,12,0,,0,0,23,1,6,4,.333,12,3,.750,4,7,0,33,6,5,11,SF,0,3,12,ATL,.333
209,Steven Hunter,17,.395,43,0,,0,0,28,10,24,17,.395,43,19,.528,36,21,0,158,18,10,53,C,1,9,42,MEM,.395
210,Serge Ibaka,200,.543,368,1,.500,2,10,20,97,259,201,.543,370,58,.630,92,73,0,1323,138,194,461,PF,25,68,397,OKC,.545
211,Andre Iguodala,402,.492,817,94,.310,303,472,26,55,447,496,.443,1120,315,.733,430,82,82,3193,82,145,1401,SF,141,218,529,PHI,.485
212,Zydrunas Ilgauskas,183,.441,415,11,.478,23,48,34,50,231,194,.443,438,75,.743,101,64,6,1339,114,183,474,C,14,63,345,CLE,.455
213,Didier Ilunga-Mbenga,48,.466,103,0,,0,8,29,29,55,48,.466,103,9,.474,19,49,2,355,32,54,105,C,5,15,87,LAL,.466
214,Ersan Ilyasova,242,.496,488,81,.336,241,84,22,23,360,323,.443,729,113,.715,158,81,31,1898,157,251,840,PF,53,71,517,MIL,.499
215,Allen Iverson*,127,.436,291,9,.360,25,113,34,2,63,136,.430,316,104,.794,131,28,24,865,16,48,385,SG-PG,19,64,79,TOT,.445
216,Royal Ivey,21,.438,48,14,.400,35,27,28,2,28,35,.422,83,9,.750,12,44,0,326,6,39,93,SG,19,11,34,TOT,.506
217,Jarrett Jack,241,.511,472,82,.412,199,413,26,6,192,323,.481,671,203,.842,241,82,43,2243,30,151,931,PG,60,163,222,TOR,.542
218,Cedric Jackson,5,.357,14,1,.167,6,14,23,2,6,6,.300,20,7,.583,12,12,0,74,2,7,20,PG,3,11,8,TOT,.325
219,Darnell Jackson,8,.308,26,1,.250,4,4,24,4,13,9,.300,30,4,.667,6,28,0,123,9,21,23,PF,2,13,22,TOT,.317
220,Stephen Jackson,471,.460,1025,129,.328,393,300,31,43,323,600,.423,1418,338,.779,434,81,81,3129,78,197,1667,SG-PF,132,259,401,TOT,.469
221,LeBron James,639,.560,1141,129,.333,387,651,25,77,483,768,.503,1528,593,.767,773,76,76,2966,71,119,2258,SF,125,261,554,CLE,.545
222,Mike James,4,.286,14,2,.333,6,5,34,0,2,6,.300,20,4,.500,8,4,0,46,1,3,18,PG,3,5,3,WAS,.350
223,Antawn Jamison,393,.498,789,85,.344,247,84,33,21,419,478,.461,1036,194,.647,300,66,64,2406,136,179,1235,PF,71,91,555,TOT,.502
224,Nathan Jawai,49,.445,110,0,.000,1,24,23,9,55,49,.441,111,26,.684,38,39,2,412,49,58,124,C,10,27,104,MIN,.441
225,Othyus Jeffers,12,.414,29,0,,0,1,24,0,11,12,.414,29,13,.684,19,14,0,73,8,10,37,SG,4,6,19,UTA,.414
226,Al Jefferson,560,.500,1121,0,.000,4,137,25,98,523,560,.498,1125,181,.680,266,76,76,2463,180,205,1301,C,63,136,703,MIN,.498
227,Richard Jefferson,303,.515,588,59,.316,187,158,29,40,298,362,.467,775,211,.735,287,81,70,2520,58,178,994,SF,45,105,356,SAS,.505
228,Jared Jeffries,117,.481,243,21,.296,71,101,28,71,158,138,.439,314,75,.625,120,70,37,1794,130,203,372,PF-SF,62,76,288,TOT,.473
229,Brandon Jennings,306,.370,828,145,.374,388,470,20,18,233,451,.371,1216,223,.817,273,82,82,2671,49,191,1270,PG,105,200,282,MIL,.431
230,Jonas Jerebko,254,.520,488,36,.313,115,58,22,29,284,290,.481,603,125,.710,176,80,73,2232,194,230,741,PF,79,82,478,DET,.511
231,Yi Jianlian,212,.406,522,15,.366,41,47,22,52,257,227,.403,563,154,.798,193,52,51,1655,115,170,623,PF,37,77,372,NJN,.417
232,Amir Johnson,208,.630,330,0,.000,4,48,22,66,241,208,.623,334,95,.638,149,82,5,1453,154,255,511,PF,44,63,395,TOR,.623
233,Anthony Johnson,36,.500,72,13,.333,39,63,35,1,40,49,.441,111,19,.950,20,31,0,406,8,32,130,PG,11,26,48,ORL,.500
234,James Johnson,80,.488,164,15,.326,46,48,22,43,94,95,.452,210,51,.729,70,65,11,757,34,126,256,PF,21,62,128,CHI,.488
235,Joe Johnson,506,.488,1036,129,.369,350,369,28,5,279,635,.458,1386,220,.818,269,76,76,2886,74,145,1619,SG,82,145,353,ATL,.505
236,Dahntay Jones,283,.479,591,4,.125,32,150,29,39,181,287,.461,623,198,.770,257,76,26,1892,48,237,776,SF,40,129,229,IND,.464
237,Dwayne Jones,0,,0,0,,0,0,26,0,2,0,,0,0,,0,2,0,7,0,1,0,PF,0,0,2,PHO,
238,James Jones,6,.207,29,37,.411,90,17,29,4,41,43,.361,119,23,.821,28,36,6,503,4,45,146,SF,11,11,45,MIA,.517
239,Solomon Jones,78,.451,173,0,.000,3,32,25,37,93,78,.443,176,51,.718,71,52,2,675,51,125,207,C,14,40,144,IND,.443
240,DeAndre Jordan,144,.610,236,0,.000,2,21,21,62,230,144,.605,238,48,.375,128,70,12,1137,122,152,336,C,16,75,352,LAC,.605
241,Chris Kaman,589,.492,1196,0,.000,6,120,27,94,520,589,.490,1202,230,.749,307,76,76,2608,184,213,1408,C,37,223,704,LAC,.490
242,Jason Kapono,63,.485,130,63,.368,171,39,28,6,52,126,.419,301,9,.600,15,57,12,976,14,80,324,SF,21,34,66,PHI,.523
243,Coby Karl,9,.429,21,2,.182,11,15,26,1,14,11,.344,32,4,.667,6,7,1,113,4,14,28,SF-SG,3,10,18,TOT,.375
244,Jason Kidd,108,.420,257,176,.425,414,724,36,35,397,284,.423,671,80,.808,99,80,80,2881,48,142,824,PG,145,195,445,DAL,.554
245,Andrei Kirilenko,218,.555,393,26,.292,89,158,28,71,188,244,.506,482,174,.744,234,58,35,1681,76,102,688,SF,83,79,264,UTA,.533
246,Kyle Korver,79,.465,170,59,.536,110,89,28,12,101,138,.493,280,39,.796,49,52,0,952,10,76,374,SG,26,42,111,UTA,.598
247,Kosta Koufos,22,.468,47,0,,0,6,20,4,29,22,.468,47,9,.600,15,36,0,172,16,26,53,C,2,15,45,UTA,.468
248,Nenad Krstic,280,.505,555,1,.200,5,52,26,45,249,281,.502,560,76,.717,106,76,76,1741,134,177,639,C,32,58,383,OKC,.503
249,Oliver Lafayette,2,.500,4,1,.500,2,2,25,0,3,3,.500,6,0,,0,1,0,22,1,0,7,SG,0,1,4,BOS,.583
250,Carl Landry,498,.537,928,1,.333,3,66,26,63,280,499,.536,931,344,.806,427,80,29,2469,188,234,1343,PF,55,136,468,TOT,.537
251,Marcus Landry,7,.467,15,9,.321,28,0,24,2,14,16,.372,43,3,.600,5,18,0,111,5,14,44,SF,1,6,19,TOT,.477
252,Acie Law,30,.508,59,5,.313,16,26,25,1,14,35,.467,75,38,.776,49,26,1,234,3,16,113,PG,11,17,17,TOT,.500
253,Ty Lawson,167,.544,307,34,.410,83,203,22,2,82,201,.515,390,106,.757,140,65,8,1318,42,89,542,PG,48,82,124,DEN,.559
254,Courtney Lee,262,.476,550,76,.338,225,121,24,20,192,338,.436,775,133,.869,153,71,66,2375,60,130,885,SG,93,76,252,NJN,.485
255,David Lee,686,.549,1250,0,.000,8,295,26,40,721,686,.545,1258,268,.812,330,81,81,3019,228,257,1640,C,85,189,949,NYK,.545
256,Rashard Lewis,182,.476,382,168,.397,423,107,30,28,256,350,.435,805,145,.806,180,72,72,2369,62,180,1013,PF,78,108,318,ORL,.539
257,Shaun Livingston,104,.533,195,0,.000,6,130,24,11,62,104,.517,201,42,.875,48,36,18,796,16,61,250,PG,17,58,78,TOT,.517
258,Brook Lopez,563,.500,1127,0,.000,2,187,21,139,439,563,.499,1129,416,.817,509,82,82,3027,270,251,1542,C,55,204,709,NJN,.499
259,Robin Lopez,171,.588,291,0,,0,7,21,53,144,171,.588,291,88,.704,125,51,31,986,104,117,430,C,10,41,248,PHO,.588
260,Kevin Love,256,.474,540,35,.330,106,136,21,23,431,291,.450,646,225,.815,276,60,22,1714,227,136,842,PF,43,117,658,MIN,.478
261,Kyle Lowry,147,.448,328,37,.272,136,305,23,9,156,184,.397,464,215,.827,260,68,0,1651,91,173,620,PG,60,116,247,HOU,.436
262,Corey Maggette,444,.531,836,13,.260,50,172,30,4,281,457,.516,886,460,.835,551,70,49,2081,92,231,1387,PF,51,168,373,GSW,.523
263,Jamaal Magloire,28,.500,56,0,,0,1,31,11,80,28,.500,56,21,.356,59,36,0,359,41,59,77,C,9,17,121,MIA,.500
264,Ian Mahinmi,35,.636,55,0,,0,2,23,8,39,35,.636,55,31,.660,47,26,0,165,13,32,101,C,3,15,52,SAS,.636
265,Shawn Marion,392,.516,759,3,.158,19,107,31,61,319,395,.508,778,105,.755,139,75,75,2385,158,141,898,SF,69,99,477,DAL,.510
266,Sean Marks,4,.500,8,0,,0,2,34,3,9,4,.500,8,2,.400,5,14,0,75,14,17,10,C,0,2,23,NOH,.500
267,Cartier Martin,33,.379,87,17,.347,49,16,25,1,43,50,.368,136,24,.800,30,18,2,390,25,48,141,SF,11,19,68,TOT,.430
268,Kenyon Martin,275,.465,591,8,.276,29,109,32,61,404,283,.456,620,93,.557,167,58,58,1986,142,186,667,PF,72,91,546,DEN,.463
269,Kevin Martin,219,.453,483,70,.333,210,111,26,6,135,289,.417,693,298,.876,340,46,43,1633,29,96,946,SG,46,92,164,TOT,.468
270,Desmond Mason,5,.417,12,0,,0,2,32,1,9,5,.417,12,3,.750,4,5,4,66,4,5,13,SF,1,4,13,SAC,.417
271,Roger Mason,105,.453,232,88,.333,264,137,29,14,151,193,.389,496,27,.794,34,79,5,1515,11,99,501,SG,30,59,162,SAS,.478
272,Wesley Matthews,210,.525,400,63,.382,165,124,23,15,141,273,.483,565,160,.829,193,82,48,2025,50,152,769,SG,64,93,191,UTA,.539
273,Jason Maxiell,212,.512,414,0,.000,1,39,26,38,240,212,.511,415,89,.574,155,76,29,1550,161,175,513,C,36,68,401,DET,.511
274,Sean May,51,.477,107,0,.000,4,17,25,7,50,51,.459,111,21,.656,32,37,4,331,20,46,123,C,12,19,70,SAC,.459
275,Eric Maynor,132,.444,297,22,.310,71,266,22,10,108,154,.418,368,52,.722,72,81,2,1269,21,115,382,PG,40,85,129,TOT,.448
276,O.J. Mayo,406,.490,828,136,.383,355,242,22,17,250,542,.458,1183,212,.809,262,82,82,3113,61,174,1432,SG,98,176,311,MEM,.516
277,Luc Mbah a Moute,171,.486,352,6,.353,17,81,23,39,229,177,.480,369,93,.699,133,73,62,1866,171,181,453,PF,60,70,400,MIL,.488
278,Antonio McDyess,205,.481,426,0,.000,2,83,35,32,306,205,.479,428,36,.632,57,77,50,1617,149,147,446,PF,43,79,455,SAS,.479
279,JaVale McGee,156,.510,306,0,.000,1,14,22,101,155,156,.508,307,74,.638,116,60,19,968,88,122,386,C,16,51,243,WAS,.508
280,Tracy McGrady*,75,.439,171,16,.250,64,99,30,14,72,91,.387,235,47,.746,63,30,24,673,22,40,245,SG,15,44,94,TOT,.421
281,Dominic McGuire,19,.365,52,0,,0,11,24,4,56,19,.365,52,0,.000,7,51,2,307,23,35,38,SF,5,17,79,TOT,.365
282,Josh McRoberts,68,.553,123,8,.348,23,44,22,16,87,76,.521,146,19,.500,38,42,3,524,40,74,179,C,17,19,127,IND,.548
283,Jodie Meeks,62,.456,136,42,.318,132,39,22,5,90,104,.388,268,31,.795,39,60,0,719,9,52,281,SG,18,25,99,TOT,.466
284,Pops Mensah-Bonsu,13,.394,33,0,,0,3,26,9,19,13,.394,33,13,.542,24,20,0,120,16,20,39,PF,4,10,35,TOT,.394
285,C.J. Miles,167,.484,345,74,.341,217,105,22,17,126,241,.429,562,66,.695,95,63,28,1497,42,190,622,SF,58,81,168,UTA,.495
286,Darko Milicic,100,.493,203,0,.000,1,47,24,34,104,100,.490,204,15,.536,28,32,18,685,47,82,215,C,22,35,151,TOT,.490
287,Andre Miller,388,.469,828,16,.200,80,445,33,9,185,404,.445,908,322,.821,392,82,66,2500,81,169,1146,PG,93,173,266,POR,.454
288,Brad Miller,213,.474,449,37,.280,132,154,33,29,316,250,.430,581,182,.827,220,82,37,1950,83,189,719,C,44,107,399,CHI,.462
289,Mike Miller,135,.515,262,82,.480,171,212,29,12,281,217,.501,433,70,.824,85,54,50,1805,55,131,586,SG,39,115,336,WAS,.596
290,Patty Mills,8,.400,20,2,.500,4,5,21,0,1,10,.417,24,4,.571,7,10,0,38,1,6,26,PG,0,4,2,POR,.458
291,Paul Millsap,384,.543,707,1,.111,9,131,24,99,373,385,.538,716,183,.693,264,82,8,2277,186,285,954,PF,64,116,559,UTA,.538
292,Nazr Mohammed,189,.553,342,0,,0,28,32,43,190,189,.553,342,81,.648,125,58,29,984,114,105,459,C,15,53,304,CHA,.553
293,Jamario Moon,82,.558,147,32,.320,100,49,29,30,165,114,.462,247,36,.800,45,61,2,1052,26,69,296,SF,34,23,191,CLE,.526
294,Mikki Moore,54,.600,90,0,,0,36,34,13,43,54,.600,90,7,.636,11,23,20,406,26,60,115,C,5,21,69,GSW,.600
295,Randolph Morris,23,.561,41,0,,0,2,24,3,28,23,.561,41,16,.593,27,28,0,124,10,34,62,PF,5,12,38,ATL,.561
296,Adam Morrison,27,.422,64,5,.238,21,18,25,2,22,32,.376,85,5,.625,8,31,0,241,10,17,74,SF,3,10,32,LAL,.406
297,Anthony Morrow,189,.477,396,140,.456,307,104,24,16,198,329,.468,703,101,.886,114,69,37,2018,61,158,899,SG,65,84,259,GSW,.568
298,Byron Mullens,7,.368,19,0,,0,1,20,0,7,7,.368,19,0,,0,13,0,54,3,13,14,PF,2,4,10,OKC,.368
299,Troy Murphy,256,.533,480,128,.384,333,150,29,34,608,384,.472,813,154,.798,193,72,69,2344,129,175,1050,PF,72,100,737,IND,.551
300,Ronald Murray,199,.431,462,69,.312,221,135,30,16,155,268,.392,683,141,.727,194,75,2,1673,28,126,746,SG,46,91,183,TOT,.443
301,Eduardo Najera,43,.524,82,19,.297,64,29,33,14,81,62,.425,146,14,.583,24,46,5,685,34,94,157,PF,26,25,115,TOT,.490
302,Steve Nash,375,.540,694,124,.426,291,892,35,12,234,499,.507,985,211,.938,225,81,81,2660,34,108,1333,PG,42,295,268,PHO,.570
303,Jameer Nelson,231,.481,480,86,.381,226,353,27,2,168,317,.449,706,98,.845,116,65,64,1860,26,147,818,PG,48,139,194,ORL,.510
304,Rasho Nesterovic,81,.544,149,0,,0,25,33,17,52,81,.544,149,1,.200,5,42,8,413,37,54,163,C,10,16,89,TOR,.544
305,Joakim Noah,262,.504,520,0,,0,132,24,100,484,262,.504,520,163,.744,219,64,54,1925,220,198,687,C,32,117,704,CHI,.504
306,Andres Nocioni,138,.408,338,96,.386,249,75,30,26,190,234,.399,587,71,.717,99,75,28,1477,32,160,635,SF,32,67,222,SAC,.480
307,Steve Novak,20,.541,37,22,.310,71,6,26,2,32,42,.389,108,7,.778,9,54,0,362,1,21,113,SF,7,2,33,LAC,.491
308,Dirk Nowitzki,669,.487,1375,51,.421,121,218,31,79,540,720,.481,1496,536,.915,586,81,80,3039,80,208,2027,PF,70,149,620,DAL,.498
309,Patrick O'Bryant,8,.571,14,0,.000,1,1,23,4,9,8,.533,15,3,.500,6,11,0,51,2,12,19,C,2,5,11,TOR,.533
310,Jermaine O'Neal,394,.530,743,0,.000,2,92,31,95,362,394,.529,745,162,.720,225,70,70,1991,124,212,950,C,25,125,486,MIA,.529
311,Shaquille O'Neal*,262,.567,462,0,.000,1,80,37,62,262,262,.566,463,112,.496,226,53,53,1240,93,169,636,C,15,105,355,CLE,.566
312,Fabricio Oberto,35,.625,56,0,,0,51,34,9,71,35,.625,56,13,.765,17,57,20,650,34,121,83,C,11,36,105,WAS,.625
313,Greg Oden,92,.605,152,0,,0,19,22,48,114,92,.605,152,49,.766,64,21,21,502,64,84,233,C,8,39,178,POR,.605
314,Lamar Odom,284,.510,557,58,.319,182,267,30,59,618,342,.463,739,140,.693,202,82,38,2585,184,227,882,PF,75,150,802,LAL,.502
315,Emeka Okafor,348,.530,656,0,,0,55,27,127,491,348,.530,656,154,.562,274,82,82,2370,251,218,850,C,54,111,742,NOH,.530
316,Mehmet Okur,273,.486,562,82,.385,213,119,30,81,383,355,.458,775,196,.820,239,73,73,2149,132,223,988,C,38,127,515,UTA,.511
317,Kevin Ollie,18,.409,44,0,.000,1,20,37,0,22,18,.400,45,8,1.000,8,25,0,263,3,16,44,PG,9,6,25,OKC,.400
318,Travis Outlaw,70,.398,176,40,.381,105,34,25,17,88,110,.391,281,49,.831,59,34,6,730,33,43,309,SF,18,32,121,TOT,.463
319,Zaza Pachulia,120,.496,242,0,.000,4,42,25,31,176,120,.488,246,93,.650,143,78,1,1089,117,186,333,C,37,58,293,ATL,.488
320,Jannero Pargo,94,.387,243,38,.275,138,89,30,2,69,132,.346,381,42,.933,45,63,5,829,9,68,344,PG,29,50,78,CHI,.396
321,Anthony Parker,98,.458,214,108,.414,261,157,34,18,201,206,.434,475,75,.789,95,81,81,2289,30,151,595,SG,63,71,231,CLE,.547
322,Tony Parker,339,.497,682,10,.294,34,317,27,8,128,349,.487,716,186,.756,246,56,50,1728,7,96,894,PG,29,149,135,SAS,.494
323,Chris Paul,262,.514,510,52,.409,127,480,24,8,171,314,.493,637,161,.847,190,45,45,1712,20,118,841,PG,96,112,191,NOH,.534
324,Sasha Pavlovic,74,.407,182,35,.297,118,58,26,6,105,109,.363,300,10,.385,26,71,0,877,12,84,263,SF,23,53,117,MIN,.422
325,Oleksiy Pecherov,63,.463,136,14,.269,52,11,24,14,92,77,.410,188,29,.906,32,44,5,447,32,55,197,C,9,32,124,MIN,.447
326,Kendrick Perkins,314,.605,519,0,.000,3,80,25,132,440,314,.602,522,163,.582,280,78,78,2154,155,219,791,C,26,165,595,BOS,.602
327,Morris Peterson,54,.415,130,62,.363,171,41,32,5,109,116,.385,301,33,.611,54,46,39,973,17,81,327,SG,25,27,126,NOH,.488
328,Johan Petro,54,.540,100,0,.000,1,14,24,13,97,54,.535,101,14,.667,21,36,16,436,32,80,122,C,10,23,129,DEN,.535
329,Paul Pierce,300,.497,604,109,.414,263,218,32,31,271,409,.472,867,369,.852,433,71,71,2411,39,196,1296,SF,84,166,310,BOS,.535
330,Mickael Pietrus,117,.502,233,116,.379,306,49,27,31,176,233,.432,539,69,.633,109,75,24,1687,39,138,651,SF,53,69,215,ORL,.540
331,James Posey,45,.437,103,81,.335,242,117,33,19,297,126,.365,345,66,.825,80,77,2,1731,32,204,399,SF,42,51,329,NOH,.483
332,Leon Powe,21,.429,49,0,,0,0,26,2,42,21,.429,49,37,.587,63,20,2,236,19,36,79,SF,6,11,61,CLE,.429
333,Josh Powell,64,.360,178,7,.438,16,35,27,6,72,71,.366,194,20,.645,31,63,0,581,44,71,169,PF,9,33,116,LAL,.384
334,A.J. Price,85,.472,180,60,.345,174,106,23,3,76,145,.410,354,60,.800,75,56,2,865,12,53,410,PG,35,59,88,IND,.494
335,Ronnie Price,80,.447,179,18,.286,63,123,26,13,46,98,.405,242,41,.695,59,60,4,806,28,109,255,PG,40,56,74,UTA,.442
336,Tayshaun Prince,255,.503,507,27,.370,73,161,29,22,177,282,.486,580,70,.714,98,49,49,1664,71,77,661,SF,34,60,248,DET,.509
337,Joel Przybilla,45,.523,86,0,,0,8,30,43,166,45,.523,86,33,.647,51,30,9,681,72,95,123,C,8,39,238,POR,.523
338,Chris Quinn,10,.417,24,10,.313,32,29,26,1,15,20,.357,56,6,1.000,6,25,0,223,1,15,56,PG,9,10,16,NJN,.446
339,Vladimir Radmanovic,73,.442,165,30,.278,108,45,29,7,127,103,.377,273,20,.741,27,41,20,891,51,97,256,PF,29,44,178,TOT,.432
340,Anthony Randolph,136,.447,304,1,.200,5,42,20,51,142,137,.443,309,109,.801,136,33,8,749,73,92,384,C,28,49,215,GSW,.445
341,Shavlik Randolph,6,.333,18,0,,0,1,26,1,7,6,.333,18,2,1.000,2,6,0,53,7,9,14,PF,1,3,14,TOT,.333
342,Zach Randolph,637,.496,1284,15,.288,52,149,28,34,620,652,.488,1336,362,.778,465,81,81,3051,330,226,1681,PF,80,174,950,MEM,.494
343,Theo Ratliff,70,.461,152,0,,0,25,36,61,98,70,.461,152,38,.760,50,49,29,807,59,87,178,C,12,41,157,TOT,.461
344,Michael Redd,57,.373,153,18,.300,60,39,30,2,43,75,.352,213,47,.712,66,18,12,492,11,24,215,SG,19,15,54,MIL,.394
345,J.J. Redick,132,.473,279,111,.405,274,158,25,4,138,243,.439,553,191,.860,222,82,9,1808,17,118,788,SG,28,63,155,ORL,.540
346,Chris Richard,15,.517,29,0,,0,7,25,4,40,15,.517,29,7,.636,11,18,0,224,19,50,37,PF,8,14,59,CHI,.517
347,Jason Richardson,316,.528,598,157,.393,400,143,29,33,323,473,.474,998,136,.739,184,79,76,2485,81,169,1239,SG,66,92,404,PHO,.553
348,Quentin Richardson,100,.493,203,142,.397,358,93,29,18,310,242,.431,561,52,.732,71,76,75,2082,64,169,678,SF,70,62,374,MIA,.558
349,Luke Ridnour,259,.513,505,69,.381,181,324,28,7,119,328,.478,686,127,.907,140,82,0,1759,24,182,852,PG,54,106,143,MIL,.528
350,Nate Robinson,128,.474,270,87,.390,223,163,25,5,82,215,.436,493,50,.746,67,56,2,1115,28,116,567,PG,49,73,110,TOT,.524
351,Sergio Rodriguez,135,.519,260,32,.352,91,212,23,5,65,167,.476,351,68,.731,93,66,8,1048,24,84,434,PG,50,114,89,TOT,.521
352,Rajon Rondo,442,.536,824,17,.213,80,794,23,11,260,459,.508,904,175,.621,282,81,81,2963,100,198,1110,PG,189,246,360,BOS,.517
353,Derrick Rose,656,.500,1313,16,.267,60,469,21,27,228,672,.489,1373,259,.766,338,78,78,2871,65,96,1619,PG,57,217,293,CHI,.495
354,Quinton Ross,36,.400,90,4,.190,21,12,28,6,32,40,.360,111,8,.571,14,52,7,562,17,69,92,SF-SG,13,11,49,TOT,.378
355,Brandon Roy,418,.512,817,73,.330,221,305,25,16,212,491,.473,1038,343,.780,440,65,65,2419,73,136,1398,SG,61,129,285,POR,.508
356,Brandon Rush,173,.433,400,124,.411,302,112,24,65,305,297,.423,702,56,.629,89,82,64,2491,41,159,774,SG,56,93,346,IND,.511
357,Kareem Rush,3,.375,8,1,.333,3,4,29,3,5,4,.364,11,0,,0,7,0,58,1,8,9,SG,2,3,6,LAC,.409
358,John Salmons,319,.468,682,118,.382,309,223,30,26,235,437,.441,991,253,.830,305,81,56,2824,35,166,1245,SG,99,123,270,TOT,.501
359,Brian Scalabrine,13,.361,36,16,.327,49,27,31,4,39,29,.341,85,4,.667,6,52,3,472,9,59,78,PF,9,17,48,BOS,.435
360,Luis Scola,559,.515,1085,1,.200,5,169,29,26,530,560,.514,1090,208,.779,267,82,82,2671,175,246,1329,PF,63,163,705,HOU,.514
361,Thabo Sefolosha,153,.494,310,41,.313,131,145,25,46,311,194,.440,441,60,.674,89,82,82,2348,76,154,489,SG,97,90,387,OKC,.486
362,Ramon Sessions,252,.467,540,1,.067,15,258,23,5,156,253,.456,555,167,.717,233,82,1,1732,58,137,674,PG,55,137,214,MIN,.457
363,Bobby Simmons,22,.407,54,20,.317,63,15,29,3,52,42,.359,117,18,.900,20,23,2,395,11,52,122,PF,15,19,63,NJN,.444
364,James Singleton,90,.415,217,7,.189,37,31,28,43,168,97,.382,254,53,.855,62,57,3,977,108,113,254,PF-SF,28,49,276,TOT,.396
365,Brian Skinner,10,.400,25,0,,0,0,33,4,18,10,.400,25,6,.750,8,16,1,123,9,20,26,PF,3,7,27,LAC,.400
366,Craig Smith,225,.574,392,1,.200,5,84,26,25,190,226,.569,397,132,.635,208,75,2,1232,97,194,585,PF,33,88,287,LAC,.571
367,J.R. Smith,270,.477,566,158,.338,467,183,24,20,206,428,.414,1033,142,.706,201,75,0,2082,28,174,1156,SG,99,139,234,DEN,.491
368,Jason Smith,65,.448,145,10,.345,29,33,23,28,81,75,.431,174,29,.690,42,56,2,658,54,110,189,PF,21,35,135,PHI,.460
369,Joe Smith,76,.409,186,1,.143,7,21,34,19,91,77,.399,193,39,.813,48,64,1,592,66,95,194,PF,6,22,157,ATL,.402
370,Josh Smith,504,.508,992,0,.000,7,342,24,172,482,504,.505,999,261,.618,422,81,81,2871,223,240,1269,PF,130,198,705,ATL,.505
371,Darius Songaila,240,.498,482,1,.167,6,70,31,14,173,241,.494,488,60,.811,74,75,1,1410,59,206,543,C,62,81,232,NOH,.495
372,Marreese Speights,212,.483,439,0,.000,5,36,22,34,167,212,.477,444,108,.745,145,62,1,1016,85,152,532,C,29,51,252,PHI,.477
373,Jerry Stackhouse,84,.452,186,45,.346,130,70,35,9,81,129,.408,316,55,.797,69,42,0,855,19,56,358,SG,21,66,100,MIL,.479
374,DeShawn Stevenson,27,.355,76,19,.218,87,56,28,6,80,46,.282,163,25,.714,35,64,18,883,11,74,136,SG,16,30,91,TOT,.340
375,Peja Stojakovic,146,.435,336,132,.375,352,92,32,5,188,278,.404,688,96,.897,107,62,55,1947,39,83,784,SF,48,56,227,NOH,.500
376,Amar'e Stoudemire,703,.559,1258,1,.167,6,82,27,83,502,704,.557,1264,487,.771,632,82,82,2838,230,281,1896,PF,52,213,732,PHO,.557
377,Rodney Stuckey,431,.418,1030,18,.228,79,348,23,12,214,449,.405,1109,299,.833,359,73,67,2499,67,205,1215,PG,101,163,281,DET,.413
378,DaJuan Summers,31,.352,88,15,.357,42,16,22,7,31,46,.354,130,27,.711,38,44,0,405,14,52,134,SF,8,16,45,DET,.412
379,Jermaine Taylor,40,.412,97,5,.227,22,16,23,3,25,45,.378,119,33,.717,46,31,4,303,21,15,128,SG,10,19,46,HOU,.399
380,Jeff Teague,83,.426,195,7,.219,32,122,21,11,62,90,.396,227,41,.837,49,71,3,719,5,82,228,PG,34,50,67,ATL,.412
381,Sebastian Telfair,70,.483,145,13,.232,56,126,24,5,40,83,.413,201,29,.784,37,43,1,659,5,71,208,PG,24,50,45,TOT,.445
382,Garrett Temple,31,.484,64,13,.351,37,21,23,6,25,44,.436,101,35,.700,50,27,4,334,6,42,136,SG,13,27,31,TOT,.500
383,Jason Terry,320,.479,668,136,.365,373,292,32,17,121,456,.438,1041,232,.866,268,77,12,2540,19,142,1280,SG,94,109,140,DAL,.503
384,Hasheem Thabeet,77,.588,131,0,,0,11,22,89,158,77,.588,131,54,.581,93,68,13,883,85,162,208,C,15,43,243,MEM,.588
385,Etan Thomas,31,.456,68,0,,0,1,31,16,46,31,.456,68,13,.591,22,23,1,321,18,39,75,C,4,18,64,OKC,.456
386,Kenny Thomas,17,.486,35,0,,0,15,32,10,51,17,.486,35,7,.583,12,26,2,313,35,42,41,PF,10,17,86,SAC,.486
387,Kurt Thomas,99,.476,208,0,,0,47,37,46,207,99,.476,208,12,.800,15,70,9,1049,84,159,210,C,26,48,291,MIL,.476
388,Tim Thomas,33,.524,63,16,.372,43,14,32,2,28,49,.462,106,21,.875,24,18,1,285,13,31,135,SF,10,14,41,DAL,.538
389,Tyrus Thomas,194,.465,417,0,.000,3,56,23,85,254,194,.462,420,120,.686,175,54,3,1220,81,129,508,PF-C,63,92,335,TOT,.462
390,Jason Thompson,369,.477,774,1,.100,10,124,23,73,413,370,.472,784,198,.715,277,75,58,2357,224,279,939,C,41,139,637,SAC,.473
391,Al Thornton,309,.479,645,11,.355,31,90,26,35,178,320,.473,676,153,.725,211,75,46,2079,116,206,804,SF,45,102,294,TOT,.482
392,Marcus Thornton,281,.493,570,117,.374,313,114,22,11,139,398,.451,883,144,.814,177,73,17,1872,72,127,1057,SG,58,76,211,NOH,.517
393,Jamaal Tinsley,45,.446,101,7,.179,39,108,31,5,55,52,.371,140,22,.815,27,38,1,589,11,67,133,PG,33,63,66,MEM,.396
394,Anthony Tolliver,143,.481,297,50,.329,152,87,24,33,236,193,.430,449,103,.769,134,46,29,1427,84,128,539,PF,32,46,320,TOT,.486
395,Alando Tucker,16,.500,32,1,.143,7,4,25,0,4,17,.436,39,16,.762,21,15,0,96,6,6,51,SF,0,5,10,TOT,.449
396,Ronny Turiaf,85,.586,145,0,.000,1,90,27,54,137,85,.582,146,37,.474,78,42,20,872,54,98,207,C,23,49,191,GSW,.582
397,Hedo Turkoglu,168,.436,385,108,.374,289,304,30,32,301,276,.409,674,175,.774,226,74,69,2272,42,220,835,SF,55,125,343,TOR,.490
398,Ime Udoka,65,.433,150,26,.286,91,58,32,6,140,91,.378,241,42,.737,57,69,2,944,51,83,250,SG,34,42,191,SAC,.432
399,Beno Udrih,340,.530,642,75,.377,199,372,27,10,181,415,.493,841,118,.837,141,79,41,2477,38,166,1023,PG,89,136,219,SAC,.538
400,Roko Ukic,11,.611,18,3,.250,12,12,25,0,3,14,.467,30,9,.818,11,13,0,97,0,6,40,PG,1,6,3,MIL,.517
401,Anderson Varejao,266,.576,462,1,.200,5,87,27,67,389,267,.572,467,116,.663,175,76,7,2166,189,223,651,PF,71,67,578,CLE,.573
402,Charlie Villanueva,264,.484,545,99,.351,282,53,25,55,280,363,.439,827,106,.815,130,78,16,1848,85,223,931,PF,48,74,365,DET,.499
403,Sasha Vujacic,41,.494,83,25,.309,81,41,25,4,54,66,.402,164,28,.848,33,67,1,575,25,67,185,SG,20,17,79,LAL,.479
404,Dwyane Wade,646,.509,1268,73,.300,243,501,28,82,266,719,.476,1511,534,.761,702,77,77,2792,107,181,2045,SG,142,252,373,MIA,.500
405,Henry Walker,70,.603,116,50,.431,116,40,22,3,73,120,.517,232,39,.796,49,35,13,768,15,83,329,SG-SF,23,28,88,TOT,.625
406,Ben Wallace,158,.545,290,0,.000,2,105,35,84,352,158,.541,292,65,.406,160,69,67,1975,245,131,381,C,86,64,597,DET,.541
407,Gerald Wallace,404,.503,803,52,.371,140,161,27,83,612,456,.484,943,422,.776,544,76,76,3119,150,194,1386,SF,117,178,762,CHA,.511
408,Rasheed Wallace,184,.511,360,82,.283,290,80,35,70,283,266,.409,650,96,.768,125,79,13,1780,42,222,710,C,80,63,325,BOS,.472
409,Luke Walton,23,.343,67,7,.412,17,40,29,1,26,30,.357,84,2,.500,4,29,0,272,12,19,69,SF,10,12,38,LAL,.399
410,Hakim Warrick,264,.486,543,1,.143,7,52,27,18,187,265,.482,550,202,.737,274,76,6,1557,127,126,733,PF,24,80,314,TOT,.483
411,C.J. Watson,202,.527,383,45,.310,145,180,25,8,141,247,.468,528,128,.771,166,65,15,1788,28,124,667,PG,103,69,169,GSW,.510
412,Earl Watson,170,.500,340,53,.288,184,399,30,16,186,223,.426,524,120,.710,169,79,52,2322,54,181,619,PG,104,175,240,IND,.476
413,Kyle Weaver,5,.357,14,7,.368,19,11,23,6,17,12,.364,33,5,.833,6,12,0,144,1,13,36,SG,6,4,18,OKC,.470
414,Martell Webster,135,.440,307,124,.373,332,62,23,40,221,259,.405,639,126,.813,155,82,49,2005,47,153,768,SF,45,60,268,POR,.502
415,Sonny Weems,234,.528,443,2,.133,15,101,23,25,150,236,.515,458,44,.688,64,69,19,1368,42,126,518,SG,39,65,192,TOR,.517
416,David West,612,.510,1199,7,.259,27,239,29,60,441,619,.505,1226,296,.865,342,81,81,2949,164,233,1541,PF,76,173,605,NOH,.508
417,Delonte West,169,.471,359,25,.325,77,196,26,28,140,194,.445,436,115,.810,142,60,3,1500,29,86,528,SG,55,90,169,CLE,.474
418,Mario West,12,.600,20,0,.000,1,9,25,0,19,12,.571,21,6,.600,10,39,1,142,8,25,30,SG,8,7,27,ATL,.571
419,Russell Westbrook,462,.438,1056,23,.221,104,652,21,34,258,485,.418,1160,329,.780,422,82,82,2813,143,204,1322,PG,108,268,401,OKC,.428
420,D.J. White,25,.610,41,0,,0,4,23,3,13,25,.610,41,9,.900,10,12,0,102,10,12,59,PF,5,3,23,OKC,.610
421,Chris Wilcox,63,.525,120,0,,0,13,27,12,73,63,.525,120,26,.500,52,34,10,441,44,64,152,PF,13,38,117,DET,.525
422,Damien Wilkins,147,.459,320,18,.295,61,135,30,25,177,165,.433,381,103,.798,129,80,31,1585,72,144,451,SF,66,76,249,MIN,.457
423,Mike Wilks,4,.444,9,2,.667,3,4,30,0,3,6,.500,12,2,.500,4,4,0,59,1,5,16,PG,0,4,4,OKC,.583
424,Deron Williams,398,.501,794,96,.371,259,798,25,16,253,494,.469,1053,335,.801,418,76,76,2802,50,208,1419,PG,96,252,303,UTA,.515
425,Jason Williams,105,.512,205,84,.380,221,298,34,3,119,189,.444,426,31,.756,41,82,18,1703,7,65,493,PG,53,87,126,ORL,.542
426,Jawad Williams,51,.451,113,30,.323,93,34,26,5,67,81,.393,206,32,.711,45,54,6,742,16,73,224,PG,12,18,83,CLE,.466
427,Lou Williams,248,.527,471,70,.340,206,268,23,15,162,318,.470,677,192,.824,233,64,38,1912,25,110,898,PG,80,106,187,PHI,.521
428,Marcus Williams,80,.421,190,24,.296,81,161,24,1,80,104,.384,271,37,.673,55,62,1,872,13,43,269,PG,32,74,93,MEM,.428
429,Marvin Williams,262,.492,532,40,.303,132,93,23,46,310,302,.455,664,176,.819,215,81,81,2468,106,160,820,SF,66,72,416,ATL,.485
430,Mo Williams,219,.452,484,159,.429,371,368,27,21,178,378,.442,855,177,.894,198,69,68,2359,28,170,1092,PG,70,173,206,CLE,.535
431,Reggie Williams,107,.560,191,33,.359,92,66,23,6,92,140,.495,283,52,.839,62,24,10,782,18,49,365,SF,23,29,110,GSW,.553
432,Sean Williams,21,.438,48,0,.000,1,1,23,19,25,21,.429,49,10,.526,19,20,0,227,21,41,52,PF,8,20,46,NJN,.429
433,Shelden Williams,63,.525,120,0,.000,1,21,26,21,99,63,.521,121,75,.765,98,54,0,597,47,85,201,PF,13,30,146,BOS,.521
434,Terrence Williams,230,.417,551,31,.310,100,223,22,10,302,261,.401,651,103,.715,144,78,9,1764,46,126,656,SF,43,124,348,NJN,.425
435,Metta World Peace,201,.453,444,105,.355,296,234,30,21,232,306,.414,740,128,.688,186,77,77,2605,99,165,845,SF,106,121,331,LAL,.484
436,Antoine Wright,104,.460,226,58,.335,173,71,25,11,152,162,.406,399,53,.688,77,67,10,1392,38,134,435,SF,30,58,190,TOR,.479
437,Dorell Wright,133,.508,262,61,.389,157,91,24,32,185,194,.463,419,61,.884,69,72,1,1496,50,94,510,SF,52,53,235,MIA,.536
438,Julian Wright,114,.504,226,2,.333,6,41,22,18,86,116,.500,232,25,.610,41,68,14,871,58,45,259,SF,29,44,144,NOH,.504
439,Nick Young,164,.423,388,69,.406,170,48,24,8,82,233,.418,558,104,.800,130,74,23,1421,20,147,639,SG,28,56,102,WAS,.479
440,Sam Young,213,.483,441,11,.196,56,52,24,20,124,224,.451,497,136,.777,175,80,1,1321,77,106,595,SF,34,94,201,MEM,.462
441,Thaddeus Young,334,.495,675,48,.348,138,97,21,15,220,382,.470,813,114,.691,165,67,45,2145,130,133,926,PF,81,126,350,PHI,.499
