,Player_Name,2P,2P%,2PA,3P,3P%,3PA,AST,Age,BLK,DRB,FG,FG%,FGA,FT,FT%,FTA,Games,Games_Strated,Minutes_Played,ORB,PF,PTS,Position,STL,TOV,TRB,Team,eFG%
0,Jeff Adrien,23,.426,54,0,,0,10,24,5,35,23,.426,54,11,.579,19,23,0,196,23,28,57,PF,4,9,58,GSW,.426
1,Arron Afflalo,207,.546,379,105,.423,248,168,25,31,206,312,.498,627,138,.847,163,69,69,2324,45,153,867,SG,34,71,251,DEN,.581
2,Maurice Ager,3,.429,7,3,.750,4,1,26,0,2,6,.545,11,0,,0,4,0,29,0,4,15,SG,1,4,2,MIN,.682
3,Alexis Ajinca,47,.475,99,12,.353,34,10,22,19,61,59,.444,133,13,.722,18,34,2,340,17,73,143,C,11,18,78,TOT,.489
4,Solomon Alabi,3,.200,15,0,,0,2,22,2,7,3,.200,15,0,.000,2,12,0,59,7,5,6,C,2,3,14,TOR,.200
5,Cole Aldrich,8,.533,15,0,,0,4,22,7,22,8,.533,15,2,.500,4,18,0,142,13,30,18,C,5,8,35,OKC,.533
6,LaMarcus Aldridge,703,.505,1392,4,.174,23,170,25,94,431,707,.500,1415,351,.791,444,81,81,3211,278,220,1769,PF,82,153,709,POR,.501
7,Malik Allen,11,.355,31,0,,0,4,32,4,20,11,.355,31,1,.500,2,18,0,178,12,30,23,PF,1,3,32,ORL,.355
8,Ray Allen,312,.520,600,168,.444,378,219,35,16,223,480,.491,978,193,.881,219,80,80,2890,51,147,1321,SG,77,117,274,BOS,.577
9,Tony Allen,247,.527,469,4,.174,23,104,29,44,123,251,.510,492,137,.753,182,72,31,1494,70,161,643,SG,129,86,193,MEM,.514
10,Al-Farouq Aminu,115,.437,263,45,.315,143,60,20,25,192,160,.394,406,92,.773,119,81,14,1452,75,121,457,SF,59,103,267,LAC,.450
11,Lou Amundson,83,.454,183,0,,0,17,28,33,104,83,.454,183,34,.391,87,46,7,691,81,87,200,PF,14,24,185,GSW,.454
12,Chris Andersen,82,.603,136,0,.000,1,20,32,58,144,82,.599,137,86,.637,135,45,0,732,75,79,250,C,23,25,219,DEN,.599
13,David Andersen,48,.490,98,8,.348,23,13,30,9,64,56,.463,121,14,.636,22,40,0,373,20,40,134,PF,5,22,84,TOT,.496
14,James Anderson,13,.371,35,18,.391,46,18,21,6,21,31,.383,81,14,.778,18,26,2,286,2,24,94,SF,3,13,23,SAS,.494
15,Ryan Anderson,92,.500,184,134,.393,341,52,22,38,226,226,.430,525,95,.812,117,64,14,1424,129,137,681,PF,30,49,355,ORL,.558
16,Carmelo Anthony,589,.470,1252,95,.378,251,221,26,46,445,684,.455,1503,507,.838,605,77,77,2751,118,224,1970,SF,68,206,563,TOT,.487
17,Joel Anthony,53,.535,99,0,,0,24,28,93,162,53,.535,99,47,.644,73,75,11,1463,104,194,153,C,10,36,266,MIA,.535
18,Gilbert Arenas,172,.423,407,97,.297,327,274,29,21,167,269,.366,734,120,.784,153,70,16,1796,22,188,755,PG,74,177,189,TOT,.433
19,Trevor Ariza,221,.450,491,82,.303,271,162,25,31,347,303,.398,762,138,.701,197,75,75,2600,61,180,826,SF,120,118,408,NOH,.451
20,Hilton Armstrong,35,.486,72,2,.500,4,14,26,21,89,37,.487,76,16,.485,33,53,2,488,42,84,92,C,18,28,131,TOT,.500
21,Carlos Arroyo,89,.436,204,31,.449,69,125,31,1,83,120,.440,273,39,.830,47,64,43,1185,20,71,310,PG,21,60,103,TOT,.496
22,Darrell Arthur,310,.502,618,0,.000,6,53,22,63,227,310,.497,624,109,.813,134,80,9,1609,115,228,729,PF,52,88,342,MEM,.497
23,Omer Asik,78,.553,141,0,,0,32,24,56,194,78,.553,141,73,.503,145,82,0,989,112,153,229,C,20,64,306,CHI,.553
24,D.J. Augustin,288,.461,625,111,.333,333,498,23,3,187,399,.416,958,269,.906,297,82,82,2757,38,152,1178,PG,54,155,225,CHA,.474
25,Luke Babbitt,12,.308,39,3,.188,16,6,21,2,24,15,.273,55,3,.333,9,24,0,137,6,15,36,SF,2,8,30,POR,.300
26,Renaldo Balkman,5,.455,11,1,.500,2,2,26,2,5,6,.462,13,3,.750,4,8,0,62,2,15,16,SF,4,1,7,TOT,.500
27,Marcus Banks,0,.000,2,0,,0,3,29,0,1,0,.000,2,6,.750,8,3,0,22,0,4,6,PG,1,2,1,TOR,.000
28,Leandro Barbosa,222,.505,440,72,.338,213,119,28,6,85,294,.450,653,109,.796,137,58,0,1395,14,112,769,SG,50,84,99,TOR,.505
29,J.J. Barea,219,.476,460,66,.349,189,317,26,1,130,285,.439,649,133,.847,157,81,2,1669,29,136,769,PG,30,136,159,DAL,.490
30,Andrea Bargnani,448,.472,950,77,.345,223,119,25,46,269,525,.448,1173,287,.820,350,66,66,2353,74,160,1414,C,34,152,343,TOR,.480
31,Matt Barnes,97,.564,172,34,.318,107,71,30,22,155,131,.470,279,60,.779,77,53,0,1020,73,127,356,SF,39,58,228,LAL,.530
32,Earl Barron,32,.323,99,0,,0,11,29,6,44,32,.323,99,15,.625,24,21,7,305,32,46,79,C,8,16,76,TOT,.323
33,Brandon Bass,332,.516,643,0,.000,2,57,25,52,290,332,.515,645,190,.815,233,76,51,1980,134,159,854,PF,27,97,424,ORL,.515
34,Tony Battie,43,.462,93,2,.667,3,12,34,15,82,45,.469,96,8,.571,14,38,0,377,17,59,100,C,5,12,99,PHI,.479
35,Shane Battier,127,.525,242,102,.382,267,185,32,81,283,229,.450,509,64,.688,93,82,59,2375,90,158,624,SF,69,79,373,TOT,.550
36,Nicolas Batum,249,.535,465,118,.345,342,123,22,49,252,367,.455,807,138,.841,164,80,67,2522,109,194,990,SF,68,83,361,POR,.528
37,Jerryd Bayless,169,.456,371,49,.336,146,266,22,5,139,218,.422,517,166,.806,206,71,14,1496,26,149,651,PG,38,127,165,TOT,.469
38,Michael Beasley,501,.463,1082,60,.366,164,158,22,52,291,561,.450,1246,219,.753,291,73,73,2361,118,222,1401,SF,54,195,409,MIN,.474
39,Rodrigue Beaubois,69,.493,140,25,.301,83,64,22,8,45,94,.422,223,23,.767,30,28,26,496,7,76,236,PG,20,47,52,DAL,.478
40,Marco Belinelli,168,.458,367,134,.414,324,92,24,6,134,302,.437,691,98,.784,125,80,69,1957,17,146,836,SG,38,77,151,NOH,.534
41,Charlie Bell,6,.273,22,6,.286,21,13,31,1,12,12,.279,43,2,.500,4,19,0,171,6,13,32,SG,6,6,18,GSW,.349
42,Raja Bell,123,.449,274,68,.352,193,118,34,14,145,191,.409,467,91,.892,102,68,63,2097,31,169,541,SG,56,63,176,UTA,.482
43,Mike Bibby,95,.417,228,153,.440,348,265,32,9,178,248,.431,576,39,.629,62,80,68,2285,17,175,688,PG,50,101,195,TOT,.563
44,Andris Biedrins,142,.534,266,0,,0,60,24,52,281,142,.534,266,10,.323,31,59,55,1397,145,198,294,C,52,57,426,GSW,.534
45,Chauncey Billups,193,.448,431,146,.402,363,387,34,14,165,339,.427,794,384,.916,419,72,72,2310,25,146,1208,PG,71,177,190,TOT,.519
46,DeJuan Blair,292,.503,581,0,.000,2,77,21,42,350,292,.501,583,90,.657,137,81,65,1734,215,213,674,PF,95,113,565,SAS,.501
47,Steve Blake,37,.327,113,73,.378,193,170,30,3,137,110,.359,306,26,.867,30,79,0,1581,19,99,319,PG,40,73,156,LAL,.479
48,Andray Blatche,422,.449,939,4,.222,18,144,24,51,343,426,.445,957,220,.777,283,64,63,2172,183,182,1076,PF,98,172,526,WAS,.447
49,Eric Bledsoe,174,.470,370,32,.276,116,289,21,26,155,206,.424,486,99,.744,133,81,25,1841,68,130,543,PG,92,194,223,LAC,.457
50,Keith Bogans,34,.486,70,90,.380,237,101,30,9,129,124,.404,307,21,.656,32,82,82,1461,19,113,359,SG,38,41,148,CHI,.550
51,Andrew Bogut,367,.497,738,0,.000,4,131,26,168,521,367,.495,742,96,.442,217,65,65,2297,199,217,830,C,47,125,720,MIL,.495
52,Matt Bonner,67,.475,141,105,.457,230,60,30,21,179,172,.464,371,32,.744,43,66,1,1432,60,110,481,PF,26,27,239,SAS,.605
53,Trevor Booker,139,.552,252,0,.000,1,35,23,42,153,139,.549,253,68,.673,101,65,14,1063,98,115,346,PF,29,38,251,WAS,.549
54,Carlos Boozer,431,.510,845,0,,0,145,29,18,435,431,.510,845,171,.701,244,59,59,1882,130,186,1033,C,45,149,565,CHI,.510
55,Chris Bosh,518,.502,1031,6,.240,25,144,26,49,500,524,.496,1056,384,.815,471,77,77,2795,141,172,1438,PF,59,138,641,MIA,.499
56,Earl Boykins,129,.459,281,27,.380,71,141,34,3,40,156,.443,352,69,.841,82,57,0,862,15,43,408,PG,38,52,55,MIL,.482
57,Craig Brackins,4,.364,11,0,.000,5,1,23,0,2,4,.250,16,0,,0,3,0,33,2,3,8,PF,1,0,4,PHI,.250
58,Avery Bradley,23,.371,62,0,.000,5,12,20,0,13,23,.343,67,6,.500,12,31,0,162,4,20,52,PG,9,16,17,BOS,.343
59,Elton Brand,502,.512,980,0,.000,1,120,31,106,439,502,.512,981,213,.780,273,81,81,2809,237,244,1217,PF,92,101,676,PHI,.512
60,Corey Brewer,163,.434,376,30,.268,112,89,24,16,118,193,.395,488,136,.708,192,69,24,1510,57,159,552,SF-SG,100,87,175,TOT,.426
61,Ronnie Brewer,199,.498,400,6,.222,27,140,25,22,207,205,.480,427,87,.654,133,81,1,1781,55,82,503,SG,106,55,262,CHI,.487
62,Jon Brockman,48,.511,94,0,,0,18,23,3,110,48,.511,94,40,.678,59,63,6,677,74,119,136,C,14,24,184,MIL,.511
63,Aaron Brooks,150,.427,351,70,.297,236,233,26,3,58,220,.375,587,124,.886,140,59,12,1284,20,115,634,PG,34,99,78,TOT,.434
64,Derrick Brown,69,.570,121,5,.500,10,33,23,10,58,74,.565,131,32,.533,60,49,1,576,41,59,185,SF,20,35,99,TOT,.584
65,Kwame Brown,194,.517,375,0,,0,43,28,39,303,194,.517,375,136,.589,231,66,50,1714,147,174,524,C,26,69,450,CHA,.517
66,Shannon Brown,199,.462,431,74,.349,212,96,25,16,122,273,.425,643,92,.911,101,82,0,1568,35,124,712,SG,67,75,157,LAL,.482
67,Kobe Bryant,625,.487,1283,115,.323,356,388,32,12,336,740,.451,1639,483,.828,583,82,82,2779,83,172,2078,SG,99,243,419,LAL,.487
68,Chase Budinger,190,.497,382,89,.325,274,127,22,18,229,279,.425,656,118,.855,138,78,22,1738,52,114,765,SF,41,67,281,HOU,.493
69,Caron Butler,142,.454,313,28,.431,65,46,30,8,96,170,.450,378,68,.773,88,29,29,867,22,59,436,SF,28,49,118,DAL,.487
70,Rasual Butler,33,.327,101,46,.338,136,27,31,15,67,79,.333,237,18,.667,27,47,2,770,10,37,222,SG,8,24,77,TOT,.430
71,Andrew Bynum,237,.574,413,0,,0,73,23,106,338,237,.574,413,138,.660,209,54,47,1500,170,140,612,C,19,74,508,LAL,.574
72,Will Bynum,166,.466,356,16,.320,50,195,28,4,59,182,.448,406,102,.836,122,61,5,1125,15,113,482,PG,52,83,74,DET,.468
73,Jose Calderon,205,.466,440,57,.365,156,605,29,7,172,262,.440,596,88,.854,103,68,55,2102,30,143,669,PG,81,148,202,TOR,.487
74,Marcus Camby,117,.399,293,0,.000,1,121,36,92,424,117,.398,294,43,.614,70,59,51,1540,182,140,277,C,40,62,606,POR,.398
75,Derrick Caracter,32,.485,66,0,,0,7,22,10,24,32,.485,66,17,.739,23,41,0,215,19,47,81,C,4,19,43,LAL,.485
76,Brian Cardinal,1,.077,13,42,.483,87,40,33,7,49,43,.430,100,17,.944,18,56,4,618,10,82,145,SF,24,17,59,DAL,.640
77,Rodney Carney,29,.403,72,17,.447,38,11,26,5,35,46,.418,110,18,.667,27,27,1,336,13,33,127,SF,12,16,48,TOT,.495
78,DeMarre Carroll,4,.333,12,0,,0,4,24,1,6,4,.333,12,2,1.000,2,12,0,50,2,5,10,PF,1,0,8,TOT,.333
79,Matt Carroll,72,.471,153,17,.370,46,23,30,6,56,89,.447,199,40,.769,52,54,1,582,12,43,235,SG,17,23,68,CHA,.490
80,Anthony Carter,33,.500,66,12,.300,40,69,35,6,44,45,.425,106,8,1.000,8,33,0,463,7,49,110,PG,27,39,51,TOT,.481
81,Vince Carter,273,.479,570,116,.361,321,146,34,20,221,389,.437,891,128,.740,173,73,63,2051,54,193,1022,SG,67,90,275,TOT,.502
82,Omri Casspi,133,.445,299,92,.372,247,74,22,13,233,225,.412,546,68,.673,101,71,27,1702,74,115,610,SF,54,68,307,SAC,.496
83,Mario Chalmers,72,.459,157,83,.359,231,177,24,7,134,155,.399,388,54,.871,62,70,28,1579,12,158,447,PG,76,91,146,MIA,.506
84,Tyson Chandler,266,.654,407,0,,0,32,28,80,486,266,.654,407,216,.732,295,74,74,2059,206,240,748,C,36,88,692,DAL,.654
85,Wilson Chandler,317,.501,633,112,.350,320,120,23,94,333,429,.450,953,130,.807,161,72,49,2401,75,199,1100,SF,48,104,408,TOT,.509
86,Josh Childress,120,.606,198,1,.063,16,42,27,23,86,121,.565,214,29,.492,59,54,3,894,69,68,272,SG,33,44,155,PHO,.568
87,Earl Clark,68,.444,153,0,.000,5,9,23,18,64,68,.430,158,27,.574,47,42,0,464,37,45,163,SF,8,28,101,TOT,.430
88,Jarron Collins,6,.286,21,0,,0,2,32,1,10,6,.286,21,7,.700,10,28,0,181,14,29,19,C,4,7,24,TOT,.286
89,Jason Collins,33,.471,70,1,1.000,1,22,32,9,72,34,.479,71,27,.659,41,49,28,593,30,97,96,C,9,26,102,ATL,.486
90,Sherron Collins,5,.333,15,2,.200,10,8,23,0,5,7,.280,25,1,1.000,1,20,0,66,0,2,17,PG,2,4,5,CHA,.320
91,Darren Collison,357,.479,746,41,.331,124,403,23,14,185,398,.457,870,202,.871,232,79,79,2360,40,109,1039,PG,87,194,225,IND,.481
92,Nick Collison,137,.566,242,0,,0,69,30,31,197,137,.566,242,55,.753,73,71,2,1524,119,210,329,C,42,55,316,OKC,.566
93,Mike Conley,343,.466,736,80,.369,217,528,23,18,215,423,.444,953,181,.733,247,81,81,2872,32,182,1107,PG,144,176,247,MEM,.486
94,Brian Cook,38,.418,91,34,.430,79,15,30,11,77,72,.424,170,15,.625,24,40,0,447,19,75,193,PF,12,25,96,LAC,.524
95,Daequan Cook,14,.519,27,65,.422,154,20,23,1,64,79,.436,181,16,.800,20,43,0,598,8,51,239,SG,14,17,72,OKC,.616
96,Marcus Cousin,2,.667,3,0,,0,0,24,1,3,2,.667,3,0,,0,4,0,18,0,1,4,C,0,1,3,UTA,.667
97,DeMarcus Cousins,429,.435,986,3,.167,18,204,20,68,482,432,.430,1004,276,.687,402,81,62,2309,217,332,1143,C,85,268,699,SAC,.432
98,Jamal Crawford,249,.474,525,119,.341,349,241,30,14,108,368,.421,874,222,.854,260,76,0,2297,22,97,1077,SG,57,145,130,ATL,.489
99,Jordan Crawford,159,.427,372,33,.258,128,117,22,3,74,192,.384,500,73,.869,84,42,18,1027,31,63,490,SG,39,83,105,TOT,.417
100,Dante Cunningham,217,.473,459,1,.077,13,43,23,43,181,218,.462,472,45,.726,62,78,18,1637,96,177,482,PF,54,51,277,TOT,.463
101,Stephen Curry,354,.498,711,151,.442,342,432,22,20,234,505,.480,1053,212,.934,227,74,74,2489,52,233,1373,PG,109,226,286,GSW,.551
102,Samuel Dalembert,268,.474,565,0,.000,2,67,29,116,445,268,.473,567,108,.730,148,80,46,1938,212,225,644,C,36,132,657,SAC,.473
103,Erick Dampier,52,.591,88,0,.000,1,22,35,47,124,52,.584,89,24,.545,44,51,22,815,53,82,128,C,14,32,177,MIA,.584
104,Antonio Daniels,2,.667,3,0,.000,2,2,35,0,5,2,.400,5,2,1.000,2,4,0,35,0,0,6,PG,0,1,5,PHI,.400
105,Marquis Daniels,110,.521,211,4,.190,21,64,30,22,89,114,.491,232,39,.684,57,49,0,938,24,63,271,SF,39,38,113,BOS,.500
106,Baron Davis,208,.458,454,81,.339,239,391,31,28,121,289,.417,693,101,.771,131,58,44,1649,35,143,760,PG,78,146,156,TOT,.475
107,Ed Davis,215,.576,373,0,,0,40,21,67,294,215,.576,373,71,.555,128,65,17,1602,168,183,501,PF,39,48,462,TOR,.576
108,Glen Davis,357,.454,786,2,.133,15,92,25,30,324,359,.448,801,195,.736,265,78,13,2298,101,231,915,C,78,85,425,BOS,.449
109,Austin Daye,124,.415,299,69,.401,172,78,22,39,210,193,.410,471,82,.759,108,72,16,1446,64,165,537,SF,39,59,274,DET,.483
110,Carlos Delfino,95,.415,229,105,.370,284,112,28,8,176,200,.390,513,60,.800,75,49,40,1590,24,72,565,SF,76,57,200,MIL,.492
111,Luol Deng,416,.506,822,115,.345,333,230,25,48,360,531,.460,1155,253,.753,336,82,82,3208,116,162,1430,SF,78,156,476,CHI,.510
112,DeMar DeRozan,534,.485,1102,5,.096,52,148,21,31,240,539,.467,1154,327,.813,402,82,82,2851,75,217,1410,SG,85,144,315,TOR,.469
113,Boris Diaw,303,.553,548,78,.345,226,337,28,46,309,381,.492,774,84,.683,123,82,82,2778,105,190,924,PF,74,166,414,CHA,.543
114,Ike Diogu,83,.561,148,0,,0,2,27,3,74,83,.561,148,41,.661,62,36,0,470,41,72,207,PF,3,22,115,LAC,.561
115,DeSagana Diop,8,.333,24,0,,0,7,29,15,28,8,.333,24,4,.364,11,16,0,181,12,26,20,C,4,11,40,CHA,.333
116,Keyon Dooling,125,.439,285,81,.346,234,243,30,4,105,206,.397,519,78,.830,94,80,22,1757,12,119,571,PG,54,91,117,MIL,.475
117,Joey Dorsey,52,.525,99,0,,0,27,27,17,111,52,.525,99,31,.477,65,43,9,522,79,78,135,C,24,39,190,TOR,.525
118,Toney Douglas,171,.460,372,143,.373,383,244,24,4,179,314,.416,755,85,.794,107,81,9,1971,65,177,856,SG,89,89,244,NYK,.511
119,Chris Douglas-Roberts,102,.449,227,15,.326,46,50,24,13,81,117,.429,273,74,.831,89,44,12,884,7,73,323,SF,29,35,88,MIL,.456
120,Zabian Dowdell,48,.417,115,3,.300,10,51,26,2,15,51,.408,125,16,.941,17,24,0,292,5,30,121,PG,20,29,20,PHO,.420
121,Goran Dragic,136,.476,286,56,.361,155,204,24,10,106,192,.435,441,83,.624,133,70,5,1234,36,125,523,PG,50,117,142,TOT,.499
122,Jared Dudley,195,.519,376,105,.415,253,108,25,20,207,300,.477,629,162,.743,218,82,15,2140,111,139,867,SF,87,77,318,PHO,.560
123,Chris Duhon,36,.468,77,13,.250,52,118,28,2,43,49,.380,129,14,.560,25,51,5,774,9,30,125,PG,16,61,52,ORL,.430
124,Tim Duncan,419,.502,834,0,.000,4,203,34,146,509,419,.500,838,184,.716,257,76,76,2156,169,119,1022,C,50,122,678,SAS,.500
125,Mike Dunleavy,138,.519,266,102,.402,254,105,30,30,248,240,.462,520,100,.800,125,61,44,1683,28,107,682,SG,40,69,276,IND,.560
126,Ronald Dupree,1,.333,3,0,.000,1,1,30,0,3,1,.250,4,0,,0,3,0,13,0,2,2,SF,0,0,3,TOR,.250
127,Kevin Durant,566,.504,1124,145,.350,414,214,22,76,476,711,.462,1538,594,.880,675,78,78,3038,57,159,2161,SF,88,218,533,OKC,.509
128,Devin Ebanks,19,.413,46,2,.400,5,2,21,5,12,21,.412,51,18,.783,23,20,0,118,15,7,62,SG,4,6,27,LAL,.431
129,Wayne Ellington,112,.406,276,48,.397,121,72,23,3,82,160,.403,397,42,.792,53,62,8,1181,26,85,410,SG,28,53,108,MIN,.463
130,Monta Ellis,589,.478,1232,137,.361,379,450,25,23,237,726,.451,1611,340,.789,431,80,80,3227,44,203,1929,SG,168,252,281,GSW,.493
131,Francisco Elson,54,.478,113,0,,0,33,34,14,80,54,.478,113,26,.839,31,62,1,610,35,84,134,C,21,32,115,UTA,.478
132,Melvin Ely,28,.549,51,0,,0,14,32,11,47,28,.549,51,13,.619,21,30,2,366,27,50,69,C,4,14,74,DEN,.549
133,Semih Erden,62,.559,111,0,,0,20,24,24,81,62,.559,111,39,.650,60,41,8,595,37,104,163,C,15,34,118,TOT,.559
134,Jeremy Evans,76,.667,114,0,.000,1,24,23,17,61,76,.661,115,26,.703,37,49,3,463,36,50,178,SF,17,19,97,UTA,.661
135,Maurice Evans,122,.475,257,55,.329,167,45,32,14,104,177,.417,424,52,.897,58,73,24,1549,52,129,461,SF,34,33,156,TOT,.482
136,Reggie Evans,42,.412,102,0,.000,1,38,30,6,226,42,.408,103,48,.545,88,30,18,798,119,89,132,PF,29,39,345,TOR,.408
137,Tyreke Evans,339,.432,785,43,.291,148,319,21,30,229,382,.409,933,205,.771,266,57,53,2107,46,143,1012,SG,85,184,275,SAC,.432
138,Patrick Ewing,0,.000,3,0,.000,2,2,26,1,1,0,.000,5,3,.750,4,7,0,19,1,1,3,SF,0,1,2,NOH,.000
139,Christian Eyenga,105,.488,215,25,.275,91,35,21,28,96,130,.425,306,18,.643,28,44,18,947,27,78,303,SF,34,47,123,CLE,.466
140,Jordan Farmar,146,.421,347,109,.359,304,368,24,6,149,255,.392,651,82,.820,100,73,18,1796,24,128,701,PG,62,139,173,NJN,.475
141,Derrick Favors,215,.517,416,0,,0,39,19,68,241,215,.517,416,103,.595,173,78,27,1535,171,246,533,PF,29,77,412,TOT,.517
142,Raymond Felton,311,.460,676,116,.353,329,625,26,11,221,427,.425,1005,194,.805,241,75,54,2737,48,150,1164,PG-SG,125,221,269,TOT,.483
143,Rudy Fernandez,97,.453,214,116,.321,361,193,25,14,135,213,.370,575,126,.863,146,78,3,1821,37,134,668,SG,87,88,172,POR,.471
144,Kyrylo Fesenko,44,.444,99,0,.000,1,18,24,16,74,44,.440,100,18,.391,46,53,1,456,34,90,106,C,4,25,108,UTA,.440
145,Landry Fields,213,.556,383,86,.393,219,155,22,17,416,299,.497,602,113,.769,147,82,81,2541,105,114,797,SG,80,107,521,NYK,.568
146,Derek Fisher,143,.386,370,63,.396,159,224,36,8,138,206,.389,529,83,.806,103,82,82,2297,14,192,558,PG,99,70,152,LAL,.449
147,Jonny Flynn,77,.393,196,31,.310,100,182,21,3,65,108,.365,296,32,.762,42,53,8,983,12,58,279,PG,34,113,77,MIN,.417
148,Gary Forbes,105,.488,215,19,.328,58,49,25,6,88,124,.454,273,59,.678,87,63,11,791,28,77,326,SF,23,46,116,DEN,.489
149,T.J. Ford,85,.417,204,6,.188,32,141,27,8,64,91,.386,236,35,.729,48,41,3,773,17,69,223,PG,35,63,81,IND,.398
150,Jeff Foster,80,.488,164,0,.000,3,46,34,31,190,80,.479,167,27,.563,48,56,3,940,160,127,187,C,24,26,350,IND,.479
151,Randy Foye,135,.430,314,71,.327,217,170,27,21,90,206,.388,531,133,.893,149,63,24,1551,13,122,616,SG,47,95,103,LAC,.455
152,Channing Frye,187,.479,390,171,.390,439,96,27,79,448,358,.432,829,89,.832,107,77,64,2541,65,272,976,PF,46,73,513,PHO,.535
153,Dan Gadzuric,54,.422,128,0,.000,1,14,32,29,64,54,.419,129,10,.370,27,42,9,463,71,91,118,C-PF,13,29,135,TOT,.419
154,Sundiata Gaines,33,.493,67,9,.237,38,42,24,1,25,42,.400,105,18,.500,36,24,0,301,13,25,111,PG,16,27,38,TOT,.443
155,Danilo Gallinari,162,.467,347,103,.352,293,104,22,27,246,265,.414,640,337,.862,391,62,60,2104,59,144,970,PF-SF,51,83,305,TOT,.495
156,Francisco Garcia,126,.502,251,81,.362,224,71,29,49,109,207,.436,475,65,.855,76,58,34,1386,24,126,560,SF,51,45,133,SAC,.521
157,Kevin Garnett,433,.530,817,1,.200,5,171,34,57,548,434,.528,822,187,.862,217,71,71,2220,83,148,1056,PF,95,115,631,BOS,.529
158,Marc Gasol,361,.528,684,3,.429,7,200,26,136,415,364,.527,691,220,.748,294,81,81,2586,154,265,951,C,74,146,569,MEM,.529
159,Pau Gasol,592,.530,1117,1,.333,3,273,30,130,568,593,.529,1120,354,.823,430,82,82,3037,268,203,1541,C,48,142,836,LAL,.530
160,Rudy Gay,352,.486,725,57,.396,144,153,24,58,254,409,.471,869,194,.805,241,54,54,2152,82,131,1069,SF,91,135,336,MEM,.503
161,Alonzo Gee,104,.488,213,17,.333,51,38,23,18,120,121,.458,264,72,.783,92,56,34,1118,62,94,331,SG,40,55,182,TOT,.491
162,Paul George,138,.537,257,41,.297,138,65,20,26,187,179,.453,395,77,.762,101,61,19,1265,37,127,476,SG,62,70,224,IND,.505
163,Daniel Gibson,146,.398,367,118,.403,293,201,24,21,153,264,.400,660,134,.822,163,67,15,1865,24,154,780,SG,48,80,177,CLE,.489
164,Taj Gibson,233,.472,494,1,.125,8,58,25,106,296,234,.466,502,100,.676,148,80,19,1742,162,203,569,PF,39,71,458,CHI,.467
165,Manu Ginobili,287,.497,577,154,.349,441,393,33,28,253,441,.433,1018,357,.871,410,80,79,2426,42,163,1393,SG,123,174,295,SAS,.509
166,Ryan Gomes,135,.459,294,72,.341,211,118,28,12,193,207,.410,505,61,.718,85,76,62,2095,61,159,547,SF,62,55,254,LAC,.481
167,Drew Gooden,153,.447,342,3,.150,20,47,29,18,165,156,.431,362,81,.794,102,35,18,860,73,98,396,PF,21,46,238,MIL,.435
168,Ben Gordon,232,.460,504,107,.402,266,171,27,16,154,339,.440,770,136,.850,160,82,27,2131,41,178,921,SG,48,141,195,DET,.510
169,Eric Gordon,321,.488,658,106,.364,291,244,22,18,119,427,.450,949,287,.825,348,56,56,2112,45,115,1247,SG,71,151,164,LAC,.506
170,Marcin Gortat,337,.563,599,1,.250,4,70,26,91,483,338,.561,603,140,.725,193,80,14,2032,148,188,817,C,36,81,631,TOT,.561
171,Joey Graham,73,.490,149,9,.300,30,18,28,7,76,82,.458,179,29,.806,36,39,8,586,8,73,202,SF,6,28,84,CLE,.483
172,Stephen Graham,76,.425,179,5,.238,21,40,28,1,106,81,.405,200,31,.816,38,59,28,959,17,106,198,SG,14,38,123,NJN,.418
173,Danny Granger,378,.443,853,157,.386,407,203,27,62,338,535,.425,1260,395,.848,466,79,79,2763,87,213,1622,SF,89,206,425,IND,.487
174,Aaron Gray,56,.566,99,0,,0,16,26,12,112,56,.566,99,17,.500,34,41,6,531,59,96,129,C,11,32,171,NOH,.566
175,Danny Green,10,.625,16,7,.368,19,2,23,1,12,17,.486,35,0,,0,8,0,92,3,7,41,SG,2,5,15,SAS,.586
176,Jeff Green,304,.499,609,64,.303,211,108,24,37,287,368,.449,820,198,.811,244,75,51,2427,73,210,998,PF-SF,53,99,360,TOT,.488
177,Willie Green,216,.476,454,54,.348,155,74,29,13,139,270,.443,609,78,.780,100,77,13,1674,22,143,672,SG,36,67,161,NOH,.488
178,Donte Greene,111,.478,232,45,.292,154,48,22,20,98,156,.404,386,43,.662,65,69,21,1127,49,88,400,SF,36,60,147,SAC,.462
179,Orien Greene,1,.500,2,0,,0,1,28,0,0,1,.500,2,1,.500,2,3,0,5,0,0,3,SG,1,0,0,NJN,.500
180,Blake Griffin,689,.510,1352,7,.292,24,312,21,45,719,696,.506,1376,446,.642,695,82,82,3112,270,252,1845,PF,63,223,989,LAC,.508
181,Hamed Haddadi,30,.526,57,0,.000,1,5,25,13,44,30,.517,58,15,.652,23,31,0,168,24,29,75,C,2,11,68,MEM,.517
182,Richard Hamilton,233,.442,527,55,.382,144,171,32,4,102,288,.429,671,146,.849,172,55,39,1498,24,95,777,SG,39,88,126,DET,.470
183,Tyler Hansbrough,285,.466,611,0,.000,2,41,25,15,221,285,.465,613,197,.779,253,70,29,1535,145,160,767,PF,37,76,366,IND,.465
184,Luke Harangody,63,.450,140,16,.242,66,30,23,17,103,79,.383,206,19,.731,26,49,0,640,40,80,193,PF,15,16,143,TOT,.422
185,James Harden,185,.514,360,113,.349,324,176,21,24,213,298,.436,684,289,.843,343,82,5,2189,42,207,998,SG,92,106,255,OKC,.518
186,Al Harrington,164,.473,347,117,.357,328,101,30,10,256,281,.416,675,86,.735,117,73,3,1665,76,202,765,PF,39,106,332,DEN,.503
187,Devin Harris,285,.450,633,58,.322,180,503,27,7,152,343,.422,813,335,.833,402,71,70,2254,17,163,1079,PG,70,207,169,TOT,.458
188,Manny Harris,74,.376,197,34,.370,92,85,21,7,104,108,.374,289,71,.763,93,54,15,933,36,65,321,SG,31,63,140,CLE,.433
189,Mike Harris,3,.500,6,0,,0,1,27,1,3,3,.500,6,2,.500,4,4,0,16,2,2,8,PF,0,1,5,HOU,.500
190,Udonis Haslem,44,.512,86,0,,0,6,30,3,77,44,.512,86,16,.800,20,13,0,345,29,39,104,PF,7,14,106,MIA,.512
191,Spencer Hawes,255,.480,531,9,.243,37,121,22,71,336,264,.465,568,47,.534,88,81,81,1718,129,201,584,C,29,97,465,PHI,.473
192,Chuck Hayes,244,.529,461,0,.000,2,202,27,49,380,244,.527,463,94,.662,142,74,63,2079,219,200,582,C,79,86,599,HOU,.527
193,Gordon Hayward,107,.489,219,35,.473,74,81,20,19,98,142,.485,293,69,.711,97,72,17,1218,41,106,388,SF,30,70,139,UTA,.544
194,Lazar Hayward,38,.404,94,17,.283,60,28,24,7,47,55,.357,154,33,.786,42,42,0,419,23,44,160,SF,12,19,70,MIN,.412
195,Brendan Haywood,128,.577,222,0,.000,1,19,31,74,247,128,.574,223,64,.362,177,72,8,1331,129,146,320,C,16,51,376,DAL,.574
196,Luther Head,43,.430,100,25,.391,64,70,28,9,44,68,.415,164,39,.780,50,36,14,586,16,43,200,PG,10,32,60,SAC,.491
197,Gerald Henderson,252,.472,534,7,.194,36,101,23,32,158,259,.454,570,128,.785,163,68,30,1661,49,118,653,SG,50,64,207,CHA,.461
198,Xavier Henry,63,.441,143,2,.118,17,18,19,3,28,65,.406,160,33,.635,52,38,16,527,9,48,165,SG,11,13,37,MEM,.413
199,Roy Hibbert,410,.463,886,0,.000,4,166,24,142,428,410,.461,890,205,.745,275,81,80,2244,182,256,1025,C,33,185,610,IND,.461
200,J.J. Hickson,429,.461,931,0,.000,5,91,22,54,478,429,.458,936,247,.673,367,80,66,2256,217,215,1105,C,48,173,695,CLE,.458
201,Nene Hilario,401,.618,649,1,.200,5,149,28,73,426,402,.615,654,286,.711,402,75,75,2291,145,238,1091,C,84,134,571,DEN,.615
202,George Hill,210,.490,429,77,.377,204,193,24,21,175,287,.453,633,233,.863,270,76,5,2148,24,153,884,PG,66,99,199,SAS,.514
203,Grant Hill,354,.498,711,45,.395,114,200,38,35,261,399,.484,825,213,.829,257,80,80,2409,77,184,1056,SF,64,134,338,PHO,.511
204,Jordan Hill,173,.494,350,0,.000,2,29,23,52,178,173,.491,352,60,.706,85,72,11,1125,128,157,406,C,14,62,306,HOU,.491
205,Kirk Hinrich,203,.467,435,75,.399,188,288,30,17,161,278,.446,623,106,.841,126,72,51,2157,21,185,737,SG-PG,75,121,182,TOT,.506
206,Jrue Holiday,365,.470,777,81,.365,222,531,20,29,264,446,.446,999,172,.823,209,82,82,2901,68,203,1145,PG,120,218,332,PHI,.487
207,Ryan Hollins,131,.598,219,0,,0,26,26,42,116,131,.598,219,111,.681,163,70,16,1182,70,199,373,C,22,67,186,CLE,.598
208,Al Horford,511,.557,917,2,.500,4,266,24,80,536,513,.557,921,150,.798,188,77,77,2704,182,193,1178,C,59,119,718,ATL,.558
209,Eddie House,60,.411,146,68,.389,175,62,32,3,83,128,.399,321,38,.950,40,56,1,978,9,68,362,SG,32,29,92,MIA,.505
210,Dwight Howard,619,.597,1037,0,.000,7,107,25,186,789,619,.593,1044,546,.596,916,78,78,2935,309,258,1784,C,107,279,1098,ORL,.593
211,Josh Howard,51,.383,133,7,.241,29,24,30,5,56,58,.358,162,29,.617,47,18,10,409,18,34,152,SF,13,20,74,WAS,.380
212,Juwan Howard,55,.440,125,0,,0,23,37,4,86,55,.440,125,29,.829,35,57,0,592,36,61,139,PF,10,25,122,MIA,.440
213,Lester Hudson,2,.222,9,4,.267,15,17,26,1,4,6,.250,24,2,.500,4,11,0,73,1,10,18,PG,4,7,5,WAS,.333
214,Kris Humphries,307,.527,582,0,.000,1,84,25,80,546,307,.527,583,127,.665,191,74,44,2061,225,168,741,PF,33,103,771,NJN,.527
215,Serge Ibaka,335,.544,616,0,.000,1,22,21,198,408,335,.543,617,138,.750,184,82,44,2216,214,267,808,PF,31,71,622,OKC,.543
216,Andre Iguodala,277,.479,578,61,.337,181,422,27,38,326,338,.445,759,208,.693,300,67,67,2469,61,109,945,SF,101,138,387,PHI,.486
217,Zydrunas Ilgauskas,162,.509,318,0,.000,1,26,35,58,179,162,.508,319,36,.783,46,72,51,1145,108,185,360,C,23,52,287,MIA,.508
218,Didier Ilunga-Mbenga,23,.469,49,0,,0,6,30,27,51,23,.469,49,13,.722,18,41,0,330,35,52,59,C,6,21,86,NOH,.469
219,Ersan Ilyasova,185,.479,386,36,.298,121,56,23,24,260,221,.436,507,93,.894,104,60,34,1505,105,159,571,PF,51,63,365,MIL,.471
220,Royal Ivey,9,.409,22,7,.438,16,7,29,1,14,16,.421,38,2,1.000,2,25,0,155,2,17,41,SG,6,5,16,OKC,.513
221,Jarrett Jack,227,.429,529,33,.306,108,242,27,6,153,260,.408,637,182,.850,214,83,15,1722,20,102,735,SG-PG,54,110,173,TOT,.434
222,Darnell Jackson,74,.503,147,3,.273,11,14,25,3,45,77,.487,158,30,.612,49,59,2,486,49,61,187,PF,12,23,94,SAC,.497
223,Stephen Jackson,314,.449,700,121,.337,359,241,32,28,251,435,.411,1059,249,.816,305,67,67,2405,53,161,1240,SG,80,209,304,CHA,.468
224,Damion James,46,.460,100,0,.000,3,20,23,12,68,46,.447,103,18,.643,28,25,9,403,17,36,110,SF,16,25,85,NJN,.447
225,LeBron James,666,.552,1206,92,.330,279,554,26,50,510,758,.510,1485,503,.759,663,79,79,3063,80,163,2111,SF,124,284,590,MIA,.541
226,Antawn Jamison,283,.462,613,91,.346,263,93,34,30,289,374,.427,876,171,.731,234,56,38,1842,86,137,1010,PF,50,77,375,CLE,.479
227,Othyus Jeffers,30,.492,61,1,.250,4,20,25,0,42,31,.477,65,30,.652,46,17,1,322,25,32,93,SG,17,14,67,TOT,.485
228,Al Jefferson,654,.496,1319,0,,0,149,26,153,559,654,.496,1319,220,.761,289,82,82,2940,235,238,1528,C,46,105,794,UTA,.496
229,Richard Jefferson,169,.504,335,135,.440,307,107,30,34,256,304,.474,642,148,.759,195,81,81,2459,54,164,891,SF,38,93,310,SAS,.579
230,Jared Jeffries,28,.364,77,2,.222,9,36,29,17,54,30,.349,86,12,.414,29,42,9,601,62,75,74,PF,31,21,116,TOT,.360
231,Brandon Jennings,263,.422,623,98,.323,303,305,21,21,192,361,.390,926,199,.809,246,63,61,2169,42,131,1019,PG,95,146,234,MIL,.443
232,Eugene Jeter,100,.437,229,6,.200,30,162,27,2,61,106,.409,259,37,.902,41,62,1,858,9,54,255,PG,29,51,70,SAC,.421
233,Yi Jianlian,142,.425,334,3,.231,13,25,23,32,169,145,.418,347,62,.681,91,63,11,1112,79,115,355,PF,27,51,248,WAS,.422
234,Amir Johnson,281,.569,494,0,.000,1,81,23,88,272,281,.568,495,126,.788,160,72,54,1853,189,263,688,PF,53,69,461,TOR,.568
235,Armon Johnson,41,.461,89,5,.417,12,45,21,1,25,46,.455,101,13,.591,22,38,0,277,11,31,110,PG,5,38,36,POR,.480
236,Chris Johnson,9,.429,21,0,,0,3,25,9,20,9,.429,21,15,.750,20,14,1,138,12,21,33,C,3,10,32,TOT,.429
237,James Johnson,100,.493,203,8,.235,34,89,23,37,105,108,.456,237,47,.662,71,38,25,822,37,95,271,SF,33,64,142,TOT,.473
238,Joe Johnson,425,.494,861,89,.297,300,338,29,7,232,514,.443,1161,195,.802,243,72,72,2554,59,131,1312,SG,47,146,291,ATL,.481
239,Trey Johnson,11,.367,30,1,.333,3,11,26,1,5,12,.364,33,9,.900,10,8,0,94,2,12,34,SG,1,5,7,TOT,.379
240,Wesley Johnson,168,.427,393,103,.356,289,148,23,54,189,271,.397,682,64,.696,92,79,63,2069,51,163,709,SG,58,95,240,MIN,.473
241,Dahntay Jones,86,.491,175,14,.359,39,33,30,7,61,100,.467,214,69,.767,90,45,2,589,4,70,283,SG,20,31,65,IND,.500
242,Dominique Jones,14,.341,41,0,.000,4,19,22,3,19,14,.311,45,14,.824,17,18,0,135,6,7,42,SG,5,10,25,DAL,.311
243,James Jones,23,.390,59,123,.429,287,43,30,19,137,146,.422,346,60,.833,72,81,8,1549,23,129,475,SF,29,21,160,MIA,.600
244,Solomon Jones,49,.408,120,0,.000,1,30,26,22,68,49,.405,121,41,.661,62,39,0,528,45,94,139,C,12,35,113,IND,.405
245,DeAndre Jordan,234,.688,340,0,.000,1,42,22,142,368,234,.686,341,98,.452,217,80,66,2047,207,255,566,C,41,101,575,LAC,.686
246,Chris Kaman,177,.471,376,0,,0,46,28,48,174,177,.471,376,43,.754,57,32,15,838,51,75,397,C,16,58,225,LAC,.471
247,Jason Kapono,6,.300,20,1,.125,8,4,29,1,8,7,.250,28,1,.500,2,24,2,112,3,4,16,SF,2,2,11,PHI,.268
248,Jason Kidd,82,.400,205,133,.340,391,655,37,29,316,215,.361,596,67,.870,77,80,80,2653,35,119,630,PG,134,179,351,DAL,.472
249,Andrei Kirilenko,217,.489,444,36,.367,98,192,29,74,227,253,.467,542,208,.770,270,64,62,1999,100,113,750,SF,81,117,327,UTA,.500
250,Linas Kleiza,139,.505,275,39,.298,131,40,26,7,140,178,.438,406,41,.631,65,39,23,1032,37,99,436,SF,19,65,177,TOR,.486
251,Kyle Korver,122,.455,268,120,.415,289,124,29,20,138,242,.434,557,77,.885,87,82,0,1649,12,156,681,SG,35,60,150,CHI,.542
252,Kosta Koufos,68,.459,148,0,.000,2,7,21,25,73,68,.453,150,24,.558,43,50,2,434,57,59,160,C,10,31,130,TOT,.453
253,Nenad Krstic,231,.511,452,0,,0,27,27,25,211,231,.511,452,113,.774,146,71,67,1571,124,184,575,C,26,56,335,TOT,.511
254,Carl Landry,345,.505,683,0,.000,4,63,27,32,182,345,.502,687,213,.740,288,76,26,2008,165,196,903,PF,40,109,347,TOT,.502
255,Acie Law,75,.500,150,6,.167,36,84,26,0,51,81,.435,186,47,.734,64,51,0,726,12,61,215,PG,32,43,63,TOT,.452
256,Gani Lawal,0,,0,0,,0,0,22,0,0,0,,0,0,,0,1,0,2,0,1,0,PF,0,0,0,PHO,
257,Ty Lawson,277,.536,517,69,.404,171,377,23,4,142,346,.503,688,172,.764,225,80,31,2103,67,133,933,PG,80,137,209,DEN,.553
258,Courtney Lee,182,.453,402,71,.408,174,100,25,18,158,253,.439,576,95,.792,120,81,1,1723,51,102,672,SG,58,68,209,HOU,.501
259,David Lee,495,.508,975,1,.333,3,233,27,31,497,496,.507,978,210,.787,267,73,73,2634,217,211,1203,PF,74,170,714,GSW,.508
260,Rashard Lewis,165,.488,338,87,.357,244,92,31,30,219,252,.433,582,77,.802,96,57,52,1824,71,159,668,SF-PF,52,87,290,TOT,.508
261,Jeremy Lin,27,.403,67,1,.200,5,42,22,9,22,28,.389,72,19,.760,25,29,0,285,12,31,76,PG,33,18,34,GSW,.396
262,Shaun Livingston,184,.468,393,1,.250,4,164,25,29,120,185,.466,397,108,.864,125,73,0,1261,29,109,479,PG,47,88,149,CHA,.467
263,Brook Lopez,644,.492,1308,0,.000,1,129,22,120,291,644,.492,1309,385,.787,489,82,82,2889,197,240,1673,C,47,176,488,NJN,.492
264,Robin Lopez,179,.501,357,0,,0,8,22,45,134,179,.501,357,74,.740,100,67,56,991,82,143,432,C,18,48,216,PHO,.501
265,Kevin Love,394,.483,815,88,.417,211,184,22,28,782,482,.470,1026,424,.850,499,73,73,2611,330,148,1476,PF,45,155,1112,MIN,.513
266,Kyle Lowry,216,.464,466,129,.376,343,500,24,23,220,345,.426,809,192,.765,251,75,71,2563,89,207,1011,PG,102,158,309,HOU,.506
267,John Lucas III,1,.500,2,0,.000,1,1,28,0,0,1,.333,3,0,.000,2,2,0,10,0,0,2,PG,0,0,0,CHI,.333
268,Corey Maggette,225,.468,481,28,.359,78,84,31,5,197,253,.453,559,271,.834,325,67,18,1401,44,175,805,SF,21,127,241,MIL,.478
269,Jamaal Magloire,13,.591,22,0,,0,3,32,2,44,13,.591,22,9,.500,18,18,0,158,17,26,35,C,4,5,61,MIA,.591
270,Ian Mahinmi,55,.573,96,0,.000,2,8,24,15,77,55,.561,98,63,.768,82,56,0,488,43,105,173,C,14,25,120,DAL,.561
271,Shawn Marion,429,.536,801,5,.152,33,110,32,50,383,434,.520,834,126,.768,164,80,27,2253,168,144,999,SF,68,130,551,DAL,.523
272,Sean Marks,17,.405,42,2,1.000,2,4,35,5,24,19,.432,44,5,.625,8,29,0,208,16,44,45,C,3,11,40,POR,.455
273,Cartier Martin,32,.386,83,39,.394,99,18,26,6,54,71,.390,182,28,.700,40,52,1,542,20,52,209,SF,18,16,74,WAS,.497
274,Kenyon Martin,183,.518,353,2,.222,9,109,33,35,230,185,.511,362,42,.583,72,48,48,1233,67,136,414,PF,43,59,297,DEN,.514
275,Kevin Martin,377,.467,808,176,.383,459,198,27,15,230,553,.436,1267,594,.888,669,80,80,2603,28,155,1876,SG,80,184,258,HOU,.506
276,Roger Mason,10,.303,33,16,.364,44,20,30,2,38,26,.338,77,7,.700,10,26,0,319,5,25,75,SG,6,6,43,NYK,.442
277,Wesley Matthews,286,.476,601,154,.407,378,164,24,9,210,440,.449,979,266,.844,315,82,69,2758,48,195,1300,SG,102,138,258,POR,.528
278,Jason Maxiell,93,.492,189,0,,0,17,27,21,107,93,.492,189,51,.515,99,57,14,930,66,92,237,PF,24,44,173,DET,.492
279,Eric Maynor,97,.409,237,37,.385,96,238,23,6,96,134,.402,333,43,.729,59,82,0,1200,25,96,348,PG,35,77,121,OKC,.458
280,O.J. Mayo,208,.431,483,96,.364,264,145,23,26,135,304,.407,747,99,.756,131,71,17,1869,35,127,803,SG,73,99,170,MEM,.471
281,Luc Mbah a Moute,198,.470,421,0,.000,7,68,24,28,251,198,.463,428,133,.707,188,79,52,2093,169,180,529,PF,72,77,420,MIL,.463
282,Antonio McDyess,169,.493,343,0,.000,1,84,36,39,273,169,.491,344,52,.675,77,73,16,1387,122,163,390,PF,36,72,395,SAS,.491
283,JaVale McGee,332,.552,601,0,.000,3,38,23,193,411,332,.550,604,134,.583,230,79,75,2193,223,232,798,C,41,102,634,WAS,.550
284,Tracy McGrady*,197,.462,426,30,.341,88,252,31,34,202,227,.442,514,90,.698,129,72,39,1686,49,101,574,SG,66,102,251,DET,.471
285,Dominic McGuire,72,.400,180,0,.000,2,43,25,33,136,72,.396,182,30,.769,39,52,8,760,63,94,174,SF,10,25,199,CHA,.396
286,Josh McRoberts,188,.577,326,23,.383,60,150,23,57,273,211,.547,386,88,.739,119,72,51,1597,109,165,533,PF,47,93,382,IND,.576
287,Jodie Meeks,104,.468,222,138,.397,348,78,23,4,150,242,.425,570,152,.894,170,74,64,2062,21,97,774,SG,63,60,171,PHI,.546
288,Pops Mensah-Bonsu,1,.333,3,0,,0,2,27,0,8,1,.333,3,0,,0,7,0,35,3,11,2,PF,0,2,11,NOH,.333
289,C.J. Miles,257,.459,560,109,.322,339,135,23,38,201,366,.407,899,159,.811,196,78,19,1969,54,221,1000,SF,74,93,255,UTA,.468
290,Darko Milicic,271,.469,578,0,,0,104,25,140,227,271,.469,578,64,.557,115,69,69,1686,133,229,606,C,54,151,360,MIN,.469
291,Andre Miller,384,.476,807,4,.108,37,566,34,12,205,388,.460,844,249,.853,292,81,81,2650,97,171,1029,PG,114,197,302,POR,.462
292,Brad Miller,92,.487,189,40,.374,107,145,34,21,178,132,.446,296,78,.830,94,60,5,1015,44,98,382,C,28,54,222,HOU,.514
293,Mike Miller,38,.452,84,43,.364,118,51,30,2,146,81,.401,202,23,.676,34,41,2,838,38,88,228,SG,20,41,184,MIA,.507
294,Patty Mills,88,.451,195,47,.353,133,109,22,1,32,135,.412,328,36,.766,47,64,0,783,19,63,353,PG,27,62,51,POR,.483
295,Paul Millsap,516,.535,965,9,.391,23,187,25,69,415,525,.531,988,256,.757,338,76,76,2605,164,272,1315,PF,103,145,579,UTA,.536
296,Yao Ming*,18,.486,37,0,,0,4,30,8,20,18,.486,37,15,.938,16,5,5,91,7,13,51,C,0,7,27,HOU,.486
297,Nazr Mohammed,234,.523,447,0,.000,1,23,33,56,228,234,.522,448,67,.598,112,75,37,1280,140,184,535,C,30,70,368,TOT,.522
298,Greg Monroe,303,.552,549,0,.000,1,105,20,45,353,303,.551,550,145,.622,233,80,48,2222,248,196,751,C,93,81,601,DET,.551
299,Jamario Moon,63,.504,125,38,.309,123,52,30,33,142,101,.407,248,15,.882,17,59,20,1042,23,65,255,SF,28,22,165,TOT,.484
300,Anthony Morrow,169,.469,360,110,.423,260,68,25,7,135,279,.450,620,96,.897,107,58,47,1856,37,135,764,SG,19,54,172,NJN,.539
301,Timofey Mozgov,63,.474,133,0,,0,15,24,25,75,63,.474,133,37,.712,52,45,14,524,46,84,163,C,15,35,121,TOT,.474
302,Byron Mullens,9,.321,28,0,,0,0,21,3,18,9,.321,28,7,.500,14,13,0,85,6,11,25,PF,2,8,24,OKC,.321
303,Troy Murphy,37,.457,81,5,.152,33,23,30,3,91,42,.368,114,20,.667,30,35,4,466,22,47,109,PF,15,20,113,TOT,.390
304,Hamady N'Diaye,4,.800,5,0,,0,0,24,5,5,4,.800,5,6,.500,12,16,0,80,2,18,14,C,2,3,7,WAS,.800
305,Eduardo Najera,15,.395,38,11,.324,34,20,34,6,30,26,.361,72,6,.545,11,31,0,372,14,52,69,PF,11,13,44,CHA,.438
306,Steve Nash,318,.525,606,81,.395,205,855,36,4,220,399,.492,811,227,.912,249,75,75,2497,40,87,1106,PG,48,265,260,PHO,.542
307,Gary Neal,156,.481,324,129,.419,308,96,26,4,175,285,.451,632,84,.808,104,80,1,1685,21,148,783,SG,27,78,196,SAS,.553
308,Jameer Nelson,255,.471,541,119,.401,297,456,28,3,189,374,.446,838,130,.802,162,76,76,2319,37,209,997,PG,75,194,226,ORL,.517
309,Joakim Noah,211,.526,401,0,.000,1,107,25,72,316,211,.525,402,139,.739,188,48,48,1576,182,156,561,C,48,90,498,CHI,.525
310,Andres Nocioni,76,.478,159,42,.356,118,45,31,15,150,118,.426,277,49,.803,61,54,17,931,19,100,327,SF,14,47,169,PHI,.502
311,Steve Novak,9,.429,21,26,.565,46,3,27,5,24,35,.522,67,8,1.000,8,30,0,215,4,14,104,SF,1,4,28,TOT,.716
312,Dirk Nowitzki,544,.538,1011,66,.393,168,190,32,47,463,610,.517,1179,395,.892,443,73,73,2504,50,172,1681,PF,38,137,513,DAL,.545
313,Jermaine O'Neal,50,.463,108,0,.000,1,12,32,30,63,50,.459,109,29,.674,43,24,10,431,25,65,129,C,2,27,88,BOS,.459
314,Shaquille O'Neal*,134,.667,201,0,,0,26,38,42,130,134,.667,201,73,.557,131,37,36,752,48,120,341,C,16,56,178,BOS,.667
315,Fabricio Oberto,3,.600,5,0,,0,0,35,0,4,3,.600,5,1,.500,2,5,0,45,3,10,7,C,0,3,7,POR,.600
316,Lamar Odom,405,.566,715,68,.382,178,249,31,61,535,473,.530,893,166,.675,246,82,35,2639,175,200,1180,PF,47,139,710,LAL,.568
317,Emeka Okafor,300,.574,523,0,.000,1,42,28,127,454,300,.573,524,145,.562,258,72,72,2287,230,230,745,C,40,119,684,NOH,.573
318,Mehmet Okur,17,.370,46,5,.313,16,19,31,4,21,22,.355,62,15,.750,20,13,0,168,9,18,64,C,4,7,30,UTA,.395
319,Travis Outlaw,198,.413,479,76,.302,252,84,26,36,271,274,.375,731,132,.772,171,82,55,2358,54,148,756,SF,34,71,325,NJN,.427
320,Larry Owens,9,.474,19,6,.462,13,8,28,5,14,15,.469,32,4,.444,9,12,0,143,1,18,40,SF,9,5,15,TOT,.563
321,Zaza Pachulia,107,.461,232,0,,0,58,26,22,214,107,.461,232,135,.754,179,79,7,1244,119,184,349,C,34,69,333,ATL,.461
322,Anthony Parker,134,.412,325,86,.379,227,218,35,10,185,220,.399,552,74,.779,95,72,65,2091,33,109,600,SF,67,80,218,CLE,.476
323,Tony Parker,530,.531,999,25,.357,70,513,28,3,208,555,.519,1069,233,.769,303,78,78,2528,30,135,1368,PG,90,200,238,SAS,.531
324,Patrick Patterson,149,.562,265,0,.000,2,41,21,37,114,149,.558,267,30,.714,42,52,6,868,86,77,328,PF,17,31,200,HOU,.558
325,Chris Paul,359,.482,745,71,.388,183,782,25,5,289,430,.463,928,337,.878,384,80,80,2880,38,196,1268,PG,188,177,327,NOH,.502
326,Sasha Pavlovic,17,.415,41,12,.387,31,16,27,7,31,29,.403,72,6,.600,10,31,7,362,1,34,76,SG-SF,10,12,32,TOT,.486
327,Nikola Pekovic,136,.517,263,0,,0,27,25,35,103,136,.517,263,87,.763,114,65,11,887,90,181,359,C,18,91,193,MIN,.517
328,Kendrick Perkins,67,.515,130,0,,0,26,26,26,170,67,.515,130,40,.556,72,29,24,742,62,91,174,C,9,56,232,TOT,.515
329,Morris Peterson,2,.500,4,0,.000,1,1,33,0,3,2,.400,5,0,,0,4,0,23,0,5,4,SG,0,0,3,OKC,.400
330,Johan Petro,129,.451,286,0,.000,4,44,25,34,150,129,.445,290,15,.536,28,77,1,893,62,178,273,C,34,46,212,NJN,.445
331,Paul Pierce,396,.547,724,111,.374,297,260,33,51,396,507,.497,1021,386,.860,449,80,80,2774,34,231,1511,SF,80,171,430,BOS,.551
332,Mickael Pietrus,58,.450,129,85,.360,236,33,28,21,111,143,.392,365,39,.684,57,57,4,1107,15,101,410,SG-SF,29,39,126,TOT,.508
333,Dexter Pittman,1,.333,3,0,,0,0,22,0,2,1,.333,3,0,,0,2,0,11,1,2,2,C,0,2,3,MIA,.333
334,Quincy Pondexter,55,.423,130,18,.360,50,28,22,10,65,73,.406,180,24,.706,34,66,6,734,23,63,188,SF,17,16,88,NOH,.456
335,James Posey,14,.483,29,67,.316,212,34,34,6,137,81,.336,241,11,.733,15,49,0,839,10,103,240,SF,24,24,147,IND,.475
336,Leon Powe,59,.504,117,0,.000,2,7,27,4,39,59,.496,119,40,.556,72,30,3,328,24,44,158,C-PF,10,12,63,TOT,.496
337,Josh Powell,94,.454,207,0,.000,1,22,28,5,86,94,.452,208,36,.800,45,54,0,653,49,78,224,PF,5,53,135,ATL,.452
338,A.J. Price,73,.427,171,41,.275,149,111,24,1,56,114,.356,320,54,.667,81,50,0,795,16,61,323,PG,29,53,72,IND,.420
339,Ronnie Price,54,.383,141,20,.290,69,56,27,5,39,74,.352,210,29,.744,39,59,0,717,22,106,197,SG,42,55,61,UTA,.400
340,Tayshaun Prince,439,.486,903,34,.347,98,215,30,41,251,473,.473,1001,118,.702,168,78,78,2562,78,90,1098,SF,30,82,329,DET,.490
341,Joel Przybilla,25,.568,44,0,,0,13,31,15,108,25,.568,44,14,.519,27,36,9,519,37,79,64,C,5,29,145,TOT,.568
342,Chris Quinn,22,.407,54,11,.297,37,42,27,1,22,33,.363,91,4,.500,8,41,0,292,3,29,81,PG,5,12,25,SAS,.423
343,Vladimir Radmanovic,67,.462,145,70,.405,173,79,30,44,148,137,.431,318,30,.882,34,74,6,1169,64,157,374,PF,44,57,212,GSW,.541
344,Anthony Randolph,122,.469,260,1,.250,4,33,21,24,117,123,.466,264,58,.674,86,40,3,590,43,62,305,C-PF,22,53,160,TOT,.468
345,Zach Randolph,590,.515,1145,8,.186,43,163,29,25,588,598,.503,1188,300,.758,396,75,74,2724,326,175,1504,PF,63,151,914,MEM,.507
346,Theo Ratliff,1,.167,6,0,,0,3,37,5,7,1,.167,6,0,.000,2,10,0,71,6,7,2,C,2,3,13,LAL,.167
347,Andy Rautins,2,.667,3,1,.250,4,3,24,0,1,3,.429,7,1,.500,2,5,0,24,0,0,8,SG,1,7,1,NYK,.500
348,Michael Redd,14,.500,28,4,.235,17,12,31,1,8,18,.400,45,4,1.000,4,10,0,134,0,4,44,SG,2,4,8,MIL,.444
349,J.J. Redick,110,.482,228,87,.397,219,102,26,3,107,197,.441,447,112,.875,128,59,5,1513,6,80,593,SG,29,53,113,ORL,.538
350,Jason Richardson,283,.490,577,189,.395,479,147,30,13,264,472,.447,1056,116,.730,159,80,80,2715,67,162,1249,SG,93,95,331,TOT,.536
351,Quentin Richardson,45,.413,109,42,.288,146,38,30,5,139,87,.341,255,33,.750,44,57,19,955,39,74,249,SF,25,33,178,ORL,.424
352,Luke Ridnour,238,.479,497,81,.440,184,384,29,10,162,319,.468,681,121,.883,137,71,66,2159,37,146,840,PG,89,158,199,MIN,.528
353,Nate Robinson,85,.483,176,65,.325,200,111,26,4,75,150,.399,376,36,.818,44,59,11,1013,15,115,401,PG,29,68,90,TOT,.485
354,Rajon Rondo,308,.491,627,10,.233,43,760,24,11,210,318,.475,670,75,.568,132,68,68,2527,87,120,721,PG,153,234,297,BOS,.482
355,Derrick Rose,583,.481,1212,128,.332,385,623,22,51,249,711,.445,1597,476,.858,555,81,81,3026,81,136,2026,PG,85,278,330,CHI,.485
356,Quinton Ross,26,.464,56,0,.000,3,10,29,6,20,26,.441,59,5,.357,14,36,4,353,10,40,57,SF,3,7,30,NJN,.441
357,Brandon Roy,171,.418,409,38,.333,114,129,26,12,93,209,.400,523,117,.848,138,47,23,1310,28,76,573,SG,37,55,121,POR,.436
358,Brandon Rush,124,.425,292,93,.417,223,62,25,35,184,217,.421,515,80,.755,106,67,21,1754,33,107,607,SG,41,69,217,IND,.512
359,John Salmons,290,.427,679,83,.379,219,252,31,28,239,373,.415,898,195,.813,240,73,70,2554,27,157,1024,SG,72,137,266,MIL,.462
360,Samardo Samuels,110,.462,238,0,.000,3,17,22,18,83,110,.456,241,68,.618,110,37,10,701,75,88,288,PF,15,53,158,CLE,.456
361,Larry Sanders,116,.433,268,0,,0,16,22,72,119,116,.433,268,28,.560,50,60,12,872,59,117,260,C,22,38,178,MIL,.433
362,Brian Scalabrine,10,.714,14,0,.000,5,6,32,4,7,10,.526,19,0,,0,18,0,88,1,18,20,PF,3,5,8,CHI,.526
363,Luis Scola,569,.505,1126,0,.000,3,185,30,44,459,569,.504,1129,214,.738,290,74,74,2412,147,227,1352,PF,48,147,606,HOU,.504
364,Thabo Sefolosha,129,.558,231,28,.275,102,111,26,38,281,157,.471,333,59,.747,79,79,79,2049,65,171,401,SG,97,55,346,OKC,.514
365,Kevin Seraphin,66,.449,147,0,,0,10,21,28,72,66,.449,147,22,.710,31,58,1,635,80,126,154,PF,17,42,152,WAS,.449
366,Ramon Sessions,359,.472,761,3,.200,15,419,24,8,209,362,.466,776,348,.823,423,81,38,2133,46,93,1075,PG,60,178,255,CLE,.468
367,Mustafa Shakur,20,.408,49,1,.100,10,25,26,3,15,21,.356,59,8,.533,15,22,0,159,7,15,51,PG,5,18,22,WAS,.364
368,Garret Siler,17,.548,31,0,,0,3,24,4,12,17,.548,31,11,.500,22,21,0,101,16,20,45,C,1,10,28,PHO,.548
369,Bobby Simmons,0,,0,0,.000,3,2,30,0,0,0,.000,3,0,,0,2,0,16,0,2,0,SF,0,0,0,SAS,.000
370,Brian Skinner,0,,0,0,,0,0,34,0,0,0,,0,0,,0,2,0,6,0,0,0,C,0,0,0,MIL,
371,Craig Smith,104,.568,183,0,.000,5,31,27,7,74,104,.553,188,50,.735,68,48,0,586,43,84,258,PF,16,33,117,LAC,.553
372,Ish Smith,40,.381,105,3,.300,10,79,22,2,40,43,.374,115,12,.571,21,43,3,442,7,37,101,PG,18,34,47,TOT,.387
373,J.R. Smith,217,.466,466,124,.390,318,175,25,16,277,341,.435,784,163,.738,221,79,6,1968,45,173,969,SF,92,100,322,DEN,.514
374,Jason Smith,136,.446,305,0,.000,2,36,24,32,152,136,.443,307,59,.843,70,77,6,1102,89,150,331,C,26,53,241,NOH,.443
375,Joe Smith,3,.188,16,0,,0,4,35,4,18,3,.188,16,2,1.000,2,16,3,69,3,13,8,PF,0,5,21,TOT,.188
376,Josh Smith,446,.503,887,51,.331,154,255,25,120,523,497,.477,1041,229,.725,316,77,77,2645,134,217,1274,PF,99,197,657,ATL,.502
377,Darius Songaila,7,.467,15,0,,0,2,32,0,8,7,.467,15,2,.500,4,10,0,71,2,16,16,C,0,4,10,PHI,.467
378,Marreese Speights,143,.498,287,1,.250,4,30,23,19,146,144,.495,291,55,.753,73,64,1,734,64,120,344,C,8,40,210,PHI,.497
379,Tiago Splitter,101,.532,190,0,.000,1,26,26,17,129,101,.529,191,76,.543,140,60,6,738,72,91,278,C,29,32,201,SAS,.529
380,Jerry Stackhouse,2,.250,8,1,.250,4,3,36,2,6,3,.250,12,5,.714,7,7,1,50,1,3,12,SG,0,2,7,MIA,.292
381,Lance Stephenson,13,.382,34,0,.000,5,21,20,0,17,13,.333,39,11,.786,14,12,0,115,1,14,37,SG,4,16,18,IND,.333
382,DeShawn Stevenson,34,.420,81,94,.378,249,77,29,5,86,128,.388,330,33,.767,43,72,54,1158,20,71,383,SG,21,44,106,DAL,.530
383,Peja Stojakovic,43,.473,91,57,.419,136,29,33,2,61,100,.441,227,23,.920,25,33,13,617,14,24,280,SF,13,17,75,TOT,.566
384,Amar'e Stoudemire,734,.503,1459,10,.435,23,202,28,150,438,744,.502,1482,473,.792,597,78,78,2870,198,274,1971,C,71,250,636,NYK,.505
385,Rodney Stuckey,337,.457,737,26,.289,90,361,24,10,146,363,.439,827,330,.866,381,70,54,2183,70,177,1082,PG,76,155,216,DET,.455
386,DaJuan Summers,19,.396,48,9,.429,21,2,23,1,10,28,.406,69,9,.450,20,22,1,199,2,21,74,SF,3,13,12,DET,.471
387,Pape Sy,2,.400,5,0,.000,1,2,22,0,1,2,.333,6,3,1.000,3,3,0,21,2,1,7,SF,1,3,3,ATL,.333
388,Jermaine Taylor,80,.530,151,14,.311,45,32,24,5,36,94,.480,196,21,.750,28,34,8,483,26,39,223,SG,14,46,62,TOT,.515
389,Jeff Teague,115,.449,256,18,.375,48,138,22,25,91,133,.438,304,77,.794,97,70,7,963,11,82,361,PG,45,64,102,ATL,.467
390,Sebastian Telfair,69,.423,163,28,.359,78,111,25,3,37,97,.402,241,44,.733,60,37,8,711,17,64,266,PG,25,64,54,MIN,.461
391,Garrett Temple,10,.323,31,10,.270,37,32,24,6,22,20,.294,68,7,.412,17,24,0,230,1,24,57,PG-SG,11,23,23,TOT,.368
392,Jason Terry,365,.493,740,127,.362,351,334,33,13,129,492,.451,1091,182,.850,214,82,10,2564,24,140,1293,SG,93,167,153,DAL,.509
393,Hasheem Thabeet,17,.425,40,0,,0,4,23,16,51,17,.425,40,19,.543,35,47,0,373,24,76,53,C,9,17,75,TOT,.425
394,Etan Thomas,10,.476,21,0,,0,2,32,4,17,10,.476,21,12,.800,15,13,0,82,6,11,32,C,1,5,23,ATL,.476
395,Kurt Thomas,94,.508,185,1,1.000,1,60,38,42,226,95,.511,186,20,.625,32,52,37,1178,75,164,211,PF,32,42,301,CHI,.513
396,Tyrus Thomas,156,.476,328,0,.000,3,29,24,66,159,156,.471,331,107,.787,136,41,2,861,65,113,419,C,30,65,224,CHA,.471
397,Jason Thompson,271,.510,531,0,.000,3,88,24,44,310,271,.507,534,121,.605,200,75,39,1748,144,212,663,PF,28,99,454,SAC,.507
398,Al Thornton,201,.496,405,4,.154,26,62,27,12,157,205,.476,431,110,.775,142,71,23,1383,56,143,524,SF-PF,35,64,213,TOT,.480
399,Marcus Thornton,262,.462,567,88,.367,240,135,23,9,197,350,.434,807,145,.788,184,73,23,1775,61,110,933,SG,64,93,258,TOT,.488
400,Anthony Tolliver,94,.475,198,47,.409,115,82,25,28,203,141,.450,313,105,.802,131,65,4,1362,92,145,434,SF,28,49,295,MIN,.526
401,Ronny Turiaf,103,.632,163,0,,0,92,28,73,143,103,.632,163,61,.622,98,64,21,1141,64,160,267,C,35,41,207,NYK,.632
402,Hedo Turkoglu,195,.473,412,127,.410,310,343,31,34,311,322,.446,722,106,.679,156,81,72,2540,45,247,877,SF-PF,72,132,356,TOT,.534
403,Evan Turner,211,.435,485,14,.318,44,159,22,14,264,225,.425,529,101,.808,125,78,14,1797,42,138,565,SG,49,80,306,PHI,.439
404,Ekpe Udoh,97,.437,222,0,,0,40,23,86,101,97,.437,222,42,.656,64,58,18,1030,80,144,236,C,22,48,181,GSW,.437
405,Ime Udoka,5,.385,13,0,.000,8,13,33,1,14,5,.238,21,4,.500,8,20,0,130,5,14,14,SF,8,5,19,SAS,.238
406,Beno Udrih,347,.540,642,65,.357,182,386,28,9,224,412,.500,824,197,.864,228,79,64,2734,41,181,1086,PG,94,141,265,SAC,.539
407,Ben Uzoh,58,.426,136,3,.375,8,69,22,8,31,61,.424,144,33,.589,56,42,0,438,30,29,158,PG,13,25,61,NJN,.434
408,Anderson Varejao,114,.533,214,0,.000,2,45,28,38,203,114,.528,216,54,.667,81,31,31,994,98,87,282,C,27,40,301,CLE,.528
409,Greivis Vasquez,70,.476,147,25,.291,86,151,24,4,61,95,.408,233,34,.773,44,70,1,860,12,83,249,SG,22,70,73,MEM,.461
410,Charlie Villanueva,188,.488,385,125,.387,323,48,26,42,245,313,.442,708,89,.767,116,76,11,1666,50,175,840,PF,42,66,295,DET,.530
411,Sasha Vujacic,142,.426,333,97,.370,262,132,26,5,156,239,.402,595,81,.844,96,67,17,1648,30,136,656,SG,54,66,186,TOT,.483
412,Dwyane Wade,629,.534,1178,63,.306,206,346,29,87,362,692,.500,1384,494,.758,652,76,76,2823,123,197,1941,SG,111,237,485,MIA,.523
413,Von Wafer,49,.533,92,18,.269,67,35,25,5,42,67,.421,159,32,.842,38,58,2,553,7,39,184,SG,18,20,49,BOS,.478
414,Henry Walker,45,.542,83,59,.386,153,34,23,6,106,104,.441,236,31,.705,44,61,1,784,16,81,298,SG,21,37,122,NYK,.566
415,John Wall,364,.425,857,34,.296,115,574,20,35,282,398,.409,972,301,.766,393,69,64,2606,35,175,1131,PG,121,261,317,WAS,.427
416,Ben Wallace,66,.449,147,1,.500,2,72,36,54,221,67,.450,149,19,.333,57,54,49,1238,129,81,154,C,54,44,350,DET,.453
417,Gerald Wallace,324,.487,665,62,.333,186,173,28,63,458,386,.454,851,279,.746,374,71,63,2693,111,183,1113,SF-PF,105,152,569,TOT,.490
418,Luke Walton,30,.366,82,8,.235,34,62,30,4,58,38,.328,116,7,.700,10,54,0,484,9,38,91,SF,9,31,67,LAL,.362
419,Willie Warren,8,.400,20,5,.333,15,27,21,0,11,13,.371,35,6,.750,8,19,0,134,1,16,37,PG,6,8,12,LAC,.443
420,Hakim Warrick,227,.522,435,1,.091,11,69,28,9,208,228,.511,446,212,.721,294,80,6,1416,88,100,669,PF,32,79,296,PHO,.512
421,C.J. Watson,102,.362,282,44,.393,112,186,26,11,78,146,.371,394,69,.742,93,82,1,1091,16,82,405,PG,55,73,94,CHI,.426
422,Earl Watson,90,.450,200,36,.336,107,278,31,17,130,126,.410,307,55,.671,82,80,13,1567,52,146,343,PG,61,116,182,UTA,.469
423,Kyle Weaver,6,.333,18,3,.429,7,7,24,2,8,9,.360,25,7,.875,8,5,0,69,2,3,28,SG,2,7,10,UTA,.420
424,Martell Webster,97,.466,208,55,.417,132,53,24,9,111,152,.447,340,94,.770,122,46,1,1094,36,101,453,SF,28,58,147,MIN,.528
425,Sonny Weems,211,.467,452,17,.279,61,104,24,2,114,228,.444,513,72,.766,94,59,28,1413,39,87,545,SF,34,86,153,TOR,.461
426,David West,526,.510,1031,2,.222,9,164,30,62,374,528,.508,1040,264,.807,327,70,70,2451,155,202,1322,PF,67,142,529,NOH,.509
427,Delonte West,43,.494,87,12,.364,33,64,27,10,31,55,.458,120,13,.867,15,24,2,453,6,29,135,PG,20,30,37,BOS,.508
428,Mario West,8,.471,17,1,.250,4,10,26,0,9,9,.429,21,3,.600,5,6,3,116,2,13,22,SG,7,2,11,NJN,.452
429,Russell Westbrook,580,.451,1287,34,.330,103,670,22,30,258,614,.442,1390,531,.842,631,82,82,2847,121,207,1793,PG,155,316,379,OKC,.454
430,D.J. White,111,.512,217,0,.000,2,19,24,20,115,111,.507,219,46,.719,64,47,0,685,43,77,268,C-PF,12,14,158,TOT,.507
431,Hassan Whiteside,0,,0,0,,0,0,21,0,0,0,,0,0,,0,1,0,2,0,2,0,C,0,0,0,SAC,
432,Chris Wilcox,187,.583,321,0,.000,1,43,28,17,176,187,.581,322,50,.562,89,57,29,995,95,145,424,PF,29,43,271,DET,.581
433,Damien Wilkins,67,.528,127,2,.200,10,41,31,9,67,69,.504,137,40,.714,56,52,0,676,23,72,180,SF,27,21,90,ATL,.511
434,Deron Williams,323,.491,658,105,.331,317,667,26,15,220,428,.439,975,348,.845,412,65,65,2465,40,190,1309,PG,79,230,260,TOT,.493
435,Jason Williams,12,.414,29,10,.263,38,52,35,1,27,22,.328,67,0,,0,27,0,295,3,8,54,PG,11,18,30,TOT,.403
436,Jawad Williams,28,.346,81,13,.289,45,22,27,3,41,41,.325,126,9,.750,12,26,1,391,7,34,104,SF,9,16,48,CLE,.377
437,Lou Williams,235,.434,542,88,.348,253,252,24,17,117,323,.406,795,293,.823,356,75,0,1747,32,128,1027,SG,47,102,149,PHI,.462
438,Marvin Williams,209,.489,427,37,.336,110,88,24,23,245,246,.458,537,147,.845,174,65,52,1865,68,104,676,SF,34,62,313,ATL,.493
439,Mo Williams,212,.436,486,79,.324,244,380,28,10,132,291,.399,730,151,.853,177,58,56,1788,21,150,812,PG,53,171,153,TOT,.453
440,Reggie Williams,166,.502,331,102,.423,241,121,24,3,171,268,.469,572,100,.746,134,80,9,1626,45,124,738,SF,28,57,216,GSW,.558
441,Shawne Williams,79,.457,173,85,.401,212,47,24,51,179,164,.426,385,41,.837,49,64,11,1323,60,164,454,PF,39,46,239,NYK,.536
442,Shelden Williams,103,.468,220,0,,0,32,27,26,180,103,.468,220,58,.773,75,59,38,911,93,126,264,PF,23,43,273,TOT,.468
443,Terrence Williams,37,.398,93,6,.273,22,38,23,0,47,43,.374,115,14,.667,21,21,0,290,4,25,106,SG,9,33,51,TOT,.400
444,Metta World Peace,178,.419,425,83,.356,233,175,31,36,167,261,.397,658,92,.676,136,82,82,2410,100,181,697,SF,124,90,267,LAL,.460
445,Antoine Wright,1,.250,4,0,.000,4,0,26,0,1,1,.125,8,0,,0,7,0,31,2,3,2,SG,1,1,3,SAC,.125
446,Brandan Wright,60,.513,117,0,,0,12,23,17,58,60,.513,117,21,.677,31,37,2,379,31,34,141,PF,11,14,89,TOT,.513
447,Dorell Wright,291,.462,630,194,.376,516,242,25,63,343,485,.423,1146,180,.789,228,82,82,3147,88,171,1344,SF,124,133,431,GSW,.508
448,Julian Wright,80,.533,150,2,.200,10,58,23,20,71,82,.513,160,22,.512,43,52,6,766,47,45,188,SF,39,43,118,TOR,.519
449,Nick Young,307,.462,664,105,.387,271,75,25,17,148,412,.441,935,186,.816,228,64,40,2034,26,144,1115,SG,45,90,174,WAS,.497
450,Sam Young,216,.486,444,17,.340,50,71,25,23,147,233,.472,494,89,.767,116,78,46,1577,40,120,572,SF,68,61,187,MEM,.489
451,Thaddeus Young,452,.548,825,6,.273,22,82,22,26,281,458,.541,847,123,.707,174,82,1,2135,153,170,1045,PF,90,99,434,PHI,.544
