,Player_Name,2P,2P%,2PA,3P,3P%,3PA,AST,Age,BLK,DRB,FG,FG%,FGA,FT,FT%,FTA,Games,Games_Strated,Minutes_Played,ORB,PF,PTS,Position,STL,TOV,TRB,Team,eFG%
0,Jeff Adrien,7,.438,16,0,,0,1,25,2,17,7,.438,16,7,.583,12,8,0,63,5,13,21,PF,0,2,22,HOU,.438
1,Arron Afflalo,241,.504,478,88,.398,221,149,26,13,157,329,.471,699,197,.798,247,62,62,2086,40,134,943,SG,36,85,197,DEN,.534
2,Blake Ahearn,2,.400,5,2,.222,9,1,27,0,2,4,.286,14,0,,0,4,0,30,0,4,10,PG,0,5,2,UTA,.357
3,Solomon Alabi,13,.361,36,0,,0,3,23,9,32,13,.361,36,7,.875,8,14,0,122,15,11,33,C,2,5,47,TOR,.361
4,Cole Aldrich,22,.524,42,0,,0,3,23,16,35,22,.524,42,13,.929,14,26,0,173,13,22,57,C,8,9,48,OKC,.524
5,LaMarcus Aldridge,481,.516,932,2,.182,11,134,26,45,292,483,.512,943,223,.814,274,55,55,1994,150,153,1191,PF,51,111,442,POR,.513
6,Lavoy Allen,79,.473,167,0,,0,34,22,18,124,79,.473,167,11,.786,14,41,15,624,47,73,169,PF,13,20,171,PHI,.473
7,Ray Allen,120,.463,259,106,.453,234,109,36,8,128,226,.458,493,97,.915,106,46,42,1565,14,83,655,SG,49,68,142,BOS,.566
8,Tony Allen,202,.479,422,8,.308,26,79,30,33,135,210,.469,448,140,.800,175,58,57,1525,98,142,568,SG,104,94,233,MEM,.478
9,Morris Almond,5,.357,14,1,.333,3,2,26,0,7,6,.353,17,1,.333,3,4,0,67,1,6,14,SG,7,1,8,WAS,.382
10,Al-Farouq Aminu,137,.431,318,13,.277,47,66,21,34,213,150,.411,365,86,.754,114,66,21,1477,95,136,399,SF,59,91,308,NOH,.429
11,Lou Amundson,89,.430,207,0,,0,14,29,44,128,89,.430,207,35,.427,82,60,0,753,94,125,213,PF,27,45,222,IND,.430
12,Chris Andersen,59,.546,108,0,,0,6,33,46,100,59,.546,108,50,.610,82,32,1,486,48,52,168,C,19,17,148,DEN,.546
13,Alan Anderson,31,.383,81,24,.393,61,26,29,3,26,55,.387,142,29,.853,34,17,12,461,8,35,163,SF,5,25,34,TOR,.472
14,James Anderson,47,.443,106,19,.279,68,41,22,2,63,66,.379,174,39,.750,52,51,2,603,16,35,190,SG,8,30,79,SAS,.434
15,Ryan Anderson,166,.496,335,166,.393,422,54,23,26,247,332,.439,757,150,.877,171,61,61,1964,224,146,980,PF,50,57,471,ORL,.548
16,Carmelo Anthony,373,.454,822,68,.335,203,200,27,24,256,441,.430,1025,295,.804,367,55,55,1876,88,156,1245,SF,62,144,344,NYK,.463
17,Joel Anthony,85,.559,152,0,,0,9,29,84,150,85,.559,152,49,.690,71,64,51,1349,100,126,219,C,36,45,250,MIA,.559
18,Gilbert Arenas,13,.520,25,13,.333,39,18,30,1,16,26,.406,64,7,.700,10,17,0,211,2,35,72,PG,11,12,18,MEM,.508
19,Trevor Ariza,139,.440,316,29,.333,87,135,26,25,174,168,.417,403,79,.775,102,41,41,1350,41,73,444,SF,69,76,215,NOH,.453
20,Omer Asik,79,.506,156,0,,0,32,25,68,223,79,.506,156,47,.456,103,66,2,971,127,121,205,C,30,68,350,CHI,.506
21,D.J. Augustin,122,.396,308,61,.341,179,307,24,1,85,183,.376,487,105,.875,120,48,46,1408,24,65,532,PG,36,110,109,CHA,.438
22,Gustavo Ayon,140,.538,260,0,.000,1,74,26,46,179,140,.536,261,39,.619,63,54,24,1088,86,118,319,PF,53,46,265,NOH,.536
23,Jeff Ayres,15,.417,36,0,,0,4,24,2,21,15,.417,36,4,.571,7,20,1,106,12,16,34,C,3,2,33,IND,.417
24,Kelenna Azubuike,2,.400,5,1,.333,3,0,28,0,0,3,.375,8,0,,0,3,0,18,0,1,7,SG,1,4,0,DAL,.438
25,Luke Babbitt,28,.384,73,43,.430,100,16,22,4,79,71,.410,173,17,.850,20,40,4,537,16,46,202,SF,10,27,95,POR,.535
26,Renaldo Balkman,14,.609,23,2,.222,9,5,27,3,20,16,.500,32,8,.727,11,14,0,115,6,14,42,SF,4,6,26,NYK,.531
27,Leandro Barbosa,206,.441,467,65,.382,170,96,29,7,95,271,.425,637,101,.815,124,64,0,1382,33,135,708,SG,56,94,128,TOT,.476
28,J.J. Barea,114,.415,275,53,.371,143,232,27,0,100,167,.400,418,76,.776,98,41,11,1032,14,61,463,PG,21,103,114,MIN,.463
29,Andrea Bargnani,175,.474,369,34,.296,115,61,26,15,148,209,.432,484,151,.873,173,31,31,1032,24,52,603,C,18,69,172,TOR,.467
30,Matt Barnes,129,.518,249,46,.333,138,126,31,48,247,175,.452,387,95,.742,128,63,16,1440,97,152,491,SF,35,73,344,LAL,.512
31,Earl Barron,2,.500,4,0,,0,0,30,0,0,2,.500,4,0,,0,2,0,9,1,5,4,C,0,0,1,GSW,.500
32,Brandon Bass,303,.479,632,0,,0,55,26,54,270,303,.479,632,132,.810,163,59,39,1868,95,135,738,PF,34,65,365,BOS,.479
33,Tony Battie,19,.380,50,0,.000,1,16,35,6,59,19,.373,51,4,1.000,4,27,11,295,8,26,42,C,4,4,67,PHI,.373
34,Shane Battier,51,.468,109,62,.339,183,82,33,33,100,113,.387,292,23,.622,37,65,10,1499,56,105,311,SF,64,37,156,MIA,.493
35,Nicolas Batum,182,.496,367,107,.391,274,84,23,60,190,289,.451,641,133,.836,159,59,34,1791,81,105,818,SF,57,90,271,POR,.534
36,Jerryd Bayless,73,.424,172,44,.423,104,118,23,4,58,117,.424,276,75,.852,88,31,11,705,8,70,353,PG,24,53,66,TOR,.504
37,Michael Beasley,183,.462,396,38,.376,101,45,23,19,168,221,.445,497,61,.642,95,47,7,1087,39,83,541,SF,18,80,207,MIN,.483
38,Rodrigue Beaubois,150,.479,313,38,.288,132,152,23,28,132,188,.422,445,58,.841,69,53,12,1151,19,98,472,PG,56,70,151,DAL,.465
39,Marco Belinelli,179,.445,402,107,.377,284,101,25,5,153,286,.417,686,101,.783,129,66,55,1966,19,115,780,SG,48,69,172,NOH,.495
40,Raja Bell,47,.540,87,34,.391,87,38,35,2,43,81,.466,174,21,.840,25,34,33,796,6,78,217,SG,13,21,49,UTA,.563
41,Keith Benson,0,.000,1,0,,0,0,23,0,1,0,.000,1,0,,0,3,0,9,2,0,0,C,0,0,3,GSW,.000
42,Mike Bibby,8,.205,39,27,.318,85,80,33,3,54,35,.282,124,6,.750,8,39,4,557,5,45,103,PG,21,20,59,NYK,.391
43,Andris Biedrins,39,.609,64,0,,0,16,25,45,131,39,.609,64,1,.111,9,47,35,739,45,125,79,C,23,14,176,GSW,.609
44,Chauncey Billups,35,.340,103,48,.384,125,80,35,3,46,83,.364,228,85,.895,95,20,20,607,4,40,299,SG,9,38,50,LAC,.469
45,Bismack Biyombo,129,.464,278,0,,0,27,19,115,255,129,.464,278,69,.483,143,63,41,1455,113,145,327,C,20,71,368,CHA,.464
46,DeJuan Blair,269,.535,503,0,.000,1,78,22,12,197,269,.534,504,73,.613,119,64,62,1363,154,168,611,PF,59,92,351,SAS,.534
47,Steve Blake,48,.436,110,53,.335,158,175,31,2,76,101,.377,268,21,.778,27,53,5,1237,9,75,276,PG,39,72,85,LAL,.476
48,Andray Blatche,91,.382,238,2,.286,7,28,25,17,108,93,.380,245,33,.673,49,26,13,626,42,54,221,PF,20,37,150,WAS,.384
49,Eric Bledsoe,43,.448,96,6,.200,30,66,22,14,43,49,.389,126,28,.636,44,40,1,464,22,58,132,PG,31,47,65,LAC,.413
50,Keith Bogans,5,.556,9,3,.250,12,3,31,0,6,8,.381,21,2,.400,5,5,1,94,5,15,21,SF,2,3,11,NJN,.452
51,Andrew Bogut,61,.452,135,0,.000,1,31,27,24,78,61,.449,136,14,.609,23,12,12,364,22,36,136,C,12,24,100,MIL,.449
52,Matt Bonner,49,.490,100,105,.420,250,61,31,21,185,154,.440,350,16,.762,21,65,2,1326,29,68,429,PF,15,14,214,SAS,.590
53,Trevor Booker,180,.531,339,1,.500,2,40,24,43,206,181,.531,341,56,.602,93,50,32,1261,119,138,419,PF,48,58,325,WAS,.532
54,Carlos Boozer,448,.533,841,0,.000,1,125,30,24,450,448,.532,842,95,.693,137,66,66,1948,114,168,991,PF,63,115,564,CHI,.532
55,Chris Bosh,383,.496,772,10,.286,35,103,27,45,358,393,.487,807,229,.821,279,57,57,2007,94,128,1025,PF,51,117,452,MIA,.493
56,Earl Boykins,10,.370,27,2,.222,9,17,35,0,11,12,.333,36,13,.867,15,8,0,111,0,5,39,PG,1,7,11,HOU,.361
57,Craig Brackins,6,.250,24,3,.333,9,8,24,1,10,9,.273,33,1,.500,2,14,1,88,5,6,22,PF,0,4,15,PHI,.318
58,Avery Bradley,178,.511,348,22,.407,54,87,21,12,81,200,.498,402,62,.795,78,64,28,1368,34,109,484,PG,43,75,115,BOS,.525
59,Elton Brand,287,.495,580,0,.000,1,97,32,97,284,287,.494,581,85,.733,116,60,60,1732,145,176,659,C,58,65,429,PHI,.494
60,Corey Brewer,168,.500,336,33,.260,127,88,25,17,107,201,.434,463,90,.692,130,59,17,1287,43,113,525,SF,72,56,150,DEN,.470
61,Ronnie Brewer,171,.455,376,19,.275,69,137,26,21,159,190,.427,445,56,.560,100,66,43,1635,72,64,455,SG,72,59,231,CHI,.448
62,Jon Brockman,15,.341,44,0,.000,1,9,24,1,42,15,.333,45,7,.467,15,35,0,239,33,33,37,PF,4,10,75,MIL,.333
63,MarShon Brooks,227,.463,490,47,.313,150,131,23,15,130,274,.428,640,113,.764,148,56,47,1648,70,116,708,SG,52,118,200,NJN,.465
64,Derrick Brown,206,.535,385,6,.250,24,67,24,12,141,212,.518,409,94,.667,141,65,17,1443,95,96,524,SF,48,55,236,CHA,.526
65,Kwame Brown,21,.525,40,0,,0,4,29,0,41,21,.525,40,15,.441,34,9,3,187,16,21,57,C,8,14,57,GSW,.525
66,Shannon Brown,183,.446,410,68,.362,188,69,26,15,119,251,.420,598,80,.808,99,59,19,1400,38,66,650,SG,44,64,157,PHO,.477
67,Kobe Bryant,487,.464,1049,87,.303,287,264,33,18,247,574,.430,1336,381,.845,451,58,58,2232,66,105,1616,SG,69,204,313,LAL,.462
68,Chase Budinger,120,.476,252,88,.402,219,74,23,7,179,208,.442,471,54,.771,70,58,9,1298,38,65,558,SF,29,55,217,HOU,.535
69,Alec Burks,138,.442,312,15,.333,45,55,20,5,75,153,.429,357,104,.727,143,59,0,939,57,84,425,SG,27,51,132,UTA,.450
70,Caron Butler,195,.435,448,92,.358,257,78,31,9,186,287,.407,705,87,.813,107,63,63,1871,44,123,753,SF,52,77,230,LAC,.472
71,Jimmy Butler,30,.441,68,2,.182,11,14,22,5,33,32,.405,79,43,.768,56,42,0,359,23,20,109,SG,11,14,56,CHI,.418
72,Rasual Butler,20,.357,56,21,.273,77,19,32,5,60,41,.308,133,7,.583,12,34,14,453,6,39,110,SF,7,15,66,TOR,.387
73,Derrick Byars,3,.600,5,0,.000,6,1,27,0,5,3,.273,11,4,1.000,4,2,0,37,6,2,10,PF,2,0,11,SAS,.273
74,Andrew Bynum,443,.560,791,1,.200,5,85,24,116,517,444,.558,796,234,.692,338,60,60,2112,192,104,1123,C,27,152,709,LAL,.558
75,Will Bynum,67,.406,165,7,.241,29,66,29,3,46,74,.381,194,49,.766,64,36,0,514,10,61,204,PG,23,54,56,DET,.399
76,Jose Calderon,159,.500,318,59,.371,159,468,30,3,141,218,.457,477,60,.882,68,53,53,1799,19,94,555,PG,47,104,160,TOR,.519
77,Marcus Camby,126,.447,282,2,.400,5,107,37,85,373,128,.446,287,29,.453,64,59,53,1352,157,126,287,C,50,57,530,TOT,.449
78,Brian Cardinal,4,.667,6,10,.204,49,16,34,2,30,14,.255,55,5,.833,6,44,0,277,4,38,43,SF,8,8,34,DAL,.345
79,DeMarre Carroll,36,.419,86,7,.368,19,18,25,1,25,43,.410,105,14,.875,16,24,9,348,28,37,107,SF-PF,12,11,53,TOT,.443
80,Matt Carroll,44,.386,114,8,.186,43,38,31,7,50,52,.331,157,30,.789,38,53,2,596,8,52,142,SG,16,24,58,CHA,.357
81,Anthony Carter,12,.333,36,5,.294,17,34,36,4,28,17,.321,53,8,.800,10,24,0,209,5,20,47,PG,8,17,33,TOR,.368
82,Vince Carter,149,.442,337,74,.361,205,139,35,25,173,223,.411,542,95,.826,115,61,40,1542,32,134,615,SG,56,84,205,DAL,.480
83,Omri Casspi,113,.463,244,53,.315,168,66,23,21,165,166,.403,412,74,.685,108,65,35,1341,63,115,459,SF,37,64,228,CLE,.467
84,Mario Chalmers,122,.513,238,101,.388,260,222,25,11,155,223,.448,498,80,.792,101,64,64,1825,16,166,627,PG,97,142,171,MIA,.549
85,Tyson Chandler,241,.683,353,0,.000,2,56,29,89,400,241,.679,355,217,.689,315,62,62,2061,212,186,699,C,56,102,612,NYK,.679
86,Wilson Chandler,28,.418,67,3,.250,12,17,24,6,35,31,.392,79,10,.833,12,8,6,215,6,18,75,SF,6,18,41,DEN,.411
87,Josh Childress,44,.587,75,4,.167,24,34,28,6,64,48,.485,99,0,.000,2,34,0,491,31,38,100,SF,14,9,95,PHO,.505
88,Earl Clark,51,.367,139,0,,0,18,24,32,89,51,.367,139,21,.724,29,45,1,559,35,72,123,PF,12,25,124,ORL,.367
89,Norris Cole,156,.417,374,21,.276,76,133,23,2,70,177,.393,450,66,.776,85,65,2,1260,21,124,441,PG,44,105,91,MIA,.417
90,Jason Collins,16,.400,40,0,,0,10,33,3,36,16,.400,40,7,.467,15,30,10,308,12,34,39,C,4,10,48,ATL,.400
91,Darren Collison,196,.457,429,34,.362,94,287,24,14,157,230,.440,523,127,.830,153,60,56,1878,30,101,621,PG,49,114,187,IND,.472
92,Nick Collison,120,.600,200,0,.000,1,82,31,28,155,120,.597,201,44,.710,62,63,0,1307,119,153,284,PF,33,61,274,OKC,.597
93,Mike Conley,236,.450,525,60,.377,159,404,24,11,134,296,.433,684,136,.861,158,62,61,2174,22,133,788,PG,136,125,156,MEM,.477
94,Brian Cook,21,.438,48,10,.200,50,10,31,5,53,31,.316,98,9,.900,10,32,0,276,10,48,81,PF,6,11,63,TOT,.367
95,Daequan Cook,30,.441,68,79,.346,228,15,24,11,110,109,.368,296,14,.636,22,57,22,989,12,69,311,SG,22,16,122,OKC,.502
96,DeMarcus Cousins,446,.453,985,2,.143,14,102,21,75,438,448,.448,999,262,.702,373,64,62,1950,265,257,1160,C,93,170,703,SAC,.449
97,Jamal Crawford,203,.426,477,80,.308,260,191,31,14,102,283,.384,737,191,.927,206,60,6,1613,16,74,837,PG,55,111,118,POR,.438
98,Jordan Crawford,270,.451,599,79,.289,273,190,23,5,124,349,.400,872,161,.793,203,64,32,1753,44,111,938,SG,59,141,168,WAS,.446
99,Dante Cunningham,144,.520,277,0,.000,2,37,24,34,155,144,.516,279,45,.652,69,64,5,1124,91,98,333,PF,42,29,246,MEM,.516
100,Eddy Curry,12,.462,26,0,,0,1,29,2,8,12,.462,26,6,.750,8,14,1,83,4,17,30,C,0,10,12,MIA,.462
101,Stephen Curry,90,.514,175,55,.455,121,138,23,8,73,145,.490,296,38,.809,47,26,23,732,15,62,383,PG,39,65,88,GSW,.583
102,Samuel Dalembert,200,.508,394,0,.000,1,33,30,111,298,200,.506,395,90,.796,113,65,45,1446,158,162,490,C,37,82,456,HOU,.506
103,Erick Dampier,1,.125,8,0,,0,4,36,4,15,1,.125,8,0,,0,15,0,83,10,9,2,C,1,3,25,ATL,.125
104,Marquis Daniels,52,.391,133,0,.000,10,47,31,9,50,52,.364,143,17,.739,23,38,0,484,16,36,121,SG,21,28,66,BOS,.364
105,Baron Davis,42,.424,99,26,.306,85,135,32,3,43,68,.370,184,16,.667,24,29,14,595,13,61,178,PG,34,76,56,NYK,.440
106,Ed Davis,172,.515,334,0,.000,1,60,22,63,304,172,.513,335,71,.670,106,66,9,1534,134,156,415,PF,40,67,438,TOR,.513
107,Glen Davis,223,.429,520,2,.143,14,47,26,19,224,225,.421,534,114,.683,167,61,13,1427,107,106,566,PF,43,75,331,ORL,.423
108,Josh Davis,6,.429,14,4,.308,13,6,31,1,11,10,.370,27,4,.500,8,15,0,130,16,19,28,PF,7,3,27,MEM,.444
109,Eric Dawson,7,.583,12,0,,0,0,27,2,5,7,.583,12,1,.500,2,4,0,39,5,6,15,C,1,3,10,SAS,.583
110,Austin Daye,60,.364,165,13,.210,62,33,23,21,77,73,.322,227,35,.814,43,41,4,603,14,62,194,SF,22,40,91,DET,.350
111,Carlos Delfino,96,.449,214,86,.360,239,123,29,10,188,182,.402,453,38,.792,48,54,53,1537,20,99,488,SF,79,66,208,MIL,.497
112,Luol Deng,232,.430,540,79,.367,215,157,26,36,273,311,.412,755,127,.770,165,54,54,2129,77,81,828,SF,56,96,350,CHI,.464
113,Justin Dentmon,8,.571,14,2,.143,14,10,26,0,8,10,.357,28,4,.667,6,6,0,91,0,10,26,PG,2,7,8,TOT,.393
114,DeMar DeRozan,357,.440,811,24,.261,92,128,22,17,171,381,.422,903,268,.810,331,63,63,2206,40,162,1054,SG,48,123,211,TOR,.435
115,Boris Diaw,125,.496,252,31,.313,99,205,29,25,210,156,.444,351,22,.629,35,57,35,1424,70,125,365,PF,34,112,280,TOT,.489
116,Ike Diogu,0,.000,2,0,,0,0,28,0,1,0,.000,2,2,1.000,2,2,0,14,0,1,2,PF,0,1,1,SAS,.000
117,DeSagana Diop,15,.357,42,0,,0,23,30,13,52,15,.357,42,1,.167,6,27,9,325,33,36,31,C,6,19,85,CHA,.357
118,Keyon Dooling,39,.476,82,27,.333,81,51,31,2,36,66,.405,163,23,.742,31,46,2,662,3,57,182,SG,13,34,39,BOS,.488
119,Toney Douglas,67,.387,173,27,.231,117,77,25,1,56,94,.324,290,22,.846,26,38,9,656,16,55,237,PG,29,56,72,NYK,.371
120,Goran Dragic,209,.525,398,68,.337,202,351,25,10,115,277,.462,600,153,.805,190,66,28,1752,53,166,775,PG,85,157,168,HOU,.518
121,Jared Dudley,232,.535,434,80,.383,209,112,26,19,206,312,.485,643,119,.726,164,65,60,2020,95,107,823,SG,49,72,301,PHO,.547
122,Chris Duhon,35,.417,84,50,.420,119,151,29,9,88,85,.419,203,17,.810,21,63,9,1226,14,71,237,PG,35,81,102,ORL,.542
123,Tim Duncan,361,.495,729,0,.000,4,132,35,88,410,361,.492,733,173,.695,249,58,58,1634,110,98,895,C,38,97,520,SAS,.492
124,Mike Dunleavy,156,.527,296,83,.399,208,117,31,8,175,239,.474,504,116,.811,143,55,3,1445,29,87,677,SF,28,58,204,MIL,.557
125,Kevin Durant,510,.535,953,133,.387,344,231,23,77,487,643,.496,1297,431,.860,501,66,66,2546,40,133,1850,SF,88,248,527,OKC,.547
126,Jerome Dyson,18,.450,40,1,.125,8,18,24,2,17,19,.396,48,28,.778,36,9,1,180,2,19,67,PG,11,20,19,NOH,.406
127,Devin Ebanks,37,.463,80,0,.000,9,12,22,6,28,37,.416,89,23,.657,35,24,12,396,26,26,97,SG,11,18,54,LAL,.416
128,Wayne Ellington,87,.448,194,35,.324,108,33,24,10,85,122,.404,302,32,.800,40,51,4,973,14,56,311,SG,26,26,99,MIN,.462
129,Monta Ellis,388,.462,839,62,.308,201,346,26,18,180,450,.433,1040,219,.796,275,58,58,2120,20,136,1181,SG,85,177,200,TOT,.463
130,Francisco Elson,1,.333,3,0,,0,1,35,1,1,1,.333,3,0,,0,5,0,16,0,0,2,C,1,1,1,PHI,.333
131,Andre Emmett,4,.667,6,0,.000,1,1,29,1,4,4,.571,7,5,.625,8,6,0,45,2,2,13,SF,2,2,6,NJN,.571
132,Semih Erden,39,.527,74,0,,0,9,25,5,52,39,.527,74,21,.512,41,28,9,333,20,60,99,C,10,16,72,CLE,.527
133,Jeremy Evans,27,.659,41,0,.000,1,13,24,24,31,27,.643,42,8,.500,16,29,0,217,19,23,62,SF,6,5,50,UTA,.643
134,Maurice Evans,28,.418,67,17,.378,45,9,33,0,16,45,.402,112,10,.769,13,24,0,343,8,36,117,SF,14,10,24,WAS,.478
135,Reggie Evans,34,.472,72,0,,0,17,31,6,171,34,.472,72,36,.507,71,56,0,771,100,118,104,PF,31,44,271,LAC,.472
136,Tyreke Evans,388,.484,801,20,.202,99,283,22,29,225,408,.453,900,201,.779,258,63,61,2162,64,136,1037,SG,84,171,289,SAC,.464
137,Christian Eyenga,5,.227,22,1,.333,3,5,22,5,10,6,.240,25,4,.500,8,7,0,102,4,7,17,SF,3,3,14,TOT,.260
138,Kenneth Faried,181,.586,309,0,,0,36,22,47,210,181,.586,309,109,.665,164,46,39,1037,142,116,471,PF,34,54,352,DEN,.586
139,Jordan Farmar,92,.484,190,55,.440,125,129,25,2,54,147,.467,315,57,.905,63,39,5,831,7,49,406,PG,24,68,61,NJN,.554
140,Derrick Favors,222,.499,445,0,,0,43,20,65,267,222,.499,445,126,.649,194,65,9,1376,158,145,570,PF,38,103,425,UTA,.499
141,Raymond Felton,199,.453,439,62,.305,203,390,27,10,122,261,.407,642,100,.806,124,60,56,1906,27,122,684,PG,78,170,149,POR,.455
142,Rudy Fernandez,59,.573,103,40,.328,122,75,26,3,56,99,.440,225,30,.698,43,31,1,710,9,37,268,SG,31,40,65,DEN,.529
143,Kyrylo Fesenko,2,.400,5,0,,0,1,25,0,7,2,.400,5,4,.667,6,3,0,17,2,2,8,C,2,0,9,IND,.400
144,Landry Fields,205,.523,392,31,.256,121,169,23,17,219,236,.460,513,77,.562,137,66,62,1894,59,99,580,SG,79,102,278,NYK,.490
145,Derek Fisher,94,.393,239,35,.321,109,170,37,4,109,129,.371,348,57,.851,67,63,43,1508,12,117,350,PG,51,73,121,TOT,.421
146,Jonny Flynn,36,.371,97,10,.294,34,96,22,2,31,46,.351,131,29,.744,39,29,1,416,8,23,131,PG,6,36,39,TOT,.389
147,Jeff Foote,2,.333,6,0,,0,0,24,1,5,2,.333,6,0,,0,4,0,39,1,5,4,C,0,2,6,NOH,.333
148,Gary Forbes,83,.441,188,29,.349,83,54,26,4,75,112,.413,271,66,.725,91,48,2,713,27,56,319,SG,24,54,102,TOR,.467
149,T.J. Ford,17,.486,35,2,.250,8,45,28,2,15,19,.442,43,11,.786,14,14,0,191,3,23,51,PG,9,23,18,SAS,.465
150,Courtney Fortson,8,.421,19,3,.231,13,10,23,0,9,11,.344,32,10,.667,15,10,0,95,6,5,35,PG,3,10,15,TOT,.391
151,Jeff Foster,8,.471,17,1,1.000,1,4,35,1,24,9,.500,18,6,.667,9,11,0,141,18,26,25,C,8,7,42,IND,.528
152,Randy Foye,129,.410,315,127,.386,329,146,28,24,113,256,.398,644,73,.859,85,65,48,1682,25,130,712,SG,46,73,138,LAC,.496
153,Jimmer Fredette,94,.409,230,78,.361,216,108,22,3,56,172,.386,446,40,.833,48,61,7,1135,17,73,462,PG,30,67,73,SAC,.473
154,Channing Frye,164,.469,350,91,.346,263,88,28,70,308,255,.416,613,73,.890,82,64,59,1669,71,176,674,PF,42,63,379,PHO,.490
155,Dan Gadzuric,0,.000,2,0,,0,0,33,1,4,0,.000,2,0,.000,2,2,0,13,1,4,0,C,1,1,5,NYK,.000
156,Sundiata Gaines,74,.392,189,28,.341,82,126,25,2,81,102,.376,271,59,.615,96,57,12,793,27,58,291,SG,55,52,108,NJN,.428
157,Danilo Gallinari,133,.470,283,60,.328,183,116,23,23,174,193,.414,466,182,.871,209,43,40,1351,28,86,628,SF,42,68,202,DEN,.479
158,Francisco Garcia,48,.490,98,38,.290,131,31,30,37,88,86,.376,229,24,.800,30,49,3,798,11,73,234,SF,36,22,99,SAC,.459
159,Kevin Garnett,388,.505,768,3,.333,9,175,35,61,428,391,.503,777,162,.857,189,60,60,1864,66,141,947,C,56,107,494,BOS,.505
160,Marc Gasol,356,.489,728,1,.083,12,204,27,121,459,357,.482,740,237,.748,317,65,65,2370,120,201,952,C,62,121,579,MEM,.483
161,Pau Gasol,452,.508,890,7,.259,27,237,31,88,495,459,.501,917,204,.782,261,65,65,2430,183,127,1129,PF,37,142,678,LAL,.504
162,Rudy Gay,431,.482,894,54,.312,173,147,25,55,287,485,.455,1067,208,.791,263,65,65,2422,130,138,1232,SF,95,161,417,MEM,.480
163,Alonzo Gee,183,.442,414,44,.321,137,113,24,17,221,227,.412,551,167,.788,212,63,31,1827,101,149,665,SG,83,114,322,CLE,.452
164,Paul George,191,.472,405,90,.385,234,158,21,38,314,281,.440,639,146,.802,182,66,66,1958,56,191,798,SG,108,117,370,IND,.510
165,Daniel Gibson,32,.294,109,55,.396,139,76,25,16,90,87,.351,248,34,.791,43,35,7,916,11,69,263,SG,26,45,101,CLE,.462
166,Taj Gibson,200,.495,404,0,,0,47,26,81,197,200,.495,404,84,.622,135,63,0,1284,135,131,484,PF,27,60,332,CHI,.495
167,Manu Ginobili,98,.616,159,52,.413,126,151,34,12,98,150,.526,285,88,.871,101,34,7,792,18,56,440,SG,24,64,116,SAS,.618
168,Mickell Gladness,25,.424,59,0,,0,5,25,20,44,25,.424,59,6,.500,12,26,7,252,14,32,56,PF,4,7,58,TOT,.424
169,Ryan Gomes,27,.409,66,4,.138,29,12,29,0,47,31,.326,95,8,.727,11,32,2,425,14,34,74,SF,16,15,61,LAC,.347
170,Drew Gooden,271,.450,602,16,.291,55,144,30,34,233,287,.437,657,176,.846,208,56,46,1469,130,112,766,C,46,109,363,MIL,.449
171,Ben Gordon,171,.446,383,63,.429,147,127,28,11,107,234,.442,530,117,.860,136,52,21,1398,14,114,648,SG,34,115,121,DET,.501
172,Eric Gordon,53,.530,100,10,.250,40,31,23,4,23,63,.450,140,49,.754,65,9,9,310,2,20,185,PG,13,24,25,NOH,.486
173,Marcin Gortat,427,.557,767,0,.000,2,59,27,99,474,427,.555,769,163,.649,251,66,66,2114,185,142,1017,C,48,90,659,PHO,.555
174,Andrew Goudelock,40,.404,99,28,.373,75,20,23,0,26,68,.391,174,11,.917,12,40,0,419,5,32,175,SG,4,21,31,LAL,.471
175,Danny Granger,268,.434,618,123,.381,323,109,28,40,228,391,.416,941,254,.873,291,62,62,2062,79,144,1159,SF,62,110,307,IND,.481
176,Aaron Gray,83,.516,161,0,,0,27,27,17,198,83,.516,161,25,.532,47,49,40,813,83,127,191,C,22,51,281,TOR,.516
177,Danny Green,109,.449,243,102,.436,234,86,24,46,174,211,.442,477,79,.790,100,66,38,1522,54,107,603,SG,58,67,228,SAS,.549
178,Gerald Green,111,.529,210,43,.391,110,34,26,17,93,154,.481,320,49,.754,65,31,2,781,15,80,400,SF,28,55,108,NJN,.548
179,Willie Green,103,.486,212,50,.442,113,40,30,6,65,153,.471,325,48,.857,56,53,2,922,15,74,404,SG,23,33,80,ATL,.548
180,Donte Greene,83,.516,161,25,.238,105,34,23,29,114,108,.406,266,44,.800,55,53,7,777,19,67,285,PF,18,32,133,SAC,.453
181,Blake Griffin,559,.556,1006,2,.125,16,210,22,48,499,561,.549,1022,244,.521,468,66,66,2392,218,216,1368,PF,54,150,717,LAC,.550
182,Hamed Haddadi,26,.553,47,0,.000,1,8,26,26,43,26,.542,48,18,.692,26,35,0,206,28,43,70,C,1,21,71,MEM,.542
183,Jordan Hamilton,31,.484,64,17,.362,47,20,21,3,51,48,.432,111,2,.400,5,26,2,258,11,15,115,SF,4,16,62,DEN,.509
184,Richard Hamilton,123,.466,264,17,.370,46,84,33,1,46,140,.452,310,29,.784,37,28,28,697,20,56,326,SG,12,49,66,CHI,.479
185,Tyler Hansbrough,194,.406,478,0,.000,1,30,26,9,177,194,.405,479,226,.813,278,66,0,1442,113,159,614,PF,54,65,290,IND,.405
186,Luke Harangody,18,.409,44,5,.238,21,6,24,3,33,23,.354,65,9,.750,12,21,1,231,20,17,60,PF,6,4,53,CLE,.392
187,James Harden,195,.579,337,114,.390,292,229,22,15,222,309,.491,629,312,.846,369,62,2,1946,30,150,1044,SG,62,137,252,OKC,.582
188,Justin Harper,7,.389,18,2,.154,13,2,22,3,9,9,.290,31,0,.000,1,14,0,84,3,5,20,PF,2,6,12,ORL,.323
189,Josh Harrellson,43,.478,90,20,.339,59,11,22,20,97,63,.423,149,16,.615,26,37,4,540,47,48,162,PF,23,20,144,NYK,.490
190,Al Harrington,244,.519,470,101,.333,303,88,31,12,318,345,.446,773,119,.676,176,64,1,1761,72,181,910,PF,58,112,390,DEN,.512
191,Devin Harris,164,.498,329,77,.362,213,316,28,13,100,241,.445,542,156,.746,209,63,63,1741,12,136,715,PG,64,122,112,UTA,.516
192,Manny Harris,48,.421,114,12,.333,36,31,22,6,59,60,.400,150,41,.695,59,26,5,456,11,28,173,SG,13,27,70,CLE,.440
193,Terrel Harris,21,.477,44,8,.205,39,26,24,2,33,29,.349,83,14,.667,21,22,1,318,18,34,80,SG,9,25,51,MIA,.398
194,Tobias Harris,73,.500,146,6,.261,23,22,19,7,71,79,.467,169,44,.815,54,42,9,479,30,45,208,SF,13,31,101,MIL,.485
195,Udonis Haslem,151,.423,357,0,,0,42,31,24,353,151,.423,357,83,.814,102,64,10,1589,117,142,385,PF,35,60,470,MIA,.423
196,Spencer Hawes,153,.498,307,3,.250,12,98,23,48,192,156,.489,319,40,.727,55,37,29,920,78,100,355,C,16,55,270,PHI,.494
197,Chuck Hayes,73,.435,168,0,.000,2,77,28,17,162,73,.429,170,26,.667,39,54,9,1039,72,111,172,C,36,50,234,SAC,.429
198,Gordon Hayward,212,.496,427,55,.346,159,207,21,41,171,267,.456,586,193,.832,232,66,58,2015,59,106,782,SF,53,109,230,UTA,.503
199,Lazar Hayward,9,.375,24,4,.286,14,4,25,1,14,13,.342,38,7,.583,12,26,0,141,2,18,37,SF,3,9,16,OKC,.395
200,Brendan Haywood,118,.518,228,0,,0,19,32,54,185,118,.518,228,45,.469,96,54,54,1146,139,121,281,C,24,46,324,DAL,.518
201,Gerald Henderson,321,.475,676,11,.234,47,126,24,20,161,332,.459,723,155,.760,204,55,55,1831,64,128,830,SG,49,100,225,CHA,.467
202,Xavier Henry,83,.393,211,7,.412,17,35,20,8,82,90,.395,228,52,.612,85,45,0,759,24,59,239,SG,26,35,106,NOH,.410
203,Roy Hibbert,332,.498,667,0,.000,1,108,25,128,359,332,.497,668,170,.711,239,65,65,1937,213,195,834,C,32,128,572,IND,.497
204,J.J. Hickson,183,.469,390,0,.000,2,45,23,35,202,183,.467,392,86,.642,134,54,19,1244,133,85,452,PF,30,70,335,TOT,.467
205,Cory Higgins,48,.343,140,4,.200,20,36,22,6,28,52,.325,160,42,.700,60,38,0,423,7,40,150,PG,5,39,35,CHA,.338
206,Nene Hilario,211,.542,389,0,.000,4,80,29,38,228,211,.537,393,113,.673,168,39,33,1110,63,95,535,C,42,96,291,TOT,.537
207,George Hill,114,.489,233,54,.367,147,145,25,17,120,168,.442,380,91,.778,117,50,9,1274,31,98,481,PG,42,52,151,IND,.513
208,Grant Hill,187,.470,398,14,.264,53,107,39,29,142,201,.446,451,83,.761,109,49,46,1378,29,88,499,SF,41,65,171,PHO,.461
209,Jordan Hill,82,.506,162,0,.000,3,16,24,27,125,82,.497,165,30,.638,47,39,8,551,61,71,194,C,14,31,186,TOT,.497
210,Kirk Hinrich,75,.472,159,47,.346,136,132,31,11,90,122,.414,295,25,.781,32,48,31,1237,11,100,316,SG,38,58,101,ATL,.493
211,Darington Hobson,2,.286,7,0,.000,6,6,24,0,3,2,.154,13,0,,0,5,0,39,0,1,4,SG,0,2,3,MIL,.154
212,Jrue Holiday,295,.445,663,65,.380,171,290,21,18,155,360,.432,834,94,.783,120,65,65,2196,57,137,879,PG,103,135,212,PHI,.471
213,Ryan Hollins,46,.548,84,0,,0,9,27,17,48,46,.548,84,39,.520,75,39,8,522,34,78,131,C,5,35,82,TOT,.548
214,Tyler Honeycutt,7,.333,21,1,.333,3,7,21,3,11,8,.333,24,3,.600,5,15,0,88,3,3,20,SF,4,2,14,SAC,.354
215,Al Horford,57,.559,102,0,.000,1,24,25,14,51,57,.553,103,22,.733,30,11,11,348,26,21,136,C,10,16,77,ATL,.553
216,Dennis Horner,1,.333,3,0,.000,1,0,23,0,3,1,.250,4,3,.750,4,8,0,22,2,1,5,PF,0,1,5,NJN,.250
217,Dwight Howard,416,.579,719,0,.000,7,104,26,116,585,416,.573,726,281,.491,572,54,54,2070,200,159,1113,C,81,175,785,ORL,.573
218,Josh Howard,135,.417,324,9,.243,37,50,31,10,119,144,.399,361,75,.773,97,43,18,991,39,91,372,SF,32,53,158,UTA,.411
219,Juwan Howard,17,.309,55,0,,0,10,38,1,29,17,.309,55,8,.800,10,28,0,190,18,18,42,PF,4,20,47,MIA,.309
220,Lester Hudson,46,.469,98,16,.250,64,36,27,3,39,62,.383,162,34,.829,41,16,0,334,7,26,174,PG,14,32,46,TOT,.432
221,Larry Hughes,4,.267,15,1,.143,7,7,33,0,4,5,.227,22,1,.500,2,9,0,114,1,10,12,PG,2,12,5,ORL,.250
222,Kris Humphries,323,.481,671,0,,0,90,26,74,448,323,.481,671,209,.752,278,62,62,2162,233,173,855,PF,50,119,681,NJN,.481
223,Serge Ibaka,261,.536,487,1,.333,3,28,22,241,305,262,.535,490,78,.661,118,66,66,1792,193,179,603,PF,33,79,498,OKC,.536
224,Andre Iguodala,211,.481,439,76,.394,193,339,28,30,325,287,.454,632,121,.617,196,62,62,2209,56,92,771,SF,107,115,381,PHI,.514
225,Ersan Ilyasova,243,.501,485,51,.455,112,71,24,44,333,294,.492,597,143,.781,183,60,41,1655,196,133,782,PF,42,76,529,MIL,.535
226,Kyrie Irving,277,.491,564,73,.399,183,275,19,20,147,350,.469,747,171,.872,196,51,51,1558,44,110,944,PG,54,160,191,CLE,.517
227,Royal Ivey,8,.400,20,18,.340,53,10,30,0,23,26,.356,73,1,.125,8,34,0,354,1,36,71,SG,14,9,24,OKC,.479
228,Jarrett Jack,227,.482,471,39,.348,112,285,28,9,153,266,.456,583,129,.872,148,45,39,1530,23,93,700,PG,31,106,176,NOH,.490
229,Reggie Jackson,38,.392,97,13,.210,62,71,21,1,39,51,.321,159,25,.862,29,45,0,501,14,31,140,PG,25,36,53,OKC,.362
230,Stephen Jackson,110,.431,255,49,.288,170,118,33,13,141,159,.374,425,94,.825,114,47,14,1212,22,99,461,SF,54,103,163,TOT,.432
231,Damion James,13,.382,34,0,.000,1,3,24,7,26,13,.371,35,8,.667,12,7,7,170,7,17,34,SF,7,12,33,NJN,.371
232,LeBron James,567,.556,1020,54,.362,149,387,27,50,398,621,.531,1169,387,.771,502,62,62,2326,94,96,1683,SF,115,213,492,MIA,.554
233,Mike James,14,.359,39,6,.600,10,29,36,2,8,20,.408,49,7,.875,8,11,0,120,2,20,53,PG,4,14,10,CHI,.469
234,Antawn Jamison,330,.425,777,91,.341,267,131,35,43,285,421,.403,1044,185,.683,271,65,65,2151,123,164,1118,PF,51,90,408,CLE,.447
235,Al Jefferson,515,.493,1044,1,.250,4,134,27,101,452,516,.492,1048,137,.774,177,61,61,2075,133,155,1170,C,47,62,585,UTA,.493
236,Richard Jefferson,90,.411,219,113,.420,269,88,31,19,193,203,.416,488,59,.694,85,63,44,1748,26,121,578,SF,37,50,219,TOT,.532
237,Jared Jeffries,56,.438,128,3,.188,16,26,30,25,83,59,.410,144,49,.681,72,39,4,729,69,89,170,PF,29,29,152,NYK,.420
238,Charles Jenkins,127,.469,271,3,.150,20,170,22,6,60,130,.447,291,34,.872,39,51,28,893,8,85,297,PG,33,60,68,GSW,.452
239,Brandon Jennings,340,.464,733,129,.332,388,365,22,22,177,469,.418,1121,193,.808,239,66,66,2331,49,114,1260,PG,104,146,226,MIL,.476
240,Jonas Jerebko,180,.519,347,32,.302,106,43,24,21,212,212,.468,453,100,.806,124,64,13,1468,96,162,556,PF,41,66,308,DET,.503
241,Yi Jianlian,28,.389,72,3,.300,10,5,24,8,37,31,.378,82,14,.667,21,30,0,203,12,23,79,PF,7,14,49,DAL,.396
242,Amir Johnson,194,.579,335,2,.400,5,79,24,69,259,196,.576,340,58,.690,84,64,43,1553,149,209,452,PF,33,94,408,TOR,.579
243,Armon Johnson,19,.475,40,1,.333,3,11,22,0,12,20,.465,43,6,1.000,6,9,0,124,1,9,47,PG,5,6,13,TOT,.477
244,Carldell Johnson,7,.350,20,4,.267,15,22,29,0,8,11,.314,35,1,.333,3,15,0,119,1,11,27,PG,8,7,9,NOH,.371
245,Chris Johnson,20,.488,41,0,,0,2,26,9,25,20,.488,41,15,.789,19,27,0,175,15,33,55,C,6,15,40,TOT,.488
246,Ivan Johnson,139,.517,269,2,.333,6,32,27,18,161,141,.513,275,72,.720,100,56,0,934,65,116,356,PF,43,69,226,ATL,.516
247,JaJuan Johnson,54,.446,121,0,,0,6,22,14,38,54,.446,121,6,.667,9,36,0,298,20,25,114,PF,5,14,58,BOS,.446
248,James Johnson,214,.467,458,19,.317,60,122,24,84,218,233,.450,518,81,.704,115,62,40,1561,74,177,566,SF,71,101,292,TOR,.468
249,Joe Johnson,298,.489,609,125,.388,322,232,30,13,168,423,.454,931,158,.849,186,60,60,2127,53,75,1129,SG,48,116,221,ATL,.521
250,Trey Johnson,8,.571,14,0,,0,4,27,0,9,8,.571,14,5,1.000,5,11,0,61,3,10,21,SG,1,5,12,NOH,.571
251,Wesley Johnson,105,.461,228,53,.314,169,59,24,48,153,158,.398,397,24,.706,34,65,64,1469,24,115,393,SF,35,60,177,MIN,.465
252,Dahntay Jones,82,.402,204,33,.429,77,63,31,11,94,115,.409,281,83,.838,99,65,3,1052,23,119,346,SF,23,46,117,IND,.468
253,Dominique Jones,28,.431,65,1,.125,8,42,23,5,35,29,.397,73,29,.784,37,33,1,268,9,28,88,SG,10,28,44,DAL,.404
254,James Jones,11,.306,36,46,.404,114,19,31,9,43,57,.380,150,25,.833,30,51,10,666,6,45,185,SG,17,10,49,MIA,.533
255,Solomon Jones,24,.393,61,0,,0,9,27,11,26,24,.393,61,19,.826,23,21,1,292,32,43,67,C-PF,9,18,58,TOT,.393
256,DeAndre Jordan,206,.634,325,0,.000,1,17,23,134,344,206,.632,326,74,.525,141,66,66,1798,202,189,486,C,30,74,546,LAC,.632
257,Jerome Jordan,17,.515,33,0,,0,4,25,6,13,17,.515,33,8,.800,10,21,0,108,14,15,42,C,1,2,27,NYK,.515
258,Cory Joseph,19,.345,55,3,.200,15,34,20,3,20,22,.314,70,11,.647,17,29,1,266,5,16,58,PG,7,12,25,SAS,.336
259,Chris Kaman,266,.446,597,0,,0,101,29,77,275,266,.446,597,84,.785,107,47,33,1372,89,106,616,C,25,129,364,NOH,.446
260,Enes Kanter,117,.498,235,0,.000,1,8,19,23,171,117,.496,236,70,.667,105,66,0,874,107,87,304,C,18,54,278,UTA,.496
261,Jason Kapono,13,.464,28,8,.296,27,11,30,0,12,21,.382,55,4,1.000,4,27,0,269,2,21,54,SG,3,6,14,LAL,.455
262,D.J. Kennedy,3,.375,8,2,.500,4,3,22,0,6,5,.417,12,0,.000,2,2,0,59,1,7,12,SF,2,3,7,CLE,.500
263,Jason Kidd,20,.400,50,79,.354,223,264,38,10,183,99,.363,273,22,.786,28,48,48,1379,15,83,299,PG,82,91,198,DAL,.507
264,Linas Kleiza,103,.446,231,62,.346,179,46,27,4,157,165,.402,410,81,.810,100,49,3,1057,42,119,473,SF,23,64,199,TOR,.478
265,Brandon Knight,214,.434,493,105,.380,276,251,20,10,178,319,.415,769,104,.759,137,66,60,2129,33,154,847,PG,49,171,211,DET,.483
266,Kyle Korver,60,.426,141,118,.435,271,112,30,15,133,178,.432,412,55,.833,66,65,7,1469,26,110,529,SG,36,53,159,CHI,.575
267,Kosta Koufos,115,.599,192,0,,0,15,22,41,163,115,.599,192,33,.600,55,48,24,792,95,96,263,C,24,33,258,DEN,.599
268,Carl Landry,182,.507,359,0,.000,3,38,28,12,136,182,.503,362,147,.799,184,41,8,999,78,89,511,PF,13,64,214,NOH,.503
269,Ty Lawson,301,.531,567,73,.365,200,401,24,6,173,374,.488,767,178,.824,216,61,61,2124,54,94,999,PG,82,149,227,DEN,.535
270,Courtney Lee,164,.452,363,87,.401,217,88,26,22,133,251,.433,580,71,.826,86,58,26,1757,26,106,660,SG,68,64,159,HOU,.508
271,David Lee,464,.506,917,0,.000,5,162,28,22,374,464,.503,922,219,.782,280,57,57,2121,171,179,1147,PF,54,149,545,GSW,.503
272,Malcolm Lee,21,.429,49,2,.200,10,31,21,4,17,23,.390,59,14,.824,17,19,0,243,9,22,62,SG,8,17,26,MIN,.407
273,Kawhi Leonard,158,.536,295,41,.376,109,70,20,24,223,199,.493,404,68,.773,88,64,39,1534,104,88,507,SF,85,44,327,SAS,.543
274,Travis Leslie,5,.357,14,0,,0,5,21,2,3,5,.357,14,4,.444,9,10,0,45,6,4,14,SG,2,2,9,LAC,.357
275,Jon Leuer,94,.516,182,3,.333,9,25,22,17,75,97,.508,191,21,.750,28,46,12,555,45,67,218,PF,14,18,120,MIL,.516
276,Rashard Lewis,69,.448,154,16,.239,67,27,32,10,75,85,.385,221,31,.838,37,28,15,729,34,49,217,SF,23,32,109,WAS,.421
277,DeAndre Liggins,12,.571,21,0,.000,4,5,23,0,9,12,.480,25,9,.474,19,17,0,115,6,6,33,SF,6,10,15,ORL,.480
278,Jeremy Lin,147,.477,308,24,.320,75,216,23,9,89,171,.446,383,146,.798,183,35,25,940,18,78,512,PG,55,126,107,NYK,.478
279,Shaun Livingston,125,.466,268,2,.667,3,122,26,20,84,127,.469,271,62,.785,79,58,27,1092,39,79,318,SG,27,66,123,MIL,.472
280,Brook Lopez,38,.494,77,0,,0,6,23,4,10,38,.494,77,20,.625,32,5,5,136,8,8,96,C,1,6,18,NJN,.494
281,Robin Lopez,124,.461,269,0,,0,20,23,60,119,124,.461,269,100,.714,140,64,0,895,90,128,348,C,18,43,209,PHO,.461
282,Kevin Love,369,.475,777,105,.372,282,111,23,28,508,474,.448,1059,379,.824,460,55,55,2145,226,152,1432,PF,47,128,734,MIN,.497
283,Kyle Lowry,131,.434,302,79,.374,211,310,25,14,176,210,.409,513,171,.864,198,47,38,1510,37,133,670,PG,73,130,213,HOU,.486
284,John Lucas III,88,.404,218,55,.393,140,108,29,1,54,143,.399,358,28,.875,32,49,2,726,22,42,369,PG,19,42,76,CHI,.476
285,Shelvin Mack,76,.427,178,12,.286,42,131,21,2,80,88,.400,220,42,.712,59,64,0,779,12,50,230,PG,28,48,92,WAS,.427
286,Vernon Macklin,19,.543,35,0,,0,5,25,4,20,19,.543,35,8,.571,14,23,0,135,14,9,46,C,4,3,34,DET,.543
287,Corey Maggette,115,.375,307,24,.364,66,39,32,1,104,139,.373,373,178,.856,208,32,28,881,21,83,480,SF,23,59,125,CHA,.405
288,Jamaal Magloire,17,.378,45,0,,0,6,33,10,88,17,.378,45,7,.259,27,34,1,374,25,66,41,C,4,22,113,TOR,.378
289,Ian Mahinmi,130,.549,237,0,.000,1,12,25,31,181,130,.546,238,94,.639,147,61,12,1139,108,176,354,C,38,50,289,DAL,.546
290,Shawn Marion,268,.464,578,20,.294,68,132,33,36,320,288,.446,646,74,.796,93,63,63,1919,145,87,670,SF,67,98,465,DAL,.461
291,Cartier Martin,30,.508,59,29,.387,75,10,27,2,46,59,.440,134,11,.579,19,17,2,391,12,35,158,SF,11,13,58,WAS,.549
292,Kenyon Martin,94,.454,207,3,.231,13,18,34,43,132,97,.441,220,20,.370,54,42,0,940,49,103,217,PF,44,32,181,LAC,.448
293,Kevin Martin,144,.462,312,78,.347,225,110,28,3,93,222,.413,537,160,.894,179,40,40,1264,13,70,682,SG,28,70,106,HOU,.486
294,Roger Mason,44,.423,104,59,.383,154,47,31,5,62,103,.399,258,21,.778,27,52,0,697,7,33,286,SG,13,32,69,WAS,.514
295,Wesley Matthews,185,.434,426,129,.383,337,113,25,15,168,314,.412,763,147,.860,171,66,53,2228,56,148,904,SG,96,73,224,POR,.496
296,Jason Maxiell,183,.480,381,0,.000,2,41,28,50,207,183,.478,383,58,.547,106,65,42,1466,126,151,424,PF,32,71,333,DET,.478
297,Eric Maynor,8,.364,22,6,.353,17,22,24,0,10,14,.359,39,4,1.000,4,9,0,137,3,13,38,PG,5,11,13,OKC,.436
298,O.J. Mayo,200,.434,461,100,.364,275,169,24,23,180,300,.408,736,133,.773,172,66,0,1771,30,137,833,SG,71,124,210,MEM,.476
299,Luc Mbah a Moute,132,.514,257,1,.250,4,29,25,22,150,133,.510,261,66,.641,103,43,22,1009,77,93,333,PF,40,39,227,MIL,.511
300,JaVale McGee,307,.556,552,0,,0,31,24,132,314,307,.556,552,77,.461,167,61,45,1535,163,166,691,C,35,87,477,TOT,.556
301,Tracy McGrady*,86,.434,198,15,.455,33,110,32,15,131,101,.437,231,56,.675,83,52,0,837,23,35,273,SF,16,53,154,ATL,.470
302,Dominic McGuire,94,.456,206,0,.000,4,110,26,36,173,94,.448,210,39,.736,53,64,6,1127,73,104,227,PF,44,56,246,GSW,.448
303,Josh McRoberts,53,.477,111,3,.429,7,51,24,18,110,56,.475,118,23,.639,36,50,6,718,61,74,138,PF,15,31,171,LAL,.487
304,Jodie Meeks,94,.468,201,97,.365,266,54,24,3,144,191,.409,467,77,.906,85,66,50,1644,17,82,556,SG,40,29,161,PHI,.513
305,C.J. Miles,131,.416,315,46,.307,150,69,24,18,89,177,.381,465,108,.794,136,56,14,1145,27,122,508,SG,46,53,116,UTA,.430
306,Darko Milicic,59,.454,130,0,,0,17,26,25,62,59,.454,130,16,.432,37,29,23,472,35,59,134,C,9,32,97,MIN,.454
307,Andre Miller,224,.478,469,18,.217,83,441,35,9,168,242,.438,552,137,.811,169,66,7,1809,53,133,639,SG,63,177,221,DEN,.455
308,Brad Miller,2,.167,12,7,.467,15,24,35,2,15,9,.333,27,10,.833,12,15,1,146,4,10,35,C,4,12,19,MIN,.463
309,Mike Miller,38,.413,92,53,.453,117,42,31,6,106,91,.435,209,2,.400,5,39,2,752,22,58,237,SG,14,30,128,MIA,.562
310,Patty Mills,39,.527,74,24,.429,56,39,23,1,24,63,.485,130,15,1.000,15,16,3,261,4,14,165,PG,10,26,28,SAS,.577
311,Paul Millsap,419,.505,830,7,.226,31,150,26,52,383,426,.495,861,202,.792,255,64,62,2100,180,222,1061,PF,118,112,563,UTA,.499
312,Nazr Mohammed,79,.470,168,0,.000,1,14,34,37,111,79,.467,169,13,.565,23,63,1,692,59,101,171,C,20,26,170,OKC,.467
313,Greg Monroe,407,.522,780,0,.000,1,152,21,46,398,407,.521,781,201,.739,272,66,66,2082,239,180,1015,C,83,161,637,DET,.521
314,Jamario Moon,5,.357,14,2,.200,10,5,31,5,20,7,.292,24,2,1.000,2,8,0,123,2,5,18,SF,1,8,22,CHA,.333
315,E'Twaun Moore,26,.382,68,17,.378,45,34,22,3,29,43,.381,113,7,1.000,7,38,0,331,4,33,110,PG,11,21,33,BOS,.456
316,Mikki Moore,9,.450,20,0,,0,5,36,3,15,9,.450,20,6,.857,7,7,0,118,7,24,24,C,3,7,22,GSW,.450
317,Darius Morris,14,.424,33,4,.444,9,21,21,0,14,18,.429,42,6,.667,9,19,0,169,2,16,46,PG,2,19,16,LAL,.476
318,Marcus Morris,14,.378,37,2,.118,17,3,22,2,11,16,.296,54,6,.750,8,17,0,126,5,12,40,PF,2,4,16,HOU,.315
319,Markieff Morris,131,.420,312,43,.347,124,65,22,42,210,174,.399,436,76,.717,106,63,7,1227,69,179,467,PF,41,70,279,PHO,.448
320,Anthony Morrow,166,.446,372,106,.371,286,61,26,9,96,272,.413,658,97,.933,104,62,18,1636,31,86,747,SG,46,70,127,NJN,.494
321,Timofey Mozgov,100,.526,190,0,,0,22,25,42,126,100,.526,190,39,.684,57,44,35,687,53,86,239,C,15,53,179,DEN,.526
322,Byron Mullens,239,.443,540,12,.235,51,57,22,52,231,251,.425,591,92,.821,112,65,25,1465,96,137,606,C,21,74,327,CHA,.435
323,Troy Murphy,49,.471,104,28,.418,67,51,31,16,151,77,.450,171,6,.667,9,59,0,956,40,98,188,PF,15,26,191,LAL,.532
324,Hamady N'Diaye,0,.000,1,0,,0,0,25,0,0,0,.000,1,0,,0,3,0,3,0,0,0,C,0,0,0,WAS,.000
325,Eduardo Najera,16,.457,35,8,.276,29,12,35,4,39,24,.375,64,2,.500,4,22,0,270,11,40,58,PF,19,7,50,CHA,.438
326,Steve Nash,240,.580,414,55,.390,141,664,37,8,160,295,.532,555,127,.894,142,62,62,1961,26,53,772,PG,38,229,186,PHO,.581
327,Gary Neal,129,.448,288,83,.419,198,117,27,2,106,212,.436,486,50,.781,64,56,7,1206,12,75,557,SG,27,60,118,SAS,.522
328,Jameer Nelson,172,.459,375,87,.377,231,325,29,5,152,259,.427,606,71,.807,88,57,57,1706,29,130,676,PG,38,135,181,ORL,.499
329,Joakim Noah,249,.509,489,0,.000,1,160,26,92,387,249,.508,490,154,.748,206,64,64,1945,242,162,652,C,41,92,629,CHI,.508
330,Andres Nocioni,4,.286,14,1,.167,6,1,32,1,13,5,.250,20,6,.545,11,11,1,56,1,4,17,SF,1,5,14,PHI,.275
331,Steve Novak,28,.509,55,133,.472,282,12,28,9,95,161,.478,337,22,.846,26,54,0,1020,9,59,477,PF,16,21,104,NYK,.675
332,Dirk Nowitzki,395,.481,822,78,.368,212,136,33,30,372,473,.457,1034,318,.896,355,62,62,2079,46,129,1342,PF,42,117,418,DAL,.495
333,Jermaine O'Neal,52,.433,120,0,,0,10,33,43,98,52,.433,120,21,.677,31,25,24,570,37,80,125,C,8,21,135,BOS,.433
334,Lamar Odom,95,.399,238,28,.252,111,83,32,18,172,123,.352,349,58,.592,98,50,4,1027,36,97,332,SF,20,52,208,DAL,.393
335,Emeka Okafor,114,.533,214,0,,0,24,29,26,143,114,.533,214,38,.514,74,27,27,781,70,73,266,C,16,37,213,NOH,.533
336,Mehmet Okur,29,.433,67,23,.319,72,30,32,5,59,52,.374,139,3,.600,5,17,14,454,22,45,130,C,9,25,81,NJN,.457
337,Daniel Orton,17,.586,29,0,.000,1,5,21,9,20,17,.567,30,11,.440,25,16,2,187,19,30,45,PF,8,7,39,ORL,.567
338,Travis Outlaw,44,.383,115,16,.267,60,16,27,21,42,60,.343,175,31,.674,46,39,5,500,19,34,167,SF,19,20,61,SAC,.389
339,Larry Owens,2,.333,6,2,.400,5,4,29,1,11,4,.364,11,3,.750,4,7,0,75,2,10,13,SF,0,2,13,NJN,.455
340,Zaza Pachulia,169,.499,339,0,,0,79,27,29,303,169,.499,339,117,.741,158,58,44,1640,154,172,455,C,55,81,457,ATL,.499
341,Jannero Pargo,52,.452,115,53,.384,138,96,32,2,64,105,.415,253,19,.950,20,50,0,671,9,64,282,PG,20,49,73,ATL,.520
342,Jeremy Pargo,40,.357,112,10,.263,38,55,25,0,25,50,.333,150,16,.593,27,44,5,424,12,46,126,PG,15,46,37,MEM,.367
343,Anthony Parker,91,.484,188,50,.362,138,120,36,7,128,141,.433,326,35,.625,56,51,51,1280,10,65,367,SF,38,50,138,CLE,.509
344,Tony Parker,413,.498,829,14,.230,61,463,29,5,149,427,.480,890,227,.799,284,60,60,1923,22,75,1095,PG,57,153,171,SAS,.488
345,Chandler Parsons,188,.507,371,60,.337,178,134,23,29,210,248,.452,549,43,.551,78,63,57,1804,90,142,599,SF,73,81,300,HOU,.506
346,Patrick Patterson,225,.443,508,0,.000,3,53,22,36,174,225,.440,511,40,.702,57,64,1,1483,112,113,490,PF,27,49,286,HOU,.440
347,Chris Paul,346,.511,677,79,.371,213,543,26,4,171,425,.478,890,260,.861,302,60,60,2181,42,138,1189,PG,152,124,213,LAC,.522
348,Sasha Pavlovic,33,.471,70,17,.293,58,18,28,15,68,50,.391,128,3,.375,8,45,7,527,4,54,120,SF,20,20,72,BOS,.457
349,Nikola Pekovic,256,.564,454,0,,0,31,26,31,165,256,.564,454,139,.743,187,47,35,1264,181,98,651,C,29,87,346,MIN,.564
350,Kendrick Perkins,128,.489,262,0,,0,78,27,73,306,128,.489,262,73,.652,112,65,65,1744,120,189,329,C,25,118,426,OKC,.489
351,Johan Petro,108,.417,259,1,1.000,1,45,26,23,156,109,.419,260,31,.838,37,59,10,920,68,122,250,C,21,38,224,NJN,.421
352,Paul Pierce,294,.476,617,100,.366,273,274,34,26,280,394,.443,890,293,.852,344,61,61,2075,37,147,1181,SF,70,173,317,BOS,.499
353,Mickael Pietrus,43,.489,88,61,.335,182,25,29,10,112,104,.385,270,20,.645,31,42,6,921,18,81,289,SG,21,33,130,BOS,.498
354,Dexter Pittman,44,.468,94,0,,0,9,23,8,44,44,.468,94,18,.643,28,35,6,301,27,73,106,C,8,17,71,MIA,.468
355,Quincy Pondexter,86,.518,166,22,.301,73,27,23,5,71,108,.452,239,33,.623,53,64,8,1002,55,90,271,SF,27,30,126,MEM,.498
356,A.J. Price,33,.384,86,26,.295,88,86,25,2,48,59,.339,174,28,.800,35,44,1,568,13,30,172,PG,20,32,61,IND,.414
357,Ronnie Price,36,.419,86,13,.295,44,67,28,3,38,49,.377,130,20,.800,25,36,8,517,18,72,131,PG,34,46,56,PHO,.427
358,Tayshaun Prince,299,.431,694,37,.356,104,153,31,32,209,336,.421,798,89,.774,115,63,63,2087,72,77,798,SF,27,74,281,DET,.444
359,Joel Przybilla,22,.458,48,0,,0,6,32,16,109,22,.458,48,11,.611,18,27,19,449,29,66,55,C,4,22,138,POR,.458
360,Vladimir Radmanovic,24,.387,62,50,.370,135,54,31,15,109,74,.376,197,22,.759,29,49,3,755,34,62,220,SF,21,35,143,ATL,.503
361,Anthony Randolph,94,.472,199,0,.000,1,19,22,35,81,94,.470,200,64,.762,84,34,5,517,42,56,252,PF,13,40,123,MIN,.470
362,Zach Randolph,130,.469,277,2,.250,8,48,30,4,147,132,.463,285,58,.659,88,28,8,735,78,57,324,PF,21,40,225,MEM,.467
363,Michael Redd,102,.447,228,42,.318,132,33,32,0,63,144,.400,360,88,.793,111,51,2,770,14,29,418,SG,13,37,77,PHO,.458
364,J.J. Redick,136,.430,316,112,.418,268,164,27,6,132,248,.425,584,143,.911,157,65,22,1765,18,92,751,SG,27,68,150,ORL,.521
365,Ryan Reid,4,.800,5,0,,0,0,25,0,1,4,.800,5,0,,0,5,0,17,1,1,8,PF,0,1,2,OKC,.800
366,Jason Richardson,141,.442,319,102,.368,277,107,31,22,158,243,.408,596,41,.594,69,54,54,1591,36,91,629,SG,53,60,194,ORL,.493
367,Quentin Richardson,32,.421,76,42,.347,121,38,31,6,108,74,.376,197,25,.833,30,48,3,866,15,74,215,SF,28,29,123,ORL,.482
368,Luke Ridnour,193,.485,398,49,.322,152,252,30,16,122,242,.440,550,106,.891,119,53,53,1750,19,136,639,SG,56,96,141,MIN,.485
369,Nate Robinson,139,.459,303,66,.365,181,231,27,2,85,205,.424,484,94,.832,113,51,9,1192,15,118,570,PG,59,75,100,GSW,.492
370,Rajon Rondo,246,.464,530,10,.238,42,620,25,3,195,256,.448,572,108,.597,181,53,53,1957,62,99,630,PG,95,193,257,BOS,.456
371,Derrick Rose,248,.475,522,54,.312,173,307,23,28,105,302,.435,695,194,.812,239,39,39,1375,26,52,852,PG,35,119,131,CHI,.473
372,Ricky Rubio,107,.363,295,32,.340,94,336,21,8,150,139,.357,389,126,.803,157,41,31,1404,21,97,436,PG,91,131,171,MIN,.398
373,Brandon Rush,136,.544,250,99,.452,219,88,26,58,218,235,.501,469,65,.793,82,65,1,1717,33,64,634,SF,35,68,251,GSW,.607
374,Walker Russell,29,.354,82,4,.308,13,58,29,1,19,33,.347,95,14,.636,22,28,0,357,7,29,84,PG,18,33,26,DET,.368
375,John Salmons,108,.464,233,33,.295,112,93,32,7,114,141,.409,345,29,.644,45,46,32,1250,20,77,344,SF,37,45,134,SAC,.457
376,Samardo Samuels,105,.455,231,0,,0,20,23,20,117,105,.455,231,82,.701,117,54,0,825,63,113,292,C,20,56,180,CLE,.455
377,Larry Sanders,84,.462,182,0,.000,2,33,23,76,98,84,.457,184,18,.474,38,52,0,643,62,133,186,PF,32,43,160,MIL,.457
378,Brian Scalabrine,13,.565,23,1,.143,7,15,33,6,13,14,.467,30,3,.500,6,28,0,122,8,9,32,PF,5,9,21,CHI,.483
379,Luis Scola,436,.493,885,0,.000,3,140,31,24,306,436,.491,888,153,.773,198,66,66,2067,122,214,1025,PF,35,153,428,HOU,.491
380,Thabo Sefolosha,36,.429,84,31,.437,71,47,27,17,107,67,.432,155,38,.884,43,42,42,914,21,78,203,SG,37,40,128,OKC,.532
381,Josh Selby,23,.404,57,2,.133,15,30,20,0,13,25,.347,72,11,.786,14,28,0,237,2,17,63,PG,7,29,15,MEM,.361
382,Kevin Seraphin,203,.533,381,0,.000,1,33,22,76,177,203,.531,382,47,.671,70,57,21,1176,103,133,453,C,19,66,280,WAS,.531
383,Ramon Sessions,199,.425,468,43,.443,97,354,25,3,181,242,.428,565,194,.782,248,64,23,1707,33,100,721,PG,44,141,214,TOT,.466
384,Iman Shumpert,166,.440,377,48,.306,157,164,21,8,144,214,.401,534,87,.798,109,59,35,1705,42,173,563,PG,101,111,186,NYK,.446
385,Xavier Silas,3,.333,9,1,.167,6,3,24,0,2,4,.267,15,2,.667,3,2,0,39,2,5,11,SG,0,3,4,PHI,.300
386,Bobby Simmons,8,.267,30,20,.333,60,11,31,3,38,28,.311,90,4,.571,7,28,0,418,17,41,80,SF,15,10,55,LAC,.422
387,Chris Singleton,72,.389,185,44,.346,127,49,22,30,190,116,.372,312,30,.682,44,66,51,1431,43,176,306,SF,70,38,233,WAS,.442
388,James Singleton,39,.591,66,2,.222,9,15,30,8,56,41,.547,75,14,.933,15,12,0,262,25,27,98,PF,9,10,81,WAS,.560
389,Brian Skinner,0,.000,1,0,,0,0,35,0,0,0,.000,1,0,,0,1,0,4,0,1,0,C,0,0,0,MEM,.000
390,Donald Sloan,77,.445,173,2,.080,25,105,24,3,49,79,.399,198,23,.767,30,33,11,669,18,37,183,PG,13,49,67,TOT,.404
391,Craig Smith,59,.509,116,0,.000,1,19,28,5,77,59,.504,117,38,.717,53,47,0,464,33,55,156,PF,16,24,110,POR,.504
392,Greg Smith,7,.636,11,0,,0,1,21,5,15,7,.636,11,0,,0,8,0,69,5,17,14,C,2,1,20,HOU,.636
393,Ish Smith,28,.389,72,3,.333,9,41,23,2,28,31,.383,81,7,.700,10,26,1,234,7,15,72,PG,15,13,35,TOT,.401
394,J.R. Smith,98,.462,212,67,.347,193,84,26,6,107,165,.407,405,39,.709,55,35,1,967,29,87,436,SG,54,46,136,NYK,.490
395,Jason Smith,180,.531,339,1,.111,9,34,25,41,124,181,.520,348,33,.702,47,40,29,947,72,102,396,PF,21,40,196,NOH,.522
396,Jerry Smith,2,.250,8,1,.167,6,4,24,0,5,3,.214,14,0,,0,5,0,46,2,5,7,PG,5,0,7,NJN,.250
397,Josh Smith,476,.480,992,28,.257,109,257,26,115,496,504,.458,1101,203,.630,322,66,66,2329,136,172,1239,PF,93,164,632,ATL,.470
398,Nolan Smith,54,.400,135,13,.289,45,62,23,3,39,67,.372,180,20,.714,28,44,4,541,17,55,167,PG,18,42,56,POR,.408
399,Marreese Speights,221,.456,485,0,.000,3,48,24,29,241,221,.453,488,84,.771,109,60,54,1345,133,147,526,PF,21,74,374,MEM,.453
400,Tiago Splitter,212,.618,343,0,,0,65,27,47,213,212,.618,343,125,.691,181,59,2,1121,93,134,549,C,21,87,306,SAS,.618
401,Jerry Stackhouse,24,.387,62,13,.342,38,14,37,3,17,37,.370,100,21,.913,23,30,0,273,6,12,108,SF,10,13,23,ATL,.435
402,Lance Stephenson,43,.453,95,4,.133,30,46,21,5,41,47,.376,125,8,.471,17,42,1,442,12,30,106,SG,21,36,53,IND,.392
403,DeShawn Stevenson,8,.296,27,41,.283,145,41,30,4,94,49,.285,172,9,.563,16,51,30,960,7,59,148,SF,19,19,101,NJN,.404
404,Greg Stiemsma,66,.545,121,0,,0,28,26,85,129,66,.545,121,29,.707,41,55,3,766,48,144,161,C,37,33,177,BOS,.545
405,Julyan Stone,11,.550,20,2,.182,11,37,23,6,20,13,.419,31,8,.727,11,22,2,179,5,18,36,SG,8,11,25,DEN,.452
406,Amar'e Stoudemire,311,.491,633,5,.238,21,52,29,45,261,316,.483,654,186,.765,243,47,47,1543,106,138,823,PF,38,112,367,NYK,.487
407,Rodney Stuckey,223,.452,493,33,.317,104,210,25,10,104,256,.429,597,267,.834,320,55,48,1644,38,124,812,SG,44,106,142,DET,.456
408,DaJuan Summers,23,.469,49,5,.313,16,10,24,0,15,28,.431,65,7,.778,9,15,6,209,8,31,68,SF,7,8,23,NOH,.469
409,Jeff Teague,269,.514,523,51,.342,149,321,23,37,138,320,.476,672,140,.757,185,66,66,2183,21,145,831,PG,106,134,159,ATL,.514
410,Sebastian Telfair,108,.456,237,33,.314,105,138,26,12,71,141,.412,342,53,.791,67,60,1,895,20,120,368,PG,41,68,91,PHO,.461
411,Jason Terry,219,.471,465,138,.378,365,226,34,11,133,357,.430,830,98,.883,111,63,1,2000,16,69,950,SG,73,127,149,DAL,.513
412,Hasheem Thabeet,11,.524,21,0,,0,0,24,10,26,11,.524,21,13,.650,20,20,3,139,16,20,35,C,1,8,42,TOT,.524
413,Isaiah Thomas,173,.491,352,83,.379,219,266,22,8,120,256,.448,571,154,.832,185,65,37,1656,48,121,749,PG,53,105,168,SAC,.521
414,Kurt Thomas,73,.465,157,0,,0,46,39,31,149,73,.465,157,14,.700,20,53,3,803,39,123,160,C,24,31,188,POR,.465
415,Lance Thomas,57,.456,125,0,.000,1,12,23,7,77,57,.452,126,52,.839,62,42,10,630,49,78,166,PF,10,24,126,NOH,.452
416,Malcolm Thomas,0,.000,3,0,,0,1,23,1,2,0,.000,3,1,.500,2,3,0,15,1,0,1,PF,1,0,3,SAS,.000
417,Tyrus Thomas,119,.367,324,1,.333,3,35,25,60,151,120,.367,327,63,.759,83,54,30,1013,49,144,304,PF,36,53,200,CHA,.369
418,Trey Thompkins,20,.417,48,4,.308,13,3,21,3,20,24,.393,61,5,.714,7,24,0,119,4,10,57,C,3,6,24,LAC,.426
419,Jason Thompson,237,.537,441,0,.000,2,79,25,44,277,237,.535,443,109,.602,181,64,47,1657,166,149,583,PF,43,68,443,SAC,.535
420,Klay Thompson,207,.460,450,111,.414,268,133,21,20,137,318,.443,718,79,.868,91,66,29,1608,24,155,826,SG,49,103,161,GSW,.520
421,Mychel Thompson,3,.231,13,4,.364,11,7,23,1,5,7,.292,24,0,,0,5,3,95,0,8,18,SG,2,5,5,CLE,.375
422,Tristan Thompson,194,.441,440,0,.000,2,27,20,62,202,194,.439,442,106,.552,192,60,25,1424,187,134,494,PF,27,81,389,CLE,.439
423,Marcus Thornton,245,.497,493,107,.345,310,98,24,12,104,352,.438,803,141,.865,163,51,51,1780,84,111,952,SG,71,84,188,SAC,.505
424,Jamaal Tinsley,47,.452,104,10,.270,37,123,33,8,39,57,.404,141,13,.765,17,37,1,507,6,47,137,PG,17,52,45,UTA,.440
425,Anthony Tolliver,46,.568,81,25,.248,101,22,26,19,103,71,.390,182,41,.745,55,51,0,882,50,86,208,SF,18,35,153,MIN,.459
426,Ronny Turiaf,19,.594,32,0,.000,1,10,29,17,50,19,.576,33,13,.591,22,17,5,279,20,39,51,C,14,14,70,TOT,.576
427,Hedo Turkoglu,118,.480,246,91,.353,258,233,32,17,175,209,.415,504,67,.705,95,53,53,1653,24,139,576,SF,45,142,199,ORL,.505
428,Evan Turner,252,.466,541,11,.224,49,180,23,20,349,263,.446,590,73,.676,108,65,20,1713,27,117,610,SF,40,105,376,PHI,.455
429,Jeremy Tyler,88,.423,208,0,.000,1,16,20,20,86,88,.421,209,29,.558,52,42,23,568,54,84,205,C,16,36,140,GSW,.421
430,Edwin Ubiles,4,.308,13,1,.200,5,1,25,1,8,5,.278,18,3,1.000,3,4,0,52,2,1,14,SF,1,1,10,WAS,.306
431,Ekpe Udoh,127,.433,293,0,.000,2,57,24,102,154,127,.431,295,86,.754,114,61,11,1290,100,174,340,C,40,53,254,TOT,.431
432,Beno Udrih,129,.473,273,17,.288,59,227,29,1,76,146,.440,332,39,.709,55,59,0,1080,26,69,348,SG,37,77,102,MIL,.465
433,Ben Uzoh,35,.357,98,0,.000,1,61,23,3,48,35,.354,99,11,.579,19,18,8,370,19,31,81,PG,17,19,67,TOT,.354
434,Anderson Varejao,114,.523,218,0,.000,4,43,29,17,178,114,.514,222,43,.672,64,25,25,785,109,62,271,C,35,45,287,CLE,.514
435,Greivis Vasquez,182,.469,388,43,.319,135,359,25,8,150,225,.430,523,96,.821,117,66,26,1706,23,126,589,SG,60,148,173,NOH,.471
436,Jan Vesely,117,.539,217,0,.000,1,47,21,32,148,117,.537,218,33,.532,62,57,20,1078,101,156,267,PF,39,60,249,WAS,.537
437,Charlie Villanueva,20,.435,46,15,.333,45,6,27,5,39,35,.385,91,6,.857,7,13,0,180,9,25,91,PF,7,7,48,DET,.467
438,Nikola Vucevic,128,.452,283,3,.375,8,31,21,34,158,131,.450,291,18,.529,34,51,15,812,88,111,283,C,20,33,246,PHI,.455
439,Dwyane Wade,401,.513,781,15,.268,56,225,30,63,164,416,.497,837,235,.791,297,49,49,1625,73,110,1082,SG,82,129,237,MIA,.506
440,Von Wafer,57,.483,118,14,.359,39,29,26,3,39,71,.452,157,38,.704,54,33,1,469,6,26,194,SG,10,35,45,ORL,.497
441,Henry Walker,32,.552,58,36,.319,113,37,24,7,71,68,.398,171,17,.850,20,32,8,620,9,84,189,SG,19,35,80,NYK,.503
442,Kemba Walker,212,.392,541,69,.305,226,289,21,20,204,281,.366,767,168,.789,213,66,25,1792,30,79,799,PG,60,119,234,CHA,.411
443,John Wall,375,.440,852,3,.071,42,530,21,57,252,378,.423,894,317,.789,402,66,66,2386,48,137,1076,PG,95,255,300,WAS,.424
444,Ben Wallace,33,.402,82,1,.250,4,43,37,51,188,34,.395,86,16,.340,47,62,11,980,81,60,85,C,47,34,269,DET,.401
445,Gerald Wallace,241,.500,482,46,.307,150,164,29,36,299,287,.454,632,180,.800,225,58,58,2076,87,145,800,SF,85,111,386,TOT,.491
446,Luke Walton,17,.378,45,7,.350,20,35,31,1,36,24,.369,65,0,,0,30,0,364,13,41,55,PF-SF,5,27,49,TOT,.423
447,Hakim Warrick,73,.429,170,1,.100,10,30,29,3,61,74,.411,180,76,.768,99,35,0,503,31,35,225,PF,8,36,92,PHO,.414
448,Darryl Watkins,7,.500,14,0,,0,3,27,4,19,7,.500,14,9,.500,18,5,0,98,8,14,23,C,5,8,27,NOH,.500
449,C.J. Watson,93,.352,264,68,.393,173,200,27,8,84,161,.368,437,84,.808,104,49,25,1159,21,103,474,PG,45,97,105,CHI,.446
450,Earl Watson,44,.407,108,10,.192,52,217,32,22,91,54,.338,160,31,.674,46,50,2,1033,30,105,149,PG,54,85,121,UTA,.369
451,Martell Webster,78,.479,163,37,.339,109,40,25,17,126,115,.423,272,57,.792,72,47,26,1140,42,86,324,SF,31,46,168,MIN,.491
452,David West,347,.491,707,2,.222,9,140,31,46,315,349,.487,716,142,.807,176,66,66,1925,118,160,842,PF,52,93,433,IND,.489
453,Delonte West,139,.489,284,27,.355,76,139,28,11,88,166,.461,360,62,.886,70,44,33,1060,13,67,421,PG,58,76,101,DAL,.499
454,Russell Westbrook,516,.482,1070,62,.316,196,362,23,21,205,578,.457,1266,340,.823,413,66,66,2331,96,147,1558,PG,112,239,301,OKC,.481
455,D.J. White,173,.491,352,1,1.000,1,47,25,23,159,174,.493,353,43,.705,61,58,11,1098,50,94,392,PF,17,43,209,CHA,.494
456,Hassan Whiteside,12,.444,27,0,,0,0,22,15,23,12,.444,27,5,.417,12,18,0,109,16,12,29,C,3,5,39,SAC,.444
457,Chris Wilcox,64,.598,107,0,,0,12,29,9,84,64,.598,107,24,.615,39,28,4,481,38,64,152,C,11,30,122,BOS,.598
458,Damien Wilkins,69,.406,170,7,.304,23,44,32,13,78,76,.394,193,34,.630,54,60,2,922,22,85,193,SF,29,30,100,DET,.412
459,Deron Williams,276,.446,619,115,.336,342,481,27,20,160,391,.407,961,257,.843,305,55,55,1999,23,121,1154,PG,67,219,183,NJN,.467
460,Derrick Williams,168,.467,360,37,.268,138,38,20,31,234,205,.412,498,136,.697,195,66,15,1418,77,95,583,PF,30,77,311,MIN,.449
461,Elliot Williams,29,.617,47,8,.296,27,6,22,3,12,37,.500,74,6,.333,18,24,0,149,7,18,88,SG,6,5,19,POR,.554
462,Jordan Williams,77,.507,152,0,,0,11,21,15,90,77,.507,152,43,.652,66,43,5,635,66,61,197,C,21,23,156,NJN,.507
463,Lou Williams,235,.425,553,83,.362,229,221,25,18,125,318,.407,782,237,.812,292,64,0,1682,30,90,956,PG,53,71,155,PHI,.460
464,Marvin Williams,145,.452,321,58,.389,149,71,25,18,218,203,.432,470,115,.788,146,57,37,1500,76,84,579,SF,47,39,294,ATL,.494
465,Mo Williams,167,.449,372,93,.389,239,160,29,7,76,260,.426,611,72,.900,80,52,1,1472,23,103,685,SG,51,86,99,LAC,.502
466,Reggie Williams,73,.493,148,33,.308,107,60,25,3,66,106,.416,255,29,.725,40,33,13,747,27,34,274,SF,20,33,93,CHA,.480
467,Sean Williams,14,.636,22,0,,0,5,25,8,12,14,.636,22,12,.923,13,11,0,107,13,18,40,C,4,10,25,TOT,.636
468,Shawne Williams,21,.350,60,21,.241,87,16,25,11,48,42,.286,147,8,.727,11,25,6,514,20,44,113,SF,10,13,68,NJN,.357
469,Shelden Williams,96,.478,201,0,,0,35,28,39,209,96,.478,201,76,.731,104,58,35,1276,141,149,268,C,47,66,350,NJN,.478
470,Terrence Williams,69,.454,152,16,.348,46,65,24,7,89,85,.429,198,27,.587,46,30,0,550,13,35,213,SG,20,43,102,TOT,.470
471,Metta World Peace,127,.460,276,56,.296,189,140,32,27,147,183,.394,465,71,.617,115,64,45,1720,71,137,493,SF,69,69,218,LAL,.454
472,Brandan Wright,144,.621,232,0,.000,1,13,24,63,112,144,.618,233,52,.634,82,49,0,791,62,61,340,C,22,21,174,DAL,.618
473,Chris Wright,23,.511,45,0,,0,4,23,13,26,23,.511,45,24,.774,31,24,1,186,19,22,70,SF,7,8,45,GSW,.511
474,Dorell Wright,117,.500,234,105,.360,292,94,26,26,218,222,.422,526,80,.816,98,61,61,1650,60,97,629,SF,58,51,278,GSW,.522
475,Nick Young,213,.424,502,103,.365,282,56,26,17,102,316,.403,784,144,.852,169,62,35,1729,31,141,879,SG,44,83,133,TOT,.469
476,Sam Young,40,.364,110,5,.294,17,15,26,6,42,45,.354,127,19,.731,26,35,2,375,20,23,114,SF,17,16,62,TOT,.374
477,Thaddeus Young,347,.508,683,1,.250,4,74,23,41,188,348,.507,687,111,.771,144,63,1,1755,137,127,808,PF,64,55,325,PHI,.507
