,Player_Name,2P,2P%,2PA,3P,3P%,3PA,AST,Age,BLK,DRB,FG,FG%,FGA,FT,FT%,FTA,Games,Games_Strated,Minutes_Played,ORB,PF,PTS,Position,STL,TOV,TRB,Team,eFG%
0,Quincy Acy,41,.562,73,1,.500,2,11,22,15,47,42,.560,75,31,.816,38,29,0,342,30,53,116,PF,13,17,77,TOR,.567
1,Jeff Adrien,72,.434,166,0,.000,2,36,26,27,128,72,.429,168,65,.650,100,52,5,713,68,80,209,PF,18,32,196,CHA,.429
2,Arron Afflalo,325,.489,665,72,.300,240,206,27,11,210,397,.439,905,191,.857,223,64,64,2307,29,137,1057,SF,40,138,239,ORL,.478
3,Josh Akognon,1,.500,2,1,.500,2,1,26,0,1,2,.500,4,0,,0,3,0,9,0,3,5,PG,0,0,1,DAL,.625
4,Cole Aldrich,44,.550,80,0,,0,9,24,23,90,44,.550,80,12,.600,20,45,0,388,30,60,100,C,5,23,120,TOT,.550
5,LaMarcus Aldridge,636,.488,1304,2,.143,14,192,27,91,495,638,.484,1318,282,.810,348,74,74,2790,175,187,1560,PF,62,143,670,POR,.485
6,Lavoy Allen,206,.455,453,0,.000,1,73,23,55,236,206,.454,454,43,.717,60,79,37,1669,159,180,455,C,24,55,395,PHI,.454
7,Ray Allen,153,.480,319,139,.419,332,135,37,15,177,292,.449,651,140,.886,158,79,0,2035,40,129,863,SG,67,103,217,MIA,.555
8,Tony Allen,281,.458,614,3,.125,24,98,31,44,242,284,.445,638,134,.717,187,79,79,2109,121,211,705,SG,119,94,363,MEM,.447
9,Al-Farouq Aminu,221,.486,455,4,.211,19,103,22,51,446,225,.475,474,101,.737,137,76,71,2066,139,153,555,SF,92,116,585,NOH,.479
10,Lou Amundson,32,.395,81,0,,0,11,30,12,58,32,.395,81,12,.333,36,39,0,372,48,53,76,PF,16,19,106,TOT,.395
11,Chris Andersen,69,.575,120,2,.667,3,17,34,44,115,71,.577,123,63,.677,93,42,0,624,57,89,207,C,16,24,172,MIA,.585
12,Alan Anderson,141,.426,331,95,.333,285,103,30,7,114,236,.383,616,126,.857,147,65,2,1495,34,131,693,SF,48,80,148,TOR,.460
13,James Anderson,31,.470,66,21,.350,60,42,23,5,54,52,.413,126,24,.857,28,39,2,401,18,25,149,SG-SF,15,25,72,TOT,.496
14,Ryan Anderson,259,.464,558,213,.382,557,97,24,31,328,472,.423,1115,152,.844,180,81,22,2503,191,179,1309,PF,42,97,519,NOH,.519
15,Carmelo Anthony,512,.476,1075,157,.379,414,171,28,32,326,669,.449,1489,425,.830,512,67,67,2482,134,205,1920,PF,52,175,460,NYK,.502
16,Joel Anthony,35,.515,68,0,,0,13,30,42,70,35,.515,68,17,.607,28,62,3,566,45,49,87,C,13,22,115,MIA,.515
17,Trevor Ariza,112,.463,242,76,.364,209,113,27,20,222,188,.417,451,78,.821,95,56,15,1471,44,72,530,SF,72,84,266,WAS,.501
18,Darrell Arthur,157,.460,341,5,.278,18,33,24,33,101,162,.451,359,33,.717,46,59,3,970,68,126,362,PF,24,43,169,MEM,.458
19,Omer Asik,332,.542,613,0,.000,1,75,26,87,681,332,.541,614,168,.562,299,82,82,2464,275,223,832,C,46,173,956,HOU,.541
20,D.J. Augustin,36,.346,104,67,.353,190,170,25,3,71,103,.350,294,83,.838,99,76,5,1226,20,64,356,PG,34,68,91,IND,.464
21,Gustavo Ayon,92,.551,167,0,,0,71,27,17,139,92,.551,167,20,.400,50,55,3,734,60,107,204,C,22,47,199,TOT,.551
22,Jeff Ayres,59,.484,122,2,.500,4,15,25,12,75,61,.484,126,21,.913,23,37,0,369,29,44,145,PF,6,23,104,IND,.492
23,Luke Babbitt,24,.429,56,62,.348,178,29,23,5,122,86,.368,234,10,.769,13,62,0,730,15,82,244,PF,14,22,137,POR,.500
24,Leandro Barbosa,65,.445,146,18,.383,47,58,30,6,38,83,.430,193,31,.756,41,41,2,513,8,51,215,PG,17,21,46,BOS,.477
25,J.J. Barea,219,.458,478,97,.346,280,294,28,0,173,316,.417,758,105,.784,134,74,2,1713,34,131,834,PG,32,145,207,MIN,.481
26,Andrea Bargnani,132,.436,303,38,.309,123,38,27,23,102,170,.399,426,65,.844,77,35,25,1003,26,64,443,PF,21,54,128,TOR,.444
27,Harrison Barnes,224,.464,483,52,.359,145,98,20,14,280,276,.439,628,144,.758,190,81,81,2058,53,140,748,SF,52,101,333,GSW,.481
28,Matt Barnes,201,.574,350,111,.342,325,123,32,63,255,312,.462,675,87,.744,117,80,4,2058,111,233,822,SF,82,90,366,LAC,.544
29,Earl Barron,18,.353,51,0,,0,5,31,6,39,18,.353,51,3,.429,7,12,2,159,22,24,39,C,5,11,61,TOT,.353
30,Will Barton,109,.447,244,9,.138,65,58,22,9,109,118,.382,309,50,.769,65,73,5,894,36,56,295,SG,34,60,145,POR,.396
31,Brandon Bass,286,.487,587,0,.000,2,84,27,64,296,286,.486,589,129,.860,150,81,69,2239,129,188,701,PF,44,80,425,BOS,.486
32,Shane Battier,16,.348,46,136,.430,316,72,34,55,128,152,.420,362,32,.842,38,72,20,1786,37,149,472,SF,41,34,165,MIA,.608
33,Nicolas Batum,187,.481,389,165,.372,444,360,24,83,315,352,.423,833,178,.848,210,73,73,2807,97,139,1047,SF,91,190,412,POR,.522
34,Jerryd Bayless,189,.450,420,71,.353,201,264,24,17,154,260,.419,621,102,.836,122,80,4,1765,22,168,693,PG,59,120,176,MEM,.476
35,Aron Baynes,18,.514,35,0,.000,1,5,26,6,20,18,.500,36,7,.583,12,16,0,141,12,23,43,C,1,11,32,SAS,.500
36,Kent Bazemore,33,.402,82,10,.294,34,22,23,4,17,43,.371,116,27,.614,44,61,0,267,5,27,123,SG,17,18,22,GSW,.414
37,Bradley Beal,191,.424,451,91,.386,236,137,19,29,168,282,.410,687,125,.786,159,56,46,1745,43,113,780,SG,50,90,211,WAS,.477
38,Michael Beasley,265,.426,622,45,.313,144,111,24,34,230,310,.405,766,94,.746,126,75,20,1554,52,107,759,SF,31,144,282,PHO,.434
39,Rodrigue Beaubois,44,.423,104,21,.292,72,84,24,4,48,65,.369,176,30,.789,38,45,0,549,9,54,181,PG,19,33,57,DAL,.429
40,Marco Belinelli,162,.416,389,79,.357,221,148,26,6,127,241,.395,610,141,.839,168,73,27,1882,13,140,702,SG,44,82,140,CHI,.460
41,Patrick Beverley,43,.462,93,36,.375,96,117,24,21,64,79,.418,189,34,.829,41,41,0,713,45,83,228,PG,37,44,109,HOU,.513
42,Andris Biedrins,10,.476,21,0,,0,14,26,42,119,10,.476,21,4,.308,13,53,9,495,34,101,24,C,15,14,153,GSW,.476
43,Chauncey Billups,20,.476,42,33,.367,90,49,36,1,30,53,.402,132,45,.938,48,22,22,418,2,25,184,SG,12,26,32,LAC,.527
44,Bismack Biyombo,156,.451,346,0,,0,35,20,143,388,156,.451,346,74,.521,142,80,65,2186,194,195,386,C,28,82,582,CHA,.451
45,DeJuan Blair,142,.526,270,0,.000,1,45,23,10,164,142,.524,271,44,.629,70,61,16,851,66,112,328,PF,37,49,230,SAS,.524
46,Steve Blake,42,.424,99,72,.421,171,173,32,6,111,114,.422,270,27,.771,35,45,13,1175,21,83,327,PG,34,62,132,LAL,.556
47,Andray Blatche,343,.524,654,3,.136,22,85,26,54,256,346,.512,676,148,.685,216,82,8,1555,161,163,843,C,86,123,417,BRK,.514
48,Eric Bledsoe,222,.453,490,31,.397,78,233,23,55,147,253,.445,568,106,.791,134,76,12,1553,78,112,643,PG,109,137,225,LAC,.473
49,Keith Bogans,24,.615,39,84,.343,245,76,32,4,104,108,.380,284,11,.647,17,74,23,1408,16,108,311,SG,28,49,120,BRK,.528
50,Andrew Bogut,82,.448,183,1,1.000,1,67,28,55,177,83,.451,184,19,.500,38,32,32,786,68,85,186,C,20,35,245,GSW,.454
51,Matt Bonner,59,.536,110,53,.442,120,36,32,19,104,112,.487,230,11,.733,15,68,4,909,25,86,288,PF,17,16,129,SAS,.602
52,Trevor Booker,108,.502,215,0,.000,5,40,25,16,141,108,.491,220,40,.556,72,48,14,887,98,95,256,PF,32,31,239,WAS,.491
53,Carlos Boozer,544,.478,1138,0,.000,2,179,31,28,596,544,.477,1140,193,.731,264,79,79,2546,175,239,1281,PF,66,176,771,CHI,.477
54,Chris Bosh,464,.557,833,21,.284,74,123,28,101,370,485,.535,907,241,.798,302,74,74,2454,131,168,1232,C,66,128,501,MIA,.546
55,Avery Bradley,152,.432,352,40,.317,126,104,22,19,81,192,.402,478,37,.755,49,50,50,1435,30,129,461,PG,64,72,111,BOS,.444
56,Elton Brand,226,.474,477,0,.000,1,70,33,90,300,226,.473,478,66,.710,93,72,18,1527,130,192,518,C,50,57,430,DAL,.473
57,Corey Brewer,284,.493,576,91,.296,307,124,26,23,180,375,.425,883,149,.690,216,82,2,2003,55,154,990,SF,118,102,235,DEN,.476
58,Ronnie Brewer,47,.385,122,23,.303,76,50,27,6,98,70,.354,198,16,.410,39,60,34,853,42,33,179,SF,43,18,140,TOT,.412
59,Aaron Brooks,93,.511,182,50,.373,134,114,28,10,67,143,.453,316,40,.769,52,53,20,997,13,94,376,PG,30,67,80,TOT,.532
60,MarShon Brooks,140,.500,280,15,.273,55,76,24,16,72,155,.463,335,69,.734,94,73,2,912,32,93,394,SG,34,69,104,BRK,.485
61,Kwame Brown,17,.459,37,0,,0,9,30,10,51,17,.459,37,7,.368,19,22,11,269,23,37,41,C,6,8,74,PHI,.459
62,Shannon Brown,201,.467,430,39,.277,141,108,27,15,105,240,.420,571,98,.784,125,59,22,1402,44,92,617,SG,59,74,149,PHO,.454
63,Kobe Bryant,606,.510,1188,132,.324,407,469,34,25,367,738,.463,1595,525,.839,626,78,78,3013,66,173,2133,SG,106,287,433,LAL,.504
64,Chase Budinger,53,.482,110,26,.321,81,25,24,7,56,79,.414,191,32,.762,42,23,1,508,15,29,216,SF,14,23,71,MIN,.482
65,Alec Burks,130,.439,296,33,.359,92,92,21,13,108,163,.420,388,92,.713,129,64,0,1137,37,114,451,SG,35,74,145,UTA,.463
66,Caron Butler,177,.454,390,128,.388,330,78,32,11,182,305,.424,720,75,.833,90,78,78,1879,41,139,813,SF,51,72,223,LAC,.513
67,Jimmy Butler,199,.489,407,40,.381,105,115,23,31,192,239,.467,512,187,.803,233,82,20,2134,136,97,705,SF,78,62,328,CHI,.506
68,Will Bynum,229,.494,464,24,.316,76,231,30,5,69,253,.469,540,106,.809,131,65,0,1219,28,128,636,PG,45,125,97,DET,.491
69,Jose Calderon,182,.516,353,130,.461,282,518,31,8,156,312,.491,635,72,.900,80,73,58,2160,20,99,826,PG,58,126,176,TOT,.594
70,Marcus Camby,17,.321,53,0,,0,14,38,14,56,17,.321,53,8,.421,19,24,4,250,24,28,42,PF,7,15,80,NYK,.321
71,DeMarre Carroll,129,.508,254,20,.286,70,61,26,24,101,149,.460,324,75,.765,98,66,12,1111,87,119,393,SF,58,34,188,UTA,.491
72,Matt Carroll,0,,0,0,,0,1,32,0,0,0,,0,0,,0,1,0,6,0,1,0,SG,0,0,0,CHA,
73,Vince Carter,210,.461,456,162,.406,399,194,36,44,276,372,.435,855,182,.816,223,81,3,2093,58,226,1088,SF,74,106,334,DAL,.530
74,Omri Casspi,38,.452,84,25,.329,76,28,24,12,94,63,.394,160,22,.537,41,43,1,503,20,45,173,SF,25,22,114,CLE,.472
75,Mario Chalmers,104,.456,228,123,.409,301,273,26,12,152,227,.429,529,89,.795,112,77,77,2068,19,196,666,PG,118,119,171,MIA,.545
76,Tyson Chandler,255,.638,400,0,,0,62,30,75,434,255,.638,400,179,.694,258,66,66,2164,269,188,689,C,42,87,703,NYK,.638
77,Wilson Chandler,158,.480,329,52,.413,126,58,25,12,173,210,.462,455,88,.793,111,43,8,1079,45,119,560,PF,45,60,218,DEN,.519
78,Josh Childress,5,.278,18,1,.333,3,5,29,2,9,6,.286,21,1,.500,2,14,0,100,6,3,14,SF,2,0,15,BRK,.310
79,Earl Clark,135,.479,282,35,.337,104,65,25,44,243,170,.440,386,53,.697,76,59,36,1363,82,102,428,PF,36,62,325,LAL,.486
80,Victor Claver,49,.480,102,25,.287,87,43,24,12,88,74,.392,189,14,.467,30,49,16,812,31,75,187,SF,26,43,119,POR,.458
81,Norris Cole,144,.440,327,35,.357,98,164,24,7,112,179,.421,425,52,.650,80,80,4,1590,18,155,445,PG,57,104,130,MIA,.462
82,Jason Collins,9,.310,29,0,,0,8,34,10,38,9,.310,29,23,.719,32,38,9,384,22,85,41,C,12,18,60,TOT,.310
83,Darren Collison,293,.498,588,48,.353,136,415,25,8,188,341,.471,724,242,.880,275,81,47,2372,31,139,972,PG,100,173,219,DAL,.504
84,Nick Collison,176,.603,292,0,.000,4,121,32,30,210,176,.595,296,60,.769,78,81,2,1583,123,197,412,C,51,69,333,OKC,.595
85,Mike Conley,308,.476,647,106,.362,293,487,25,24,182,414,.440,940,234,.830,282,80,80,2757,43,171,1168,PG,174,189,225,MEM,.497
86,Will Conroy,0,.000,6,0,.000,3,0,30,0,0,0,.000,9,1,.500,2,4,0,20,1,1,1,PG,0,0,1,MIN,.000
87,Daequan Cook,25,.329,76,26,.286,91,19,25,7,54,51,.305,167,9,.750,12,49,1,441,7,26,137,SG,8,15,61,TOT,.383
88,Chris Copeland,123,.513,240,59,.421,140,27,28,12,85,182,.479,380,63,.759,83,56,13,862,34,104,486,PF,16,50,119,NYK,.557
89,DeMarcus Cousins,478,.471,1014,4,.182,22,199,22,55,524,482,.465,1036,312,.738,423,75,74,2289,222,269,1280,C,108,225,746,SAC,.467
90,Jamal Crawford,296,.477,620,149,.376,396,193,32,13,106,445,.438,1016,216,.871,248,76,0,2230,22,71,1255,SG,79,146,128,LAC,.511
91,Jordan Crawford,218,.455,479,83,.337,246,225,24,7,165,301,.415,725,129,.811,159,70,14,1709,44,106,814,SG,39,141,209,TOT,.472
92,Jae Crowder,78,.446,175,63,.328,192,94,22,17,152,141,.384,367,47,.644,73,78,16,1353,35,128,392,SF,63,49,187,DAL,.470
93,Dante Cunningham,314,.472,665,0,.000,6,67,25,38,266,314,.468,671,67,.650,103,80,9,2010,142,153,695,PF,84,56,408,MIN,.468
94,Jared Cunningham,4,.364,11,2,.667,3,1,21,0,2,6,.429,14,2,1.000,2,8,0,26,1,3,16,SG,1,2,3,DAL,.500
95,Eddy Curry,4,.500,8,0,,0,0,30,0,2,4,.500,8,1,.250,4,2,0,25,2,7,9,C,0,3,4,DAL,.500
96,Stephen Curry,354,.449,788,272,.453,600,539,24,12,255,626,.451,1388,262,.900,291,78,78,2983,59,198,1786,PG,126,240,314,GSW,.549
97,Samuel Dalembert,136,.540,252,1,1.000,1,21,31,53,171,137,.542,253,38,.691,55,47,23,765,105,90,313,C,17,51,276,MIL,.543
98,Marquis Daniels,112,.401,279,20,.278,72,65,32,10,102,132,.376,351,40,.741,54,59,33,1085,48,77,324,SF,51,45,150,MIL,.405
99,Anthony Davis,349,.521,670,0,.000,6,63,19,112,357,349,.516,676,169,.751,225,64,60,1846,165,158,867,PF,75,89,522,NOH,.516
100,Ed Davis,260,.539,482,0,,0,63,23,85,308,260,.539,482,103,.617,167,81,28,1631,152,191,623,C-PF,38,63,460,TOT,.539
101,Glen Davis,214,.450,476,0,.000,2,70,27,21,191,214,.448,478,84,.718,117,34,33,1064,55,88,512,PF,32,64,246,ORL,.448
102,Austin Daye,49,.445,110,41,.418,98,42,24,22,107,90,.433,208,26,.765,34,55,0,676,16,82,247,SF,14,29,123,TOT,.531
103,Nando De Colo,74,.465,159,31,.378,82,138,25,6,115,105,.436,241,35,.795,44,72,6,920,23,87,276,SG,41,81,138,SAS,.500
104,Carlos Delfino,93,.467,199,158,.375,421,135,30,9,202,251,.405,620,48,.857,56,67,5,1689,18,114,708,SF,68,72,220,HOU,.532
105,Luol Deng,391,.455,860,75,.322,233,222,27,32,314,466,.426,1093,230,.816,282,75,75,2903,162,105,1237,SF,81,144,476,CHI,.461
106,Justin Dentmon,0,.000,2,0,,0,0,27,0,0,0,.000,2,0,,0,2,0,4,0,0,0,PG,0,0,0,DAL,.000
107,DeMar DeRozan,514,.463,1111,34,.283,120,204,23,24,272,548,.445,1231,355,.831,427,82,82,3013,48,173,1485,SG,76,151,320,TOR,.459
108,Boris Diaw,149,.587,254,30,.385,78,180,30,27,188,179,.539,332,47,.723,65,75,20,1709,66,143,435,PF,52,84,254,SAS,.584
109,DeSagana Diop,8,.308,26,0,.000,1,13,31,16,41,8,.296,27,0,.000,1,22,1,226,10,19,16,C,5,8,51,CHA,.296
110,Keyon Dooling,5,.556,9,5,.417,12,8,32,0,1,10,.476,21,6,.857,7,7,0,82,0,8,31,PG,1,5,1,MEM,.595
111,Toney Douglas,106,.424,250,82,.380,216,151,26,3,104,188,.403,466,76,.905,84,71,0,1289,34,145,534,PG,71,81,138,TOT,.491
112,Chris Douglas-Roberts,5,.500,10,0,.000,4,4,26,0,5,5,.357,14,7,.700,10,6,0,63,0,4,17,SG,2,1,5,DAL,.357
113,Goran Dragic,313,.497,630,88,.319,276,569,26,26,178,401,.443,906,244,.748,326,77,77,2581,60,214,1134,PG,124,212,238,PHO,.491
114,Andre Drummond,207,.609,340,1,.500,2,30,19,95,288,208,.608,342,59,.371,159,60,10,1243,169,144,476,C,59,57,457,DET,.610
115,Jared Dudley,207,.520,398,106,.391,271,203,27,8,166,313,.468,669,129,.796,162,79,50,2170,79,128,861,SF,75,101,245,PHO,.547
116,Chris Duhon,14,.438,32,33,.363,91,133,30,1,57,47,.382,123,6,.462,13,46,9,820,11,56,133,PG,20,40,68,LAL,.516
117,Tim Duncan,488,.504,969,2,.286,7,184,36,183,562,490,.502,976,245,.817,300,69,69,2078,124,117,1227,C,50,147,686,SAS,.503
118,Mike Dunleavy,148,.455,325,128,.428,299,145,32,35,260,276,.442,624,105,.820,128,75,3,1943,31,135,785,SF,39,90,291,MIL,.545
119,Kevin Durant,592,.539,1099,139,.416,334,374,24,105,594,731,.510,1433,679,.905,750,81,81,3119,46,143,2280,SF,116,280,640,OKC,.559
120,Devin Ebanks,18,.353,51,6,.273,22,10,23,1,31,24,.329,73,11,.786,14,19,3,197,10,23,65,SF,3,11,41,LAL,.370
121,Wayne Ellington,132,.457,289,94,.392,240,104,25,3,141,226,.427,529,68,.907,75,78,21,1661,25,81,614,SG,45,57,166,TOT,.516
122,Monta Ellis,503,.454,1108,94,.287,328,496,27,36,271,597,.416,1436,289,.773,374,82,82,3076,45,164,1577,SG,169,254,316,MIL,.448
123,Kim English,28,.452,62,14,.280,50,26,24,3,29,42,.375,112,21,.724,29,41,0,407,8,46,119,SG,16,19,37,DET,.438
124,Jeremy Evans,27,.628,43,0,.000,1,11,25,13,32,27,.614,44,21,.636,33,37,0,215,26,30,75,PF,8,8,58,UTA,.614
125,Reggie Evans,125,.479,261,0,,0,43,32,13,628,125,.479,261,113,.509,222,80,56,1967,260,199,363,PF,74,111,888,BRK,.479
126,Tyreke Evans,321,.508,632,45,.338,133,229,23,27,231,366,.478,765,210,.775,271,65,61,2016,56,133,987,SG,90,128,287,SAC,.508
127,Festus Ezeli,74,.438,169,0,,0,22,23,74,172,74,.438,169,43,.531,81,78,41,1120,141,157,191,C,23,63,313,GSW,.438
128,Kenneth Faried,380,.552,689,0,,0,77,23,83,474,380,.552,689,163,.613,266,80,80,2248,260,234,923,PF,81,113,734,DEN,.552
129,Derrick Favors,274,.487,563,0,.000,5,75,21,130,362,274,.482,568,179,.688,260,77,8,1787,184,247,727,PF,67,129,546,UTA,.482
130,Raymond Felton,284,.455,624,93,.360,258,372,28,14,143,377,.427,882,101,.789,128,68,68,2313,51,130,948,PG,94,155,194,NYK,.480
131,Landry Fields,100,.478,209,2,.143,14,60,24,8,149,102,.457,223,34,.642,53,51,22,1037,59,63,240,SF,32,42,208,TOR,.462
132,Derek Fisher,25,.309,81,30,.375,80,47,38,3,35,55,.342,161,35,.921,38,33,9,575,2,55,175,SG-PG,19,30,37,TOT,.435
133,Evan Fournier,53,.541,98,22,.407,54,44,20,1,29,75,.493,152,30,.769,39,38,4,428,6,65,202,SG,19,32,35,DEN,.566
134,Randy Foye,115,.378,304,178,.410,434,167,29,27,110,293,.397,738,118,.819,144,82,72,2249,17,190,882,SG,66,92,127,UTA,.518
135,Jimmer Fredette,107,.423,253,65,.417,156,92,23,3,52,172,.421,409,85,.859,99,69,0,967,19,64,494,SG,31,68,71,SAC,.500
136,Joel Freeland,58,.408,142,0,,0,13,25,11,79,58,.408,142,18,.667,27,51,1,477,40,67,134,PF,13,19,119,POR,.408
137,Danilo Gallinari,229,.450,509,135,.373,362,176,24,36,302,364,.418,871,286,.822,348,71,71,2309,65,130,1149,SF,64,111,367,DEN,.495
138,Francisco Garcia,51,.421,121,67,.374,179,63,31,38,83,118,.393,300,18,.857,21,58,20,1029,8,88,321,SG-SF,46,32,91,TOT,.505
139,Kevin Garnett,420,.504,834,2,.125,16,159,36,62,455,422,.496,850,158,.786,201,68,68,2022,75,154,1004,C,78,110,530,BOS,.498
140,Diante Garrett,13,.382,34,3,.200,15,31,24,0,10,16,.327,49,5,.500,10,19,0,149,5,5,40,PG,10,16,15,PHO,.357
141,Marc Gasol,428,.501,855,1,.071,14,318,28,139,438,429,.494,869,268,.848,316,80,80,2796,184,255,1127,C,80,157,622,MEM,.494
142,Pau Gasol,262,.475,551,8,.286,28,200,32,61,310,270,.466,579,125,.702,178,49,42,1655,111,93,673,PF,24,104,421,LAL,.473
143,Rudy Gay,437,.440,993,84,.323,260,202,26,53,362,521,.416,1253,240,.814,295,75,74,2687,99,182,1366,SF,113,198,461,TOT,.449
144,Alonzo Gee,236,.450,525,69,.315,219,133,25,29,245,305,.410,744,163,.795,205,82,82,2541,75,199,842,SF,107,132,320,CLE,.456
145,Mickael Gelabale,56,.644,87,16,.308,52,26,29,4,67,72,.518,139,21,.875,24,36,13,644,32,47,181,SF,16,16,99,MIN,.576
146,Paul George,323,.457,707,170,.362,469,327,22,51,515,493,.419,1176,221,.807,274,79,79,2972,88,227,1377,SF,143,233,603,IND,.491
147,Daniel Gibson,28,.333,84,56,.344,163,82,26,4,55,84,.340,247,26,.703,37,46,3,919,5,89,250,PG,30,31,60,CLE,.453
148,Taj Gibson,214,.490,437,0,.000,4,61,27,90,220,214,.485,441,89,.679,131,65,5,1459,125,166,517,PF,27,76,345,CHI,.485
149,Manu Ginobili,146,.480,304,83,.353,235,274,35,13,171,229,.425,539,164,.796,206,60,0,1393,30,114,705,SG,80,132,201,SAS,.502
150,Drew Gooden,19,.339,56,1,.200,5,6,31,6,18,20,.328,61,11,.688,16,16,0,151,13,21,52,C,5,9,31,MIL,.336
151,Ben Gordon,197,.421,468,113,.387,292,141,29,16,112,310,.408,760,107,.843,127,75,0,1560,18,134,840,SG,35,136,130,CHA,.482
152,Eric Gordon,179,.436,411,56,.324,173,137,24,8,67,235,.402,584,187,.842,222,42,40,1264,10,75,713,SG,45,117,77,NOH,.450
153,Marcin Gortat,295,.524,563,0,.000,3,75,28,98,388,295,.521,566,90,.652,138,61,61,1876,128,127,680,C,40,99,516,PHO,.521
154,Andrew Goudelock,0,.000,2,0,,0,0,24,0,0,0,.000,2,0,,0,1,0,6,1,0,0,SG,0,0,1,LAL,.000
155,Danny Granger,8,.320,25,2,.200,10,3,29,1,6,10,.286,35,5,.625,8,5,0,74,3,6,27,SF,2,4,9,IND,.314
156,Aaron Gray,48,.533,90,0,,0,33,28,5,85,48,.533,90,23,.523,44,42,16,513,48,85,119,C,7,36,133,TOR,.533
157,Danny Green,120,.480,250,177,.429,413,141,25,54,208,297,.448,663,67,.848,79,80,80,2201,36,124,838,SG,92,94,244,SAS,.581
158,Draymond Green,70,.368,190,14,.209,67,53,22,25,202,84,.327,257,45,.818,55,79,1,1061,58,159,227,SF,42,51,260,GSW,.354
159,Gerald Green,96,.407,236,59,.314,188,50,27,23,110,155,.366,424,52,.800,65,60,7,1080,31,64,421,SF,19,53,141,IND,.435
160,Jeff Green,306,.490,624,70,.385,182,128,26,68,263,376,.467,806,214,.808,265,81,17,2252,55,175,1036,PF,56,132,318,BOS,.510
161,Willie Green,107,.486,220,71,.428,166,55,31,12,80,178,.461,386,23,.719,32,72,60,1188,17,96,450,SG,29,31,97,LAC,.553
162,Blake Griffin,572,.548,1044,5,.179,28,299,23,50,476,577,.538,1072,281,.660,426,80,80,2598,186,231,1440,PF,97,185,662,LAC,.541
163,Hamed Haddadi,35,.427,82,0,,0,12,27,27,68,35,.427,82,14,.519,27,30,0,322,43,60,84,C,6,31,111,TOT,.427
164,Jordan Hamilton,57,.445,128,27,.370,73,23,22,8,63,84,.418,201,13,.500,26,40,1,397,32,24,208,SF,15,19,95,DEN,.485
165,Richard Hamilton,188,.444,423,16,.308,52,119,34,5,67,204,.429,475,66,.857,77,50,45,1088,16,93,490,SG,24,84,83,CHI,.446
166,Ben Hansbrough,9,.409,22,6,.261,23,21,25,2,16,15,.333,45,21,.778,27,28,0,200,2,23,57,PG,7,18,18,IND,.400
167,Tyler Hansbrough,176,.436,404,0,.000,3,36,27,18,212,176,.432,407,216,.720,300,81,8,1366,161,152,568,PF,29,78,373,IND,.432
168,James Harden,406,.477,851,179,.368,486,455,23,38,317,585,.438,1337,674,.851,792,78,78,2985,62,178,2023,SG,142,295,379,HOU,.504
169,Maurice Harkless,228,.510,447,32,.274,117,50,19,62,213,260,.461,564,73,.570,128,76,59,1974,122,144,625,SF,88,69,335,ORL,.489
170,Josh Harrellson,3,.750,4,1,.200,5,0,23,1,4,4,.444,9,1,.500,2,6,0,31,3,4,10,C,1,3,7,MIA,.500
171,Al Harrington,12,.444,27,8,.267,30,10,32,1,21,20,.351,57,3,.750,4,10,0,119,6,18,51,C,4,7,27,ORL,.421
172,Devin Harris,117,.549,213,77,.335,230,197,29,13,110,194,.438,443,112,.727,154,58,34,1421,6,103,577,SG,64,88,116,ATL,.525
173,Terrel Harris,4,.211,19,0,.000,8,9,25,3,22,4,.148,27,7,.700,10,20,0,137,4,17,15,SG,2,17,26,TOT,.148
174,Tobias Harris,199,.493,404,34,.315,108,69,20,44,214,233,.455,512,103,.752,137,55,34,1299,73,120,603,SF-PF,32,66,287,TOT,.488
175,Udonis Haslem,129,.514,251,0,,0,38,32,15,307,129,.514,251,32,.711,45,75,59,1414,97,173,290,PF,30,45,404,MIA,.514
176,Spencer Hawes,345,.477,724,31,.356,87,183,24,113,417,376,.464,811,122,.777,157,82,40,2233,173,233,905,C,24,131,590,PHI,.483
177,Chuck Hayes,84,.444,189,0,.000,1,112,29,18,186,84,.442,190,30,.625,48,74,1,1209,113,114,198,C,31,44,299,SAC,.442
178,Gordon Hayward,234,.444,527,102,.415,246,213,22,38,174,336,.435,773,243,.827,294,72,27,2104,51,125,1017,SF,58,120,225,UTA,.501
179,Lazar Hayward,2,.333,6,0,.000,4,3,26,0,4,2,.200,10,6,1.000,6,4,0,31,0,3,10,SF,2,0,4,MIN,.200
180,Brendan Haywood,93,.433,215,0,.000,1,29,33,49,165,93,.431,216,30,.455,66,61,17,1162,125,125,216,C,16,50,290,CHA,.431
181,Gerald Henderson,349,.462,755,33,.330,100,177,25,34,195,382,.447,855,258,.824,313,68,58,2133,55,149,1055,SG,68,108,250,CHA,.466
182,Xavier Henry,62,.413,150,4,.364,11,13,21,5,69,66,.410,161,58,.630,92,50,2,625,21,72,194,SF,16,31,90,NOH,.422
183,John Henson,162,.486,333,0,.000,3,31,22,42,181,162,.482,336,56,.533,105,63,9,827,116,83,380,PF,19,47,297,MIL,.482
184,Roy Hibbert,384,.449,855,1,.250,4,113,26,206,360,385,.448,859,166,.741,224,79,79,2269,296,279,937,C,39,162,656,IND,.449
185,J.J. Hickson,418,.563,742,0,.000,2,88,24,51,562,418,.562,744,182,.679,268,80,80,2323,266,160,1018,C,48,145,828,POR,.562
186,Cory Higgins,5,.357,14,1,.200,5,5,23,0,2,6,.316,19,1,.500,2,6,0,32,1,5,14,SG,3,0,3,CHA,.342
187,Nene Hilario,285,.481,593,0,.000,1,177,30,37,306,285,.480,594,196,.729,269,61,49,1659,101,171,766,PF,55,139,407,WAS,.480
188,George Hill,256,.494,518,130,.368,353,355,26,26,237,386,.443,871,174,.817,213,76,76,2620,47,134,1076,PG,81,116,284,IND,.518
189,Grant Hill,35,.402,87,3,.273,11,26,40,7,43,38,.388,98,14,.583,24,29,0,437,6,39,93,SF,11,25,49,LAC,.403
190,Jordan Hill,77,.503,153,0,.000,2,13,25,19,84,77,.497,155,40,.656,61,29,1,458,82,55,194,PF,8,26,166,LAL,.497
191,Kirk Hinrich,88,.367,240,71,.390,182,314,32,25,142,159,.377,422,70,.714,98,60,60,1764,16,192,459,PG,63,99,158,CHI,.461
192,Jrue Holiday,464,.446,1041,91,.368,247,625,22,32,240,555,.431,1288,182,.752,242,78,78,2926,89,170,1383,PG,123,292,329,PHI,.466
193,Justin Holiday,12,.375,32,4,.250,16,15,23,6,14,16,.333,48,6,.750,8,9,0,142,0,7,42,SG,3,9,14,PHI,.375
194,Ryan Hollins,70,.614,114,0,,0,11,28,34,89,70,.614,114,66,.750,88,60,0,663,50,133,206,C,6,44,139,LAC,.614
195,Tyler Honeycutt,3,.333,9,0,.000,2,2,22,1,7,3,.273,11,2,1.000,2,9,0,32,3,2,8,SF,0,5,10,SAC,.273
196,Al Horford,573,.544,1054,3,.500,6,240,26,78,562,576,.543,1060,134,.644,208,74,74,2756,195,163,1289,C,78,147,757,ATL,.545
197,Dwight Howard,469,.581,807,1,.167,6,108,27,186,694,470,.578,813,355,.492,721,76,76,2722,251,291,1296,C,84,225,945,LAL,.579
198,Josh Howard,26,.426,61,5,.313,16,4,32,3,27,31,.403,77,7,.583,12,11,4,207,9,18,74,SF,10,10,36,MIN,.435
199,Juwan Howard,10,.526,19,0,,0,6,39,0,8,10,.526,19,1,1.000,1,7,2,51,0,9,21,PF,0,4,8,MIA,.526
200,Kris Humphries,139,.451,308,0,.000,2,32,27,33,239,139,.448,310,97,.789,123,65,21,1191,126,127,375,PF,16,57,365,BRK,.448
201,Serge Ibaka,426,.591,721,20,.351,57,43,23,242,395,446,.573,778,143,.749,191,80,80,2486,222,213,1055,PF,28,125,617,OKC,.586
202,Andre Iguodala,305,.515,592,91,.317,287,433,29,52,341,396,.451,879,155,.574,270,80,80,2779,82,127,1038,SG,139,206,423,DEN,.502
203,Ersan Ilyasova,276,.469,589,95,.444,214,117,25,36,366,371,.462,803,125,.796,157,73,54,2012,154,185,962,PF,68,75,520,MIL,.521
204,Kyrie Irving,375,.474,791,109,.391,279,350,20,21,182,484,.452,1070,248,.855,290,59,59,2048,34,146,1325,PG,89,191,216,CLE,.503
205,Royal Ivey,25,.446,56,37,.420,88,32,31,3,41,62,.431,144,9,.563,16,53,5,698,16,73,170,SG,23,20,57,PHI,.559
206,Jarrett Jack,305,.466,654,82,.404,203,439,29,11,222,387,.452,857,167,.843,198,79,4,2349,21,134,1023,SG,60,157,243,GSW,.499
207,Reggie Jackson,125,.566,221,24,.231,104,122,22,13,145,149,.458,325,52,.839,62,70,0,993,21,84,374,PG,29,53,166,OKC,.495
208,Stephen Jackson,77,.481,160,46,.271,170,80,34,14,133,123,.373,330,49,.700,70,55,6,1075,22,89,341,SF,37,77,155,SAS,.442
209,Bernard James,53,.525,101,0,.000,2,6,27,38,79,53,.515,103,25,.610,41,46,11,457,52,64,131,C,12,18,131,DAL,.515
210,Damion James,0,,0,0,,0,0,25,0,1,0,,0,0,,0,2,0,0,0,0,0,SF,0,0,1,BRK,
211,LeBron James,662,.602,1100,103,.406,254,551,28,67,513,765,.565,1354,403,.753,535,76,76,2877,97,110,2036,PF,129,226,610,MIA,.603
212,Mike James,53,.363,146,48,.384,125,139,37,3,63,101,.373,271,23,.793,29,45,23,862,9,95,273,PG,26,55,72,DAL,.461
213,Antawn Jamison,183,.535,342,84,.361,233,50,36,22,253,267,.464,575,94,.691,136,76,6,1636,109,124,712,PF,30,53,362,LAL,.537
214,Al Jefferson,609,.500,1219,2,.118,17,164,28,89,564,611,.494,1236,167,.770,217,78,78,2578,156,170,1391,C,80,105,720,UTA,.495
215,Richard Jefferson,48,.527,91,14,.311,45,31,32,7,79,62,.456,136,38,.717,53,56,1,568,5,45,176,SF,14,23,84,GSW,.507
216,Jared Jeffries,16,.308,52,0,.000,2,14,31,6,34,16,.296,54,12,.522,23,38,0,350,26,58,44,PF,6,17,60,POR,.296
217,Charles Jenkins,48,.403,119,1,.500,2,44,23,2,24,49,.405,121,12,.545,22,59,1,441,8,22,111,SG-PG,15,21,32,TOT,.409
218,John Jenkins,78,.500,156,53,.384,138,56,21,10,77,131,.446,294,59,.843,70,61,2,902,17,37,374,SG,12,40,94,ATL,.536
219,Brandon Jennings,324,.412,786,173,.375,461,521,23,10,187,497,.399,1247,230,.819,281,80,80,2897,59,155,1397,PG,125,203,246,MIL,.468
220,Jonas Jerebko,117,.502,233,25,.301,83,43,25,8,117,142,.449,316,68,.773,88,49,2,892,68,90,377,PF,38,42,185,DET,.489
221,Amir Johnson,331,.558,593,5,.385,13,122,25,110,384,336,.554,606,136,.727,187,81,38,2325,227,301,813,PF,81,117,611,TOR,.559
222,Chris Johnson,48,.640,75,0,,0,8,27,28,40,48,.640,75,21,.618,34,30,0,284,20,49,117,C,7,13,60,MIN,.640
223,Chris Johnson,5,.714,7,6,.333,18,2,22,0,6,11,.440,25,1,.500,2,8,0,102,5,5,29,SF,4,3,11,MEM,.560
224,Ivan Johnson,184,.536,343,1,.077,13,46,28,14,190,185,.520,356,81,.618,131,69,5,1035,76,131,452,PF,56,71,266,ATL,.521
225,James Johnson,115,.439,262,2,.095,21,58,25,50,96,117,.413,283,40,.597,67,54,11,878,49,99,276,SF,41,68,145,SAC,.417
226,Joe Johnson,297,.452,657,148,.375,395,253,31,14,165,445,.423,1052,132,.820,161,72,72,2642,53,99,1170,SG,49,123,218,BRK,.493
227,Orlando Johnson,36,.419,86,36,.383,94,47,23,9,90,72,.400,180,23,.719,32,51,0,619,20,51,203,SG,11,29,110,IND,.500
228,Wesley Johnson,111,.461,241,50,.323,155,34,25,18,102,161,.407,396,27,.771,35,50,21,953,21,56,399,SF,22,48,123,PHO,.470
229,Darius Johnson-Odom,0,.000,3,0,.000,1,1,23,0,3,0,.000,4,0,,0,4,0,6,1,0,0,SG,0,0,4,LAL,.000
230,Dahntay Jones,71,.410,173,11,.224,49,48,32,6,77,82,.369,222,87,.770,113,78,19,1016,24,119,262,SF,22,38,101,TOT,.394
231,DeQuan Jones,86,.470,183,9,.257,35,16,22,22,88,95,.436,218,34,.667,51,63,17,803,17,55,233,SF,19,30,105,ORL,.456
232,Dominique Jones,39,.390,100,1,.111,9,83,24,2,27,40,.367,109,35,.660,53,29,3,338,18,29,116,PG,14,38,45,DAL,.372
233,James Jones,5,.625,8,16,.302,53,13,32,6,22,21,.344,61,2,.500,4,38,0,221,0,16,60,SF,2,3,22,MIA,.475
234,Kevin Jones,43,.402,107,0,,0,10,23,5,40,43,.402,107,9,.600,15,32,0,334,38,25,95,PF,9,8,78,CLE,.402
235,Perry Jones,39,.402,97,0,.000,2,10,21,6,50,39,.394,99,10,.667,15,38,1,280,12,23,88,SF,5,15,62,OKC,.394
236,Solomon Jones,0,.000,1,0,,0,0,28,1,2,0,.000,1,0,,0,2,1,26,1,3,0,PF,0,3,3,NYK,.000
237,Terrence Jones,38,.507,75,5,.263,19,15,21,19,37,43,.457,94,13,.765,17,19,0,276,28,21,104,PF,12,13,65,HOU,.484
238,DeAndre Jordan,314,.643,488,0,,0,28,24,112,384,314,.643,488,96,.386,249,82,82,2010,210,192,724,C,48,100,594,LAC,.643
239,Cory Joseph,45,.506,89,6,.286,21,53,21,4,40,51,.464,110,18,.857,21,28,9,388,12,25,126,PG,15,21,52,SAS,.491
240,Kris Joseph,2,.182,11,0,.000,3,1,24,0,6,2,.143,14,5,.625,8,10,0,54,1,3,9,SF,3,2,7,TOT,.143
241,Chris Kaman,313,.508,616,0,.000,1,51,30,52,275,313,.507,617,67,.788,85,66,52,1363,97,141,693,C,29,103,372,DAL,.507
242,Enes Kanter,205,.542,378,1,1.000,1,31,20,32,169,206,.544,379,93,.795,117,70,2,1078,135,116,506,C,28,101,304,UTA,.545
243,Jason Kidd,38,.452,84,114,.351,325,249,39,25,273,152,.372,409,40,.833,48,76,48,2043,50,125,458,SG,125,76,323,NYK,.511
244,Michael Kidd-Gilchrist,279,.462,604,2,.222,9,117,19,70,324,281,.458,613,140,.749,187,78,77,2025,131,164,704,SF,54,101,455,CHA,.460
245,Andrei Kirilenko,249,.566,440,35,.292,120,177,31,62,260,284,.507,560,188,.752,250,64,64,2034,102,82,791,SF,96,119,362,MIN,.538
246,Linas Kleiza,28,.359,78,20,.303,66,16,28,2,42,48,.333,144,32,.842,38,20,3,376,10,45,148,SF,4,14,52,TOR,.403
247,Brandon Knight,237,.430,551,120,.367,327,303,21,8,193,357,.407,878,165,.733,225,75,75,2365,54,157,999,PG,58,205,247,DET,.475
248,Kyle Korver,88,.471,187,189,.457,414,146,31,37,270,277,.461,601,67,.859,78,74,60,2259,23,170,810,SF,70,70,293,ATL,.618
249,Kosta Koufos,295,.582,507,0,.000,1,32,23,103,351,295,.581,508,58,.558,104,81,81,1817,211,246,648,C,44,53,562,DEN,.581
250,Viacheslav Kravtsov,33,.717,46,0,,0,9,25,9,21,33,.717,46,11,.297,37,25,0,224,24,32,77,C,5,14,45,DET,.717
251,Doron Lamb,46,.365,126,14,.378,37,32,21,0,38,60,.368,163,20,.588,34,47,0,577,8,52,154,SG,13,26,46,TOT,.411
252,Jeremy Lamb,15,.395,38,9,.300,30,5,20,2,13,24,.353,68,14,1.000,14,23,0,147,5,13,71,SF,2,6,18,OKC,.419
253,Carl Landry,324,.541,599,1,.333,3,65,29,31,303,325,.540,602,223,.817,273,81,2,1876,180,190,874,PF,35,115,483,GSW,.541
254,Ty Lawson,363,.491,739,85,.366,232,501,25,8,162,448,.461,971,235,.756,311,73,71,2513,36,135,1216,PG,107,182,198,DEN,.505
255,Courtney Lee,188,.503,374,58,.372,156,143,27,21,159,246,.464,530,62,.861,72,78,39,1941,31,139,612,SG,89,84,190,BOS,.519
256,David Lee,602,.521,1156,0,.000,4,279,29,22,668,602,.519,1160,255,.797,320,79,79,2907,218,246,1459,PF,67,207,886,GSW,.519
257,Malcolm Lee,21,.404,52,8,.333,24,20,22,6,24,29,.382,76,12,.600,20,16,12,289,15,30,78,SG,12,10,39,MIN,.434
258,Kawhi Leonard,195,.554,352,65,.374,174,93,21,32,283,260,.494,526,104,.825,126,58,57,1810,63,99,689,SF,97,62,346,SAS,.556
259,Meyers Leonard,148,.548,270,3,.429,7,33,20,38,175,151,.545,277,72,.809,89,69,9,1206,80,168,377,C,11,49,255,POR,.551
260,Jon Leuer,25,.510,49,0,.000,3,8,23,0,24,25,.481,52,6,.462,13,28,0,187,13,21,56,PF-C,6,8,37,TOT,.481
261,Rashard Lewis,52,.441,118,51,.389,131,30,33,14,102,103,.414,249,28,.622,45,55,9,792,19,67,285,PF,21,33,121,MIA,.516
262,DeAndre Liggins,14,.500,28,7,.368,19,15,24,3,40,21,.447,47,9,.500,18,39,1,290,13,33,58,SG,18,14,53,OKC,.521
263,Damian Lillard,368,.469,785,185,.368,503,531,22,19,215,553,.429,1288,271,.844,321,82,82,3167,42,172,1562,PG,74,243,257,POR,.501
264,Jeremy Lin,309,.483,640,87,.339,257,497,24,29,215,396,.441,897,216,.785,275,82,82,2640,32,205,1095,PG,134,236,247,HOU,.490
265,Shaun Livingston,166,.485,342,0,.000,4,215,27,31,127,166,.480,346,85,.867,98,66,16,1455,31,127,417,PG,48,76,158,TOT,.480
266,Brook Lopez,570,.522,1093,0,.000,1,70,24,154,304,570,.521,1094,297,.758,392,74,74,2253,208,152,1437,C,33,131,512,BRK,.521
267,Robin Lopez,384,.534,719,0,,0,64,24,128,236,384,.534,719,161,.778,207,82,82,2136,226,167,929,C,32,110,462,NOH,.534
268,Kevin Love,85,.413,206,20,.217,92,42,24,9,188,105,.352,298,100,.704,142,18,18,618,64,34,330,PF,13,39,252,MIN,.386
269,Kyle Lowry,149,.433,344,101,.362,279,435,26,24,265,250,.401,623,190,.795,239,68,52,2020,56,218,791,PG,94,157,321,TOR,.482
270,John Lucas III,72,.393,183,57,.377,151,105,30,1,57,129,.386,334,18,.720,25,63,0,827,8,50,333,PG,23,26,65,TOR,.472
271,Scott Machado,3,.600,5,0,.000,1,6,22,0,1,3,.500,6,2,1.000,2,6,0,21,0,0,8,PG,2,8,1,HOU,.500
272,Shelvin Mack,40,.519,77,18,.367,49,68,22,0,37,58,.460,126,9,.563,16,31,3,416,3,39,143,PG-SG,15,34,40,TOT,.532
273,Corey Maggette,22,.400,55,5,.238,21,19,33,2,20,27,.355,76,36,.750,48,18,0,257,5,42,95,SF,6,17,25,DET,.388
274,Ian Mahinmi,149,.456,327,0,.000,2,27,26,66,196,149,.453,329,104,.608,171,80,2,1322,115,201,402,C,39,92,311,IND,.453
275,Shawn Marion,332,.538,617,23,.315,73,163,34,47,379,355,.514,690,79,.782,101,67,67,2010,146,111,812,PF,75,103,525,DAL,.531
276,Kendall Marshall,33,.423,78,23,.315,73,143,21,4,38,56,.371,151,8,.571,14,48,3,702,4,48,143,PG,22,57,42,PHO,.447
277,Cartier Martin,38,.358,106,58,.397,146,20,28,6,89,96,.381,252,20,.714,28,41,3,694,11,58,270,SF,19,32,100,WAS,.496
278,Kenyon Martin,56,.602,93,0,,0,8,35,17,61,56,.602,93,17,.425,40,18,11,431,34,64,129,C,16,16,95,NYK,.602
279,Kevin Martin,192,.472,407,158,.426,371,106,29,8,147,350,.450,778,219,.890,246,77,0,2136,31,138,1077,SG,72,101,178,OKC,.551
280,Roger Mason,66,.452,146,66,.415,159,74,32,11,121,132,.433,305,39,.907,43,69,13,1219,11,104,369,SG,26,51,132,NOH,.541
281,Wesley Matthews,183,.478,383,169,.398,425,174,26,18,156,352,.436,808,149,.797,187,69,69,2403,35,172,1022,SG,90,109,191,POR,.540
282,Jason Maxiell,204,.446,457,0,,0,54,29,95,274,204,.446,457,90,.621,145,72,71,1789,135,172,498,PF,32,81,409,DET,.446
283,Eric Maynor,72,.389,185,34,.354,96,182,25,1,37,106,.377,281,45,.726,62,64,0,963,9,55,291,PG-SG,22,79,46,TOT,.438
284,O.J. Mayo,319,.471,677,142,.407,349,361,25,23,255,461,.449,1026,191,.820,233,82,82,2913,36,195,1255,SG,93,210,291,DAL,.519
285,Luc Mbah a Moute,138,.406,340,13,.351,37,55,26,14,167,151,.401,377,72,.571,126,58,45,1326,89,82,387,SF,42,70,256,MIL,.418
286,JaVale McGee,302,.574,526,1,1.000,1,24,25,157,223,303,.575,527,110,.591,186,79,0,1433,158,184,717,C,30,90,381,DEN,.576
287,Dominic McGuire,24,.429,56,0,,0,20,27,11,59,24,.429,56,3,.300,10,26,10,387,19,39,51,SF,13,12,78,TOT,.429
288,Josh McRoberts,132,.510,259,24,.286,84,141,25,27,232,156,.455,343,65,.765,85,67,22,1487,93,131,401,PF,32,66,325,TOT,.490
289,Jodie Meeks,83,.441,188,122,.357,342,69,25,5,134,205,.387,530,86,.896,96,78,10,1663,37,103,618,SG,58,52,171,LAL,.502
290,Fab Melo,3,.500,6,0,,0,0,22,2,3,3,.500,6,1,.250,4,6,0,36,0,7,7,C,2,1,3,BOS,.500
291,Khris Middleton,48,.500,96,14,.311,45,28,21,4,46,62,.440,141,27,.844,32,27,0,475,4,53,165,SG,15,11,50,DET,.489
292,C.J. Miles,129,.451,286,126,.384,328,63,25,17,150,255,.415,614,93,.869,107,65,13,1364,24,138,729,SF,49,69,174,CLE,.518
293,Darko Milicic,0,.000,1,0,,0,0,27,0,1,0,.000,1,0,,0,1,0,5,0,1,0,C,0,2,1,BOS,.000
294,Andre Miller,286,.504,568,17,.266,64,484,36,11,178,303,.479,632,163,.840,194,82,11,2151,60,159,786,PG,73,172,238,DEN,.493
295,Darius Miller,22,.423,52,22,.393,56,44,22,12,70,44,.407,108,8,1.000,8,52,2,694,8,89,118,SF,17,23,78,NOH,.509
296,Mike Miller,27,.482,56,73,.417,175,99,32,4,139,100,.433,231,8,.727,11,59,17,900,18,63,281,SF,21,35,157,MIA,.591
297,Quincy Miller,4,.364,11,0,.000,1,3,20,0,1,4,.333,12,1,.500,2,7,0,26,1,3,9,PF,1,1,2,DEN,.333
298,Patty Mills,61,.550,111,52,.400,130,62,24,4,41,113,.469,241,16,.842,19,58,2,656,9,55,294,PG,26,39,50,SAS,.577
299,Paul Millsap,416,.498,836,13,.333,39,201,27,80,377,429,.490,875,264,.742,356,78,78,2375,177,232,1135,PF,102,138,554,UTA,.498
300,Nazr Mohammed,66,.371,178,0,.000,2,26,35,32,122,66,.367,180,34,.723,47,63,12,693,73,97,166,C,21,24,195,CHI,.367
301,Greg Monroe,514,.488,1054,0,.000,4,281,22,55,541,514,.486,1058,270,.689,392,81,81,2687,236,190,1298,C,105,234,777,DET,.486
302,E'Twaun Moore,170,.424,401,67,.340,197,206,23,23,119,237,.396,598,47,.797,59,75,21,1682,48,122,588,SG,51,105,167,ORL,.452
303,Darius Morris,49,.402,122,24,.364,66,76,22,2,33,73,.388,188,24,.649,37,48,17,683,24,58,194,PG,21,45,57,LAL,.452
304,Marcus Morris,136,.464,293,86,.369,233,62,23,20,197,222,.422,526,66,.564,117,77,23,1524,80,160,596,PF-SF,45,77,277,TOT,.504
305,Markieff Morris,221,.426,519,45,.336,134,108,23,64,265,266,.407,653,93,.732,127,82,32,1837,131,209,670,PF,77,104,396,PHO,.442
306,Anthony Morrow,48,.471,102,16,.372,43,13,27,1,19,64,.441,145,20,.909,22,41,1,383,11,43,164,SG,13,8,30,TOT,.497
307,Donatas Motiejunas,73,.562,130,24,.289,83,31,22,10,57,97,.455,213,32,.627,51,44,14,538,36,73,250,PF,7,37,93,HOU,.512
308,Arnett Moultrie,78,.582,134,0,,0,10,22,10,69,78,.582,134,18,.643,28,47,0,542,76,43,174,PF,17,19,145,PHI,.582
309,Timofey Mozgov,44,.518,85,0,.000,2,9,26,18,57,44,.506,87,20,.769,26,41,1,366,50,57,108,C,6,25,107,DEN,.506
310,Byron Mullens,151,.425,355,66,.317,208,81,23,32,266,217,.385,563,64,.646,99,53,41,1428,71,110,564,PF,34,74,337,CHA,.444
311,Kevin Murphy,6,.261,23,1,.200,5,2,22,0,4,7,.250,28,0,,0,17,0,52,0,4,15,SG,1,3,4,UTA,.268
312,Troy Murphy,11,.423,26,11,.314,35,7,32,6,42,22,.361,61,10,.909,11,14,1,256,7,29,65,PF,10,7,49,DAL,.451
313,Steve Nash,179,.519,345,57,.438,130,333,38,5,116,236,.497,475,107,.922,116,50,50,1627,26,70,636,PG,30,126,142,LAL,.557
314,Gary Neal,157,.454,346,89,.355,251,129,28,2,130,246,.412,597,64,.865,74,68,17,1484,13,93,645,SG,30,69,143,SAS,.487
315,Jameer Nelson,185,.435,425,121,.341,355,413,30,6,186,306,.392,780,89,.873,102,56,56,1977,23,161,822,PG,71,154,209,ORL,.470
316,Andrew Nicholson,256,.527,486,0,,0,44,23,32,189,256,.527,486,75,.798,94,75,28,1249,69,133,587,PF,24,79,258,ORL,.527
317,Joakim Noah,303,.485,625,0,.000,5,262,27,141,473,303,.481,630,178,.751,237,66,64,2426,260,185,784,C,78,176,733,CHI,.481
318,Steve Novak,29,.367,79,149,.425,351,35,29,8,135,178,.414,430,30,.909,33,81,1,1641,17,97,535,SF,28,12,152,NYK,.587
319,Dirk Nowitzki,278,.487,571,65,.414,157,132,34,37,326,343,.471,728,166,.860,193,53,47,1661,37,93,917,PF,38,70,363,DAL,.516
320,Jermaine O'Neal,179,.482,371,0,,0,42,34,78,211,179,.482,371,96,.835,115,55,4,1029,82,126,454,C,19,73,293,PHO,.482
321,Kyle O'Quinn,101,.515,196,0,.000,1,52,22,26,144,101,.513,197,30,.667,45,57,5,638,65,107,232,C,11,37,209,ORL,.513
322,Lamar Odom,128,.464,276,18,.200,90,142,33,58,363,146,.399,366,20,.476,42,82,2,1616,117,214,330,PF,69,86,480,LAC,.423
323,Tim Ohlbrecht,1,.333,3,0,,0,1,24,0,1,1,.333,3,1,1.000,1,3,0,12,0,1,3,C,1,4,1,HOU,.333
324,Emeka Okafor,328,.477,687,0,,0,93,30,77,493,328,.477,687,109,.571,191,79,77,2052,199,145,765,C,45,107,692,WAS,.477
325,Daniel Orton,12,.462,26,0,,0,4,22,3,13,12,.462,26,9,.529,17,13,0,104,13,13,33,C,4,4,26,OKC,.462
326,Travis Outlaw,60,.472,127,14,.280,50,21,28,8,44,74,.418,177,38,.731,52,38,2,444,17,35,200,SF,11,19,61,SAC,.458
327,Zaza Pachulia,114,.479,238,0,.000,3,79,28,12,204,114,.473,241,78,.757,103,52,15,1134,132,128,306,C,35,70,336,ATL,.473
328,Jannero Pargo,39,.406,96,39,.336,116,67,33,3,25,78,.368,212,12,.923,13,32,0,507,10,42,207,PG,18,41,35,TOT,.460
329,Jeremy Pargo,74,.420,176,25,.338,74,92,26,2,41,99,.396,250,42,.677,62,39,11,655,8,46,265,PG-SG,13,50,49,TOT,.446
330,Tony Parker,495,.534,927,24,.353,68,499,30,6,180,519,.522,995,279,.845,330,66,66,2174,18,92,1341,PG,54,170,198,SAS,.534
331,Chandler Parsons,304,.559,544,152,.385,395,269,24,32,325,456,.486,939,113,.729,155,76,76,2758,79,148,1177,SF,75,147,404,HOU,.567
332,Patrick Patterson,268,.546,491,51,.386,132,81,23,40,224,319,.512,623,48,.762,63,71,41,1775,113,138,737,PF,31,61,337,TOT,.553
333,Chris Paul,336,.538,624,76,.328,232,678,27,10,209,412,.481,856,286,.885,323,70,70,2335,53,143,1186,PG,169,159,262,LAC,.526
334,Sasha Pavlovic,24,.407,59,18,.300,60,32,29,5,49,42,.353,119,1,.167,6,39,1,528,7,59,103,SG,24,14,56,POR,.429
335,Nikola Pekovic,385,.520,741,0,,0,53,27,50,315,385,.520,741,241,.744,324,62,62,1959,230,143,1011,C,43,101,545,MIN,.520
336,Kendrick Perkins,143,.458,312,0,.000,1,111,28,83,356,143,.457,313,44,.611,72,78,78,1954,110,227,330,C,43,109,466,OKC,.457
337,Johan Petro,47,.443,106,1,.250,4,16,27,9,79,48,.436,110,11,.917,12,31,8,352,33,48,108,C,10,24,112,ATL,.441
338,Paul Pierce,331,.466,710,145,.380,382,370,35,30,442,476,.436,1092,333,.787,423,77,77,2575,45,210,1430,SF,84,214,487,BOS,.502
339,Mickael Pietrus,14,.412,34,20,.313,64,9,30,6,31,34,.347,98,12,.667,18,19,16,386,5,33,100,SF,12,16,36,TOR,.449
340,Dexter Pittman,4,.364,11,0,,0,0,24,0,5,4,.364,11,0,.000,3,11,0,32,7,8,8,C,0,3,12,TOT,.364
341,Miles Plumlee,5,.238,21,0,,0,2,24,3,10,5,.238,21,3,.750,4,14,0,55,12,5,13,C,0,3,22,IND,.238
342,Quincy Pondexter,68,.463,147,60,.395,152,61,24,6,89,128,.428,299,59,.787,75,59,1,1243,43,95,375,SF,35,42,132,MEM,.528
343,A.J. Price,91,.427,213,70,.350,200,205,26,3,94,161,.390,413,49,.790,62,57,22,1278,20,73,441,PG,33,64,114,WAS,.475
344,Ronnie Price,29,.358,81,10,.256,39,73,29,3,31,39,.325,120,17,.708,24,39,0,510,13,61,105,PG,26,34,44,POR,.367
345,Pablo Prigioni,47,.547,86,53,.396,134,236,35,2,102,100,.455,220,22,.880,25,78,18,1263,41,127,275,PG,69,86,143,NYK,.575
346,Tayshaun Prince,321,.442,726,38,.404,94,196,32,25,292,359,.438,820,96,.738,130,82,81,2631,72,86,852,SF,48,89,364,TOT,.461
347,Joel Przybilla,1,.250,4,0,,0,4,33,2,16,1,.250,4,0,.000,2,12,1,68,5,10,2,C,1,4,21,MIL,.250
348,Chris Quinn,4,.364,11,0,.000,5,9,29,0,1,4,.250,16,2,1.000,2,7,0,78,1,4,10,SG,3,6,2,CLE,.250
349,Vladimir Radmanovic,8,.500,16,5,.185,27,8,32,4,18,13,.302,43,2,.667,3,25,0,144,10,29,33,PF,8,7,28,CHI,.360
350,Anthony Randolph,56,.528,106,0,.000,8,12,23,21,66,56,.491,114,31,.689,45,39,0,329,29,41,143,PF,19,37,95,DEN,.491
351,Shavlik Randolph,28,.583,48,0,,0,4,29,7,42,28,.583,48,11,.407,27,16,0,198,28,38,67,PF,8,10,70,BOS,.583
352,Zach Randolph,469,.469,1001,2,.087,23,108,31,31,544,471,.460,1024,225,.750,300,76,75,2607,310,180,1169,PF,61,150,854,MEM,.461
353,J.J. Redick,217,.506,429,165,.366,451,296,28,9,154,382,.434,880,171,.900,190,78,13,2379,17,117,1100,SG,38,138,171,TOT,.528
354,Jason Richardson,78,.462,169,57,.341,167,51,32,15,108,135,.402,336,20,.606,33,33,33,936,19,57,347,SG,40,26,127,PHI,.487
355,Quentin Richardson,0,.000,7,1,.250,4,1,32,0,5,1,.091,11,2,1.000,2,1,0,29,5,1,5,SF,0,2,10,NYK,.136
356,Luke Ridnour,301,.503,599,66,.311,212,311,31,15,165,367,.453,811,139,.848,164,82,82,2474,41,187,939,SG,82,130,206,MIN,.493
357,Austin Rivers,117,.385,304,28,.326,86,127,20,9,93,145,.372,390,59,.546,108,61,26,1418,16,122,377,SG,26,74,109,NOH,.408
358,Brian Roberts,154,.430,358,59,.386,153,219,27,3,80,213,.417,511,70,.909,77,78,5,1324,17,108,555,PG,37,71,97,NOH,.475
359,Nate Robinson,258,.450,573,141,.405,348,358,28,10,155,399,.433,921,135,.799,169,82,23,2086,29,207,1074,PG,85,144,184,CHI,.510
360,Thomas Robinson,138,.431,320,0,.000,1,46,21,26,193,138,.430,321,57,.523,109,70,0,1056,122,124,333,PF,41,88,315,TOT,.430
361,Rajon Rondo,213,.513,415,12,.240,50,420,26,9,169,225,.484,465,60,.645,93,38,38,1423,43,96,522,PG,70,148,212,BOS,.497
362,Terrence Ross,121,.464,261,65,.332,196,53,21,14,109,186,.407,457,30,.714,42,73,2,1239,35,122,467,SG,43,48,144,TOR,.478
363,Brandon Roy,11,.423,26,0,.000,9,23,28,0,11,11,.314,35,7,.700,10,5,5,122,3,5,29,SG,3,7,14,MIN,.314
364,Ricky Rubio,158,.374,422,27,.293,92,418,22,5,185,185,.360,514,211,.799,264,57,47,1691,44,143,608,PG,137,172,229,MIN,.386
365,Brandon Rush,6,.857,7,0,.000,2,2,27,0,1,6,.667,9,2,.667,3,2,0,25,0,5,14,SF,0,3,1,GSW,.667
366,Robert Sacre,18,.375,48,0,,0,6,23,10,25,18,.375,48,7,.636,11,32,3,203,9,38,43,C,0,10,34,LAL,.375
367,John Salmons,145,.420,345,99,.371,267,226,33,25,174,244,.399,612,85,.773,110,76,72,2278,33,143,672,SF,51,85,207,SAC,.480
368,Samardo Samuels,22,.373,59,0,.000,1,8,24,3,18,22,.367,60,14,.583,24,18,1,196,10,30,58,C,3,6,28,CLE,.367
369,Larry Sanders,306,.507,603,0,.000,2,83,24,201,448,306,.506,605,84,.618,136,71,55,1937,224,233,696,C,53,87,672,MIL,.506
370,Luis Scola,429,.477,899,3,.188,16,182,32,35,383,432,.472,915,181,.787,230,82,67,2184,158,257,1048,PF,67,126,541,PHO,.474
371,Mike Scott,70,.479,146,0,.000,1,12,24,2,71,70,.476,147,43,.768,56,40,1,376,39,32,183,PF,4,21,110,ATL,.476
372,Thabo Sefolosha,116,.558,208,108,.419,258,125,28,44,259,224,.481,466,57,.826,69,81,81,2229,58,177,613,SG,103,64,317,OKC,.597
373,Josh Selby,5,.313,16,1,.167,6,4,21,0,5,6,.273,22,7,.636,11,10,0,59,0,7,20,PG,2,7,5,MEM,.295
374,Kevin Seraphin,330,.461,716,0,,0,57,23,59,239,330,.461,716,61,.693,88,79,8,1721,107,211,721,C,24,130,346,WAS,.461
375,Ramon Sessions,243,.427,569,33,.308,107,230,26,7,142,276,.408,676,291,.839,347,61,0,1652,27,91,876,SG,48,104,169,CHA,.433
376,Tornike Shengelia,9,.429,21,1,.500,2,3,21,1,14,10,.435,23,9,.563,16,19,0,93,9,11,30,SF,3,11,23,BRK,.457
377,Iman Shumpert,58,.392,148,51,.402,127,75,22,7,105,109,.396,275,36,.766,47,45,45,996,31,99,305,SG,43,37,136,NYK,.489
378,Alexey Shved,151,.435,347,85,.295,288,286,24,27,134,236,.372,635,108,.720,150,77,16,1840,41,117,665,SG,54,147,175,MIN,.439
379,Henry Sims,2,.667,3,0,,0,0,22,0,0,2,.667,3,0,,0,2,0,5,2,1,4,C,0,1,2,NOH,.667
380,Kyle Singler,205,.464,442,70,.350,200,77,24,37,221,275,.428,642,100,.806,124,82,74,2293,109,217,720,SF,57,98,330,DET,.483
381,Chris Singleton,85,.415,205,7,.194,36,37,23,24,133,92,.382,241,40,.571,70,57,11,924,51,124,231,PF,38,45,184,WAS,.396
382,Donald Sloan,20,.339,59,7,.368,19,38,25,0,25,27,.346,78,20,.800,25,23,0,263,3,17,81,SG-PG,5,14,28,TOT,.391
383,Greg Smith,170,.623,273,0,.000,1,25,22,40,210,170,.620,274,81,.623,130,70,10,1110,111,175,421,C,18,41,321,HOU,.620
384,Ish Smith,48,.364,132,8,.296,27,87,24,9,49,56,.352,159,3,.429,7,52,3,516,12,26,123,PG,21,37,61,TOT,.377
385,J.R. Smith,372,.458,813,155,.356,436,218,27,24,361,527,.422,1249,237,.762,311,80,0,2678,64,226,1446,SG,100,134,425,NYK,.484
386,Jason Smith,167,.496,337,0,.000,4,34,26,45,122,167,.490,341,86,.843,102,51,0,876,64,123,420,C,15,55,186,NOH,.490
387,Josh Smith,489,.498,981,61,.303,201,321,27,136,506,550,.465,1182,166,.517,321,76,76,2683,133,175,1327,PF,94,226,639,ATL,.491
388,Nolan Smith,36,.419,86,6,.214,28,35,24,1,20,42,.368,114,20,.714,28,40,0,288,7,26,110,PG,7,29,27,POR,.395
389,Marreese Speights,257,.448,574,3,.300,10,47,25,53,240,260,.445,584,135,.771,175,79,3,1300,146,175,658,C,24,80,386,TOT,.448
390,Tiago Splitter,315,.561,561,0,.000,2,130,28,64,371,315,.560,563,208,.730,285,81,58,1997,144,161,838,PF,63,100,515,SAS,.560
391,Jerry Stackhouse,36,.434,83,30,.337,89,35,38,4,28,66,.384,172,20,.870,23,37,0,544,5,31,182,SF,7,24,33,BRK,.471
392,Lance Stephenson,213,.520,410,62,.330,188,223,22,16,257,275,.460,598,75,.652,115,78,72,2278,47,162,687,SG,81,109,304,IND,.512
393,DeShawn Stevenson,22,.415,53,76,.364,209,52,31,6,104,98,.374,262,12,.522,23,56,31,1158,18,69,284,SG,29,23,122,ATL,.519
394,Greg Stiemsma,127,.457,278,0,,0,30,27,90,200,127,.457,278,53,.768,69,76,19,1209,61,184,307,C,44,59,261,MIN,.457
395,Julyan Stone,2,1.000,2,0,,0,2,24,0,1,2,1.000,2,3,.750,4,4,0,28,2,4,7,PG,1,2,3,DEN,1.000
396,Amar'e Stoudemire,154,.577,267,0,,0,13,30,21,85,154,.577,267,105,.808,130,29,0,682,60,89,413,PF,10,50,145,NYK,.577
397,Rodney Stuckey,249,.440,566,55,.302,182,270,26,17,169,304,.406,748,213,.783,272,76,24,2171,43,127,876,SG,51,134,212,DET,.443
398,Jared Sullinger,110,.500,220,1,.200,5,35,20,22,172,111,.493,225,47,.746,63,45,5,892,92,154,270,PF,22,29,264,BOS,.496
399,DaJuan Summers,1,.250,4,0,,0,1,25,0,2,1,.250,4,0,,0,2,0,7,0,0,2,PF,0,0,2,LAC,.250
400,Jeffery Taylor,119,.486,245,53,.344,154,63,23,15,99,172,.431,399,75,.728,103,77,29,1507,51,136,472,SF,47,48,150,CHA,.497
401,Tyshawn Taylor,26,.351,74,6,.462,13,21,22,0,16,32,.368,87,15,.556,27,38,0,221,2,25,85,PG,13,25,18,BRK,.402
402,Jeff Teague,350,.482,726,89,.359,248,579,24,28,155,439,.451,974,199,.881,226,80,78,2628,25,181,1166,PG,117,230,180,ATL,.496
403,Marquis Teague,39,.433,90,4,.174,23,63,19,7,41,43,.381,113,9,.563,16,48,0,392,3,47,99,PG,9,35,44,CHI,.398
404,Mirza Teletovic,34,.442,77,37,.343,108,23,27,8,62,71,.384,185,9,.818,11,53,0,499,33,53,188,PF,13,20,95,BRK,.484
405,Sebastian Telfair,59,.371,159,53,.353,150,153,27,11,71,112,.362,309,54,.783,69,59,2,980,13,104,331,PG,37,64,84,TOT,.448
406,Garrett Temple,79,.444,178,26,.325,80,115,26,17,94,105,.407,258,26,.703,37,51,36,1156,29,94,262,SG,50,61,123,WAS,.457
407,Jason Terry,158,.498,317,123,.372,331,198,35,11,140,281,.434,648,114,.870,131,79,24,2124,19,110,799,SG,66,102,159,BOS,.529
408,Hasheem Thabeet,64,.604,106,0,,0,11,25,60,126,64,.604,106,32,.604,53,66,4,770,69,148,160,C,30,41,195,OKC,.604
409,Isaiah Thomas,251,.491,511,115,.358,321,316,23,3,132,366,.440,832,253,.882,287,79,62,2122,29,167,1100,PG,67,140,161,SAC,.509
410,Kurt Thomas,44,.537,82,1,1.000,1,21,40,16,65,45,.542,83,6,.462,13,39,17,392,24,52,97,PF,10,8,89,NYK,.548
411,Lance Thomas,53,.500,106,0,,0,17,24,7,71,53,.500,106,43,.729,59,59,9,646,44,78,149,SF,11,14,115,NOH,.500
412,Malcolm Thomas,5,.500,10,0,,0,4,24,2,11,5,.500,10,5,.625,8,12,0,57,5,8,15,PF,2,3,16,TOT,.500
413,Tyrus Thomas,45,.352,128,3,.375,8,19,26,15,44,48,.353,136,26,.839,31,26,2,360,16,51,125,PF,14,17,60,CHA,.364
414,Jason Thompson,374,.504,742,0,.000,3,84,26,61,377,374,.502,745,143,.694,206,82,81,2285,172,227,891,PF,48,101,549,SAC,.502
415,Klay Thompson,297,.437,679,211,.401,526,183,22,45,274,508,.422,1205,132,.841,157,82,82,2936,32,237,1359,SG,86,157,306,GSW,.509
416,Tristan Thompson,390,.490,796,0,.000,3,108,21,71,467,390,.488,799,177,.608,291,82,82,2564,306,234,957,PF,60,123,773,CLE,.488
417,Marcus Thornton,191,.484,395,141,.372,379,91,25,4,131,332,.429,774,111,.881,126,72,8,1726,50,105,916,SG,61,68,181,SAC,.520
418,Jamaal Tinsley,47,.439,107,39,.307,127,290,34,14,98,86,.368,234,18,.692,26,66,32,1221,17,106,229,PG,64,106,115,UTA,.451
419,Anthony Tolliver,37,.446,83,45,.338,133,32,27,12,124,82,.380,216,44,.863,51,62,11,963,31,66,253,SF,15,36,155,ATL,.484
420,P.J. Tucker,188,.503,374,22,.314,70,109,27,19,218,210,.473,444,64,.744,86,79,45,1910,132,145,506,SG,62,67,350,PHO,.498
421,Ronny Turiaf,49,.505,97,0,,0,35,30,35,107,49,.505,97,23,.365,63,65,0,701,45,80,121,C,19,29,152,LAC,.505
422,Hedo Turkoglu,13,.448,29,1,.042,24,23,33,1,22,14,.264,53,3,.500,6,11,1,189,4,11,32,SF,7,12,26,ORL,.274
423,Evan Turner,383,.428,894,58,.365,159,354,24,17,461,441,.419,1053,154,.740,208,82,82,2892,56,197,1094,SF,71,187,517,PHI,.446
424,Jeremy Tyler,9,.375,24,0,,0,1,21,2,14,9,.375,24,4,.667,6,21,0,68,6,10,22,C,1,6,20,TOT,.375
425,Ekpe Udoh,117,.437,268,0,.000,1,43,25,85,138,117,.435,269,89,.748,119,76,9,1312,113,139,323,C,39,43,251,MIL,.435
426,Beno Udrih,176,.471,374,34,.333,102,302,30,3,107,210,.441,476,84,.816,103,66,9,1457,34,90,538,SG-PG,41,108,141,TOT,.477
427,Jonas Valanciunas,204,.557,366,0,,0,45,20,78,251,204,.557,366,146,.789,185,62,57,1482,121,188,554,C,17,94,372,TOR,.557
428,Anderson Varejao,138,.486,284,0,.000,5,84,30,14,223,138,.478,289,77,.755,102,25,25,901,138,68,353,C,37,44,361,CLE,.478
429,Jarvis Varnado,3,.429,7,0,,0,3,24,2,7,3,.429,7,2,.500,4,13,0,58,2,10,8,PF,1,6,9,TOT,.429
430,Greivis Vasquez,355,.462,769,83,.342,243,704,26,6,294,438,.433,1012,124,.805,154,78,78,2685,43,190,1083,PG,66,247,337,NOH,.474
431,Jan Vesely,57,.504,113,0,.000,1,28,22,17,79,57,.500,114,12,.308,39,51,4,601,43,107,126,PF,15,27,122,WAS,.500
432,Charlie Villanueva,85,.415,205,90,.347,259,54,28,39,192,175,.377,464,27,.551,49,69,0,1092,49,96,467,PF,31,39,241,DET,.474
433,Nikola Vucevic,461,.520,886,0,.000,3,143,22,79,644,461,.519,889,86,.683,126,77,77,2559,273,218,1008,C,61,141,917,ORL,.519
434,Dwyane Wade,552,.537,1027,17,.258,66,352,31,56,258,569,.521,1093,308,.725,425,69,69,2391,86,140,1463,SG,128,194,344,MIA,.528
435,Dion Waiters,273,.446,612,63,.310,203,183,21,16,127,336,.412,815,159,.746,213,61,48,1756,22,113,894,SG,59,121,149,CLE,.451
436,Kemba Walker,419,.459,912,107,.322,332,471,22,31,223,526,.423,1244,296,.798,371,82,82,2859,60,153,1455,PG,160,200,283,CHA,.466
437,John Wall,312,.452,690,12,.267,45,373,22,37,161,324,.441,735,246,.804,306,49,42,1602,35,117,906,PG,65,157,196,WAS,.449
438,Gerald Wallace,136,.461,295,46,.282,163,181,30,46,250,182,.397,458,121,.637,190,69,68,2076,69,118,531,SF,97,110,319,BRK,.448
439,Rasheed Wallace,33,.452,73,22,.319,69,6,38,15,72,55,.387,142,14,.700,20,21,0,296,11,40,146,C,13,10,83,NYK,.465
440,Luke Walton,51,.447,114,20,.299,67,166,32,13,107,71,.392,181,10,.500,20,50,0,857,38,98,172,PF,42,60,145,CLE,.448
441,Hakim Warrick,67,.414,162,0,.000,3,25,30,6,68,67,.406,165,60,.682,88,28,14,489,21,37,194,PF,13,29,89,TOT,.406
442,C.J. Watson,104,.424,245,88,.411,214,161,28,12,107,192,.418,459,71,.780,91,80,8,1521,38,123,543,PG,66,69,145,BRK,.514
443,Earl Watson,32,.348,92,5,.179,28,190,33,8,64,37,.308,120,17,.680,25,48,4,829,23,94,96,PG,40,69,87,UTA,.329
444,Maalik Wayns,19,.333,57,7,.226,31,27,21,0,6,26,.295,88,17,.895,19,27,1,202,1,26,76,PG,6,15,7,TOT,.335
445,Martell Webster,142,.463,307,139,.422,329,143,26,17,241,281,.442,636,168,.848,198,76,62,2200,53,166,869,SF,49,90,294,WAS,.551
446,David West,498,.503,990,4,.211,19,213,32,69,418,502,.498,1009,242,.768,315,73,73,2435,145,149,1250,PF,74,157,563,IND,.500
447,Russell Westbrook,576,.466,1235,97,.323,300,607,24,24,317,673,.438,1535,460,.800,575,82,82,2861,111,189,1903,PG,145,273,428,OKC,.470
448,D.J. White,12,.522,23,0,,0,4,26,6,9,12,.522,23,5,.556,9,12,0,86,4,5,29,PF,1,2,13,BOS,.522
449,James White,36,.480,75,14,.341,41,29,30,4,43,50,.431,116,11,.579,19,57,16,435,5,44,125,SF,13,17,48,NYK,.491
450,Chris Wilcox,110,.724,152,0,.000,1,22,30,28,125,110,.719,153,39,.672,58,61,7,830,55,125,259,C,32,34,180,BOS,.719
451,Damien Wilkins,128,.483,265,17,.333,51,91,33,18,73,145,.459,316,81,.743,109,61,21,1095,32,98,388,SG,37,49,105,PHI,.486
452,Deron Williams,326,.482,677,169,.378,447,604,28,30,203,495,.440,1124,317,.859,369,78,78,2842,29,194,1476,PG,75,218,232,BRK,.516
453,Derrick Williams,273,.463,590,65,.332,196,46,21,37,334,338,.430,786,192,.706,272,78,56,1916,96,127,933,PF,44,101,430,MIN,.471
454,Lou Williams,115,.466,247,72,.367,196,139,26,10,72,187,.422,443,105,.868,121,39,9,1119,8,55,551,SG,44,74,80,ATL,.503
455,Marvin Williams,145,.477,304,54,.325,166,77,26,38,208,199,.423,470,77,.778,99,73,51,1727,55,98,529,SF,37,60,263,UTA,.481
456,Mo Williams,170,.449,379,59,.383,154,285,30,9,86,229,.430,533,75,.882,85,46,46,1418,24,105,592,PG,46,125,110,UTA,.485
457,Reggie Williams,35,.583,60,22,.306,72,39,26,1,43,57,.432,132,10,.476,21,40,0,380,8,19,146,SF,12,19,51,CHA,.515
458,Terrence Williams,43,.524,82,5,.333,15,38,25,2,40,48,.495,97,9,.429,21,24,0,318,4,13,110,SF,11,22,44,BOS,.521
459,Metta World Peace,191,.464,412,141,.342,412,112,33,42,271,332,.403,824,124,.734,169,75,66,2530,101,198,929,SF,122,98,372,LAL,.488
460,Brandan Wright,241,.601,401,0,.000,3,38,25,76,175,241,.597,404,59,.615,96,64,16,1149,85,78,541,C,26,34,260,DAL,.597
461,Chris Wright,1,.500,2,0,,0,0,23,0,0,1,.500,2,0,,0,3,0,4,0,0,2,SG,0,1,0,DAL,.500
462,Dorell Wright,102,.429,238,135,.374,361,150,27,35,260,237,.396,599,120,.851,141,79,8,1783,42,98,729,SF,62,64,302,PHI,.508
463,Tony Wroten,29,.414,70,4,.250,16,43,19,4,15,33,.384,86,21,.724,29,35,0,272,13,34,91,SG,8,29,28,MEM,.407
464,Nick Young,149,.449,332,75,.357,210,84,27,14,106,224,.413,542,105,.820,128,59,17,1411,24,84,628,SG,36,50,130,PHI,.482
465,Sam Young,42,.438,96,16,.308,52,42,27,8,97,58,.392,148,23,.535,43,56,3,693,26,62,155,SG,15,33,123,IND,.446
466,Thaddeus Young,508,.535,950,1,.125,8,125,24,55,389,509,.531,958,108,.574,188,76,76,2629,182,191,1127,PF,133,90,571,PHI,.532
467,Luke Zeller,8,.381,21,1,.200,5,3,25,0,9,9,.346,26,0,,0,16,0,58,1,5,19,C,0,0,10,PHO,.365
468,Tyler Zeller,245,.441,555,0,.000,4,96,23,70,279,245,.438,559,120,.764,157,77,55,2033,159,251,610,C,35,95,438,CLE,.438
