,Player_Name,2P,2P%,2PA,3P,3P%,3PA,AST,Age,BLK,DRB,FG,FG%,FGA,FT,FT%,FTA,Games,Games_Strated,Minutes_Played,ORB,PF,PTS,Position,STL,TOV,TRB,Team,eFG%
0,Quincy Acy,62,.492,126,4,.267,15,28,23,26,144,66,.468,141,35,.660,53,63,0,847,72,122,171,SF,23,30,216,TOT,.482
1,Steven Adams,93,.503,185,0,,0,43,20,57,190,93,.503,185,79,.581,136,81,20,1197,142,203,265,C,40,71,332,OKC,.503
2,Jeff Adrien,143,.520,275,0,,0,38,27,36,204,143,.520,275,76,.639,119,53,12,961,102,108,362,PF,24,39,306,TOT,.520
3,Arron Afflalo,336,.473,711,128,.427,300,248,28,3,230,464,.459,1011,274,.815,336,73,73,2552,32,136,1330,SG,35,146,262,ORL,.522
4,Alexis Ajinca,136,.548,248,0,.000,1,40,25,46,183,136,.546,249,56,.836,67,56,30,951,94,187,328,C,23,63,277,NOP,.546
5,Cole Aldrich,33,.541,61,0,,0,14,25,30,92,33,.541,61,26,.867,30,46,2,330,37,40,92,C,8,18,129,NYK,.541
6,LaMarcus Aldridge,649,.461,1408,3,.200,15,178,28,68,599,652,.458,1423,296,.822,360,69,69,2498,166,147,1603,PF,63,123,765,POR,.459
7,Lavoy Allen,132,.460,287,2,.154,13,71,24,33,192,134,.447,300,33,.660,50,65,2,1072,119,126,303,PF,24,44,311,TOT,.450
8,Ray Allen,124,.530,234,116,.375,309,143,38,8,182,240,.442,543,105,.905,116,73,9,1936,23,115,701,SG,54,84,205,MIA,.549
9,Tony Allen,193,.527,366,11,.234,47,94,32,19,129,204,.494,413,76,.628,121,55,28,1278,79,121,495,SG,90,90,208,MEM,.507
10,Al-Farouq Aminu,221,.496,446,13,.271,48,114,23,38,367,234,.474,494,91,.664,137,80,65,2045,129,147,572,SF,82,88,496,NOP,.487
11,Lou Amundson,16,.500,32,0,,0,6,31,11,27,16,.500,32,6,.250,24,19,0,185,28,49,38,PF,9,14,55,TOT,.500
12,Chris Andersen,174,.662,263,3,.250,12,19,35,97,250,177,.644,275,120,.710,169,72,0,1396,129,162,477,C,32,53,379,MIA,.649
13,Alan Anderson,110,.464,237,84,.339,248,81,31,11,135,194,.400,485,92,.780,118,78,26,1773,40,147,564,SF,48,62,175,BRK,.487
14,James Anderson,194,.530,366,115,.328,351,149,24,28,241,309,.431,717,77,.726,106,80,62,2309,59,154,810,SG,74,106,300,PHI,.511
15,Ryan Anderson,88,.463,190,67,.409,164,17,25,7,76,155,.438,354,59,.952,62,22,14,795,66,47,436,PF,10,20,142,NOP,.532
16,Giannis Antetokounmpo,132,.440,300,41,.347,118,150,19,61,261,173,.414,418,138,.683,202,77,23,1897,78,173,525,SF,60,122,339,MIL,.463
17,Carmelo Anthony,576,.469,1228,167,.402,415,242,29,51,477,743,.452,1643,459,.848,541,77,77,2982,145,224,2112,PF,95,198,622,NYK,.503
18,Joel Anthony,12,.375,32,0,,0,2,31,12,23,12,.375,32,4,.500,8,33,0,186,15,17,28,C,3,3,38,TOT,.375
19,Pero Antic,67,.545,123,56,.327,171,58,31,12,152,123,.418,294,50,.758,66,50,26,925,57,126,352,C,19,55,209,ATL,.514
20,Trevor Ariza,209,.509,411,180,.407,442,191,28,20,376,389,.456,853,149,.772,193,77,77,2723,99,179,1107,SF,126,132,475,WAS,.562
21,Hilton Armstrong,9,.474,19,0,,0,5,29,4,28,9,.474,19,7,.438,16,15,1,97,19,11,25,C,4,6,47,GSW,.474
22,Darrell Arthur,138,.399,346,24,.375,64,61,25,47,158,162,.395,410,53,.855,62,68,1,1161,52,185,401,SF,39,58,210,DEN,.424
23,Omer Asik,101,.532,190,0,,0,25,27,37,277,101,.532,190,78,.619,126,48,19,968,101,92,280,C,14,59,378,HOU,.532
24,D.J. Augustin,165,.427,386,133,.401,332,313,26,3,115,298,.415,718,201,.885,227,71,9,1939,15,147,930,PG,53,125,130,TOT,.508
25,Gustavo Ayon,52,.510,102,0,,0,28,28,10,83,52,.510,102,8,.400,20,26,14,429,42,47,112,C,25,29,125,ATL,.510
26,Jeff Ayres,101,.580,174,0,,0,60,26,25,169,101,.580,174,38,.691,55,73,10,952,89,146,240,PF,13,63,258,SAS,.580
27,Chris Babb,2,.667,3,6,.222,27,3,23,0,13,8,.267,30,0,,0,14,0,132,4,13,22,SG,6,3,17,BOS,.367
28,Luke Babbitt,24,.407,59,36,.379,95,29,24,11,70,60,.390,154,14,.778,18,27,2,473,18,52,170,PF,7,15,88,NOP,.506
29,Leandro Barbosa,49,.462,106,7,.280,25,32,31,4,32,56,.427,131,31,.795,39,20,0,368,5,30,150,PG,7,19,37,PHO,.454
30,J.J. Barea,181,.426,425,73,.316,231,303,29,0,138,254,.387,656,79,.790,100,79,1,1471,16,129,660,PG,26,125,154,MIN,.443
31,Andrea Bargnani,192,.487,394,30,.278,108,45,28,52,153,222,.442,502,84,.824,102,42,39,1257,69,100,558,C,14,58,222,NYK,.472
32,Harrison Barnes,205,.419,489,66,.347,190,116,21,20,245,271,.399,679,130,.718,181,78,24,2204,66,158,738,SF,65,84,311,GSW,.448
33,Matt Barnes,134,.549,244,97,.343,283,125,33,28,232,231,.438,527,66,.733,90,63,40,1735,60,185,625,SF,56,85,292,LAC,.530
34,Will Barton,55,.447,123,10,.303,33,33,23,7,58,65,.417,156,26,.813,32,41,0,387,16,31,166,SG,9,18,74,POR,.449
35,Brandon Bass,350,.487,719,2,.333,6,87,28,71,309,352,.486,725,205,.858,239,82,73,2266,161,190,911,PF,36,102,470,BOS,.487
36,Shane Battier,32,.492,65,73,.348,210,63,35,39,104,105,.382,275,15,.652,23,73,56,1468,34,124,298,SF,50,21,138,MIA,.515
37,Nicolas Batum,236,.566,417,145,.361,402,420,25,57,495,381,.465,819,163,.803,203,82,82,2956,116,156,1070,SF,75,208,611,POR,.554
38,Jerryd Bayless,172,.425,405,76,.358,212,194,25,9,123,248,.402,617,94,.797,118,72,19,1686,22,161,666,PG,60,82,145,TOT,.464
39,Aron Baynes,71,.436,163,0,,0,34,27,5,88,71,.436,163,19,.905,21,53,4,491,57,77,161,C,2,36,145,SAS,.436
40,Kent Bazemore,104,.484,215,43,.336,128,91,24,13,107,147,.429,343,66,.606,109,67,15,911,10,102,403,SG,43,79,117,TOT,.491
41,Bradley Beal,343,.426,806,138,.402,343,243,20,18,219,481,.419,1149,149,.788,189,73,73,2530,54,153,1249,SG,71,128,273,WAS,.479
42,Michael Beasley,156,.518,301,21,.389,54,42,25,21,141,177,.499,355,61,.772,79,55,2,831,31,93,436,SF,23,57,172,MIA,.528
43,Marco Belinelli,211,.525,402,126,.430,293,179,27,7,208,337,.485,695,111,.847,131,80,25,2016,18,130,911,SF,50,95,226,SAS,.576
44,Anthony Bennett,67,.390,172,13,.245,53,17,20,8,106,80,.356,225,44,.638,69,52,0,663,49,93,217,PF,21,47,155,CLE,.384
45,Patrick Beverley,107,.473,226,92,.361,255,151,25,23,124,199,.414,481,83,.814,102,56,55,1751,72,174,573,PG,77,66,196,HOU,.509
46,Andris Biedrins,1,1.000,1,0,,0,0,27,0,15,1,1.000,1,1,.167,6,6,0,45,2,6,3,C,0,2,17,UTA,1.000
47,Chauncey Billups,10,.323,31,14,.292,48,42,37,1,24,24,.304,79,10,.833,12,19,7,309,4,25,72,SG,8,25,28,DET,.392
48,Bismack Biyombo,88,.611,144,0,,0,8,21,86,261,88,.611,144,46,.517,89,77,9,1072,105,124,222,C,7,40,366,CHA,.611
49,DeJuan Blair,210,.537,391,0,.000,2,70,24,21,229,210,.534,393,77,.636,121,78,13,1214,139,192,497,PF,60,77,368,DAL,.534
50,Steve Blake,54,.378,143,79,.376,210,307,33,8,146,133,.377,353,33,.767,43,55,28,1498,13,85,378,PG,54,102,159,TOT,.489
51,Andray Blatche,306,.494,620,15,.278,54,112,27,38,270,321,.476,674,164,.742,221,73,7,1618,120,166,821,PF,75,110,390,BRK,.487
52,Eric Bledsoe,215,.517,416,50,.357,140,235,24,14,175,265,.477,556,183,.772,237,43,40,1416,27,99,763,PG,69,143,202,PHO,.522
53,Vander Blue,2,.667,3,0,.000,1,1,21,0,3,2,.500,4,1,.200,5,3,0,15,0,1,5,SG,0,2,3,BOS,.500
54,Keith Bogans,0,,0,3,.500,6,3,33,0,3,3,.500,6,3,1.000,3,6,0,55,0,2,12,SG,1,1,3,BOS,.750
55,Andrew Bogut,235,.627,375,0,,0,112,29,121,489,235,.627,375,22,.344,64,67,67,1769,182,210,492,C,47,97,671,GSW,.627
56,Matt Bonner,31,.470,66,42,.429,98,31,33,11,114,73,.445,164,9,.750,12,61,0,690,16,49,197,PF,15,16,130,SAS,.573
57,Trevor Booker,222,.554,401,0,.000,2,64,26,45,230,222,.551,403,47,.618,76,72,45,1553,149,131,491,PF,41,58,379,WAS,.551
58,Carlos Boozer,447,.457,978,0,.000,2,118,32,22,495,447,.456,980,148,.767,193,76,76,2141,137,216,1042,PF,53,154,632,CHI,.456
59,Chris Bosh,418,.569,735,74,.339,218,87,29,78,424,492,.516,953,223,.820,272,79,79,2531,98,192,1281,C,80,125,522,MIA,.555
60,Avery Bradley,282,.451,625,79,.395,200,85,23,11,178,361,.438,825,90,.804,112,60,58,1855,48,145,891,SG,63,96,226,BOS,.485
61,Elton Brand,179,.542,330,0,.000,2,74,34,88,264,179,.539,332,61,.649,94,73,15,1414,97,192,419,C,40,60,361,ATL,.539
62,Corey Brewer,329,.552,596,59,.280,211,135,27,30,144,388,.481,807,163,.718,227,81,81,2609,63,210,998,SF,151,105,207,MIN,.517
63,Ronnie Brewer,2,.286,7,1,.125,8,10,28,1,12,3,.200,15,0,.000,2,24,3,160,2,4,7,SF,6,2,14,TOT,.233
64,Aaron Brooks,137,.411,333,96,.387,248,233,29,13,97,233,.401,581,83,.874,95,72,12,1557,43,146,645,PG,52,117,140,TOT,.484
65,MarShon Brooks,44,.440,100,13,.520,25,25,25,4,44,57,.456,125,32,.727,44,35,0,316,10,21,159,SG,14,24,54,TOT,.508
66,Lorenzo Brown,23,.411,56,3,.100,30,41,23,3,20,26,.302,86,9,.692,13,26,0,224,8,19,64,PG,13,16,28,PHI,.320
67,Shannon Brown,24,.375,64,0,.000,2,9,28,0,21,24,.364,66,15,.714,21,29,1,251,7,24,63,SG,13,18,28,TOT,.364
68,Kobe Bryant,28,.491,57,3,.188,16,38,35,1,24,31,.425,73,18,.857,21,6,6,177,2,9,83,SG,7,34,26,LAL,.445
69,Chase Budinger,58,.433,134,42,.350,120,31,25,2,84,100,.394,254,32,.821,39,41,8,751,19,58,274,SF,19,24,103,MIN,.476
70,Reggie Bullock,21,.438,48,22,.301,73,12,22,1,43,43,.355,121,7,.778,9,43,0,395,11,26,115,SF,9,13,54,LAC,.446
71,Trey Burke,230,.410,561,111,.330,336,396,21,6,171,341,.380,897,102,.903,113,70,68,2262,37,145,895,PG,42,131,208,UTA,.442
72,Alec Burks,330,.480,688,50,.350,143,212,22,14,198,380,.457,831,279,.748,373,78,12,2193,59,190,1089,SG,69,149,257,UTA,.487
73,Caron Butler,115,.395,291,98,.394,249,82,33,17,208,213,.394,540,63,.840,75,56,13,1419,21,120,587,SF,47,60,229,TOT,.485
74,Jimmy Butler,207,.457,453,68,.283,240,175,24,36,243,275,.397,693,260,.769,338,67,67,2591,87,106,878,SG,127,102,330,CHI,.446
75,Rasual Butler,25,.521,48,26,.419,62,17,34,9,35,51,.464,110,8,.571,14,50,2,378,6,30,136,SG,7,11,41,IND,.582
76,Dwight Buycks,10,.323,31,5,.294,17,10,24,0,19,15,.313,48,8,.889,9,14,0,146,4,11,43,PG,8,10,23,TOR,.365
77,Andrew Bynum,94,.418,225,0,,0,29,26,29,92,94,.418,225,37,.755,49,26,19,516,53,31,225,C,6,34,145,TOT,.418
78,Will Bynum,164,.446,368,20,.323,62,216,31,7,75,184,.428,430,97,.802,121,56,3,1054,24,121,485,PG,39,103,99,DET,.451
79,Nick Calathes,123,.492,250,19,.311,61,207,24,8,114,142,.457,311,44,.611,72,71,7,1173,23,117,347,SG,66,101,137,MEM,.487
80,Jose Calderon,150,.464,323,191,.449,425,377,32,11,163,341,.456,748,52,.825,63,81,81,2468,29,136,925,PG,69,103,192,DAL,.584
81,Kentavious Caldwell-Pope,123,.447,275,59,.319,185,55,20,12,118,182,.396,460,47,.770,61,80,41,1583,38,145,470,SG,75,28,156,DET,.460
82,Isaiah Canaan,13,.406,32,18,.327,55,22,22,4,17,31,.356,87,21,.724,29,22,0,252,7,25,101,PG,8,21,24,HOU,.460
83,DeMarre Carroll,205,.548,374,97,.362,268,134,27,21,296,302,.470,642,109,.773,141,73,73,2341,107,188,810,SF,108,79,403,ATL,.546
84,Vince Carter,184,.418,440,146,.394,371,212,37,35,217,330,.407,811,161,.821,196,81,0,1973,67,209,967,SG,61,108,284,DAL,.497
85,Michael Carter-Williams,372,.440,846,55,.264,208,441,22,43,336,427,.405,1054,258,.703,367,70,70,2414,101,213,1167,PG,130,247,437,PHI,.431
86,Omri Casspi,112,.479,234,61,.347,176,88,25,14,205,173,.422,410,83,.680,122,71,2,1283,55,100,490,PF,44,72,260,HOU,.496
87,Mario Chalmers,167,.500,334,87,.385,226,357,27,16,173,254,.454,560,121,.742,163,73,73,2178,41,210,716,PG,119,162,214,MIA,.531
88,Tyson Chandler,191,.595,321,0,.000,1,59,31,63,370,191,.593,322,98,.632,155,55,55,1662,159,145,480,C,36,71,529,NYK,.593
89,Wilson Chandler,185,.478,387,122,.348,351,114,26,31,236,307,.416,738,110,.724,152,62,55,1927,58,193,846,SF,46,79,294,DEN,.499
90,Josh Childress,0,,0,0,,0,2,30,0,3,0,,0,0,,0,4,0,24,0,1,0,SF,1,1,3,NOP,
91,Dionte Christmas,13,.419,31,9,.290,31,8,27,3,25,22,.355,62,18,.750,24,31,0,198,13,19,71,SF,2,6,38,PHO,.427
92,Earl Clark,56,.403,139,41,.336,122,18,26,25,121,97,.372,261,22,.647,34,54,17,768,22,67,257,PF,17,31,143,TOT,.450
93,Ian Clark,15,.417,36,11,.355,31,15,22,2,16,26,.388,67,5,.714,7,23,0,172,3,24,68,SG,8,14,19,UTA,.470
94,Victor Claver,14,.583,24,3,.167,18,12,25,3,30,17,.405,42,10,.909,11,21,0,184,9,16,47,SF,3,11,39,POR,.440
95,Norris Cole,147,.451,326,60,.345,174,248,25,5,143,207,.414,500,53,.779,68,82,6,2014,17,156,527,PG,77,127,160,MIA,.474
96,Jason Collins,11,.524,21,0,.000,3,4,35,1,12,11,.458,24,3,.750,4,22,1,172,7,30,25,C,8,7,19,BRK,.458
97,Darren Collison,253,.501,505,71,.376,189,297,26,15,141,324,.467,694,192,.857,224,80,35,2069,47,150,911,PG,93,132,188,LAC,.518
98,Nick Collison,130,.580,224,4,.235,17,104,33,28,177,134,.556,241,66,.710,93,81,0,1353,116,187,338,PF,30,71,293,OKC,.564
99,Mike Conley,358,.484,739,105,.361,291,441,26,13,172,463,.450,1030,225,.815,276,73,73,2446,41,141,1256,PG,110,150,213,MEM,.500
100,Chris Copeland,22,.579,38,33,.418,79,18,29,7,25,55,.470,117,10,.714,14,41,0,265,7,38,153,SF,3,14,32,IND,.611
101,DeMarcus Cousins,591,.499,1184,0,.000,7,207,23,91,613,591,.496,1191,432,.726,595,71,71,2298,218,270,1614,C,109,251,831,SAC,.496
102,Robert Covington,2,.667,3,4,.364,11,0,23,0,3,6,.429,14,0,,0,7,0,34,2,3,16,SF,2,1,5,HOU,.571
103,Allen Crabbe,6,.316,19,6,.429,14,6,21,1,8,12,.364,33,3,.750,4,15,0,100,1,10,33,SG,2,3,9,POR,.455
104,Jamal Crawford,260,.460,565,161,.361,446,223,33,12,124,421,.416,1011,279,.866,322,69,24,2094,34,120,1282,SG,59,135,158,LAC,.496
105,Jordan Crawford,237,.471,503,90,.316,285,281,25,5,155,327,.415,788,146,.864,169,81,35,1859,28,120,890,SG-PG,47,134,183,TOT,.472
106,Jae Crowder,80,.552,145,50,.331,151,60,23,21,148,130,.439,296,46,.754,61,78,8,1254,46,100,356,SF,59,41,194,DAL,.524
107,Dante Cunningham,236,.468,504,0,.000,5,83,26,58,218,236,.464,509,38,.567,67,81,7,1635,112,146,510,PF,62,42,330,MIN,.464
108,Jared Cunningham,5,.357,14,1,.143,7,8,22,0,5,6,.286,21,13,.813,16,13,0,80,1,16,26,SG,3,2,6,TOT,.310
109,Seth Curry,0,.000,2,1,1.000,1,0,23,0,1,1,.333,3,0,,0,2,0,13,0,0,3,PG,2,0,1,TOT,.500
110,Stephen Curry,391,.509,768,261,.424,615,666,25,14,288,652,.471,1383,308,.885,348,78,78,2846,46,194,1873,PG,128,294,334,GSW,.566
111,Samuel Dalembert,214,.569,376,0,.000,1,38,32,94,341,214,.568,377,101,.737,137,80,68,1614,200,210,529,C,41,90,541,DAL,.568
112,Troy Daniels,3,.500,6,12,.480,25,5,22,0,4,15,.484,31,0,,0,5,1,75,0,6,42,SG,0,3,4,HOU,.677
113,Luigi Datome,27,.466,58,7,.179,39,11,26,1,32,34,.351,97,8,.800,10,34,0,238,14,20,83,SF,6,11,46,DET,.387
114,Brandon Davies,52,.441,118,2,.200,10,28,22,8,71,54,.422,128,34,.642,53,51,0,575,38,92,144,PF,24,35,109,PHI,.430
115,Anthony Davis,520,.522,996,2,.222,9,105,20,189,466,522,.519,1005,348,.791,440,67,66,2358,207,200,1394,PF,89,109,673,NOP,.520
116,Ed Davis,155,.534,290,0,,0,27,24,43,168,155,.534,290,47,.528,89,63,4,956,92,114,357,PF,17,40,260,MEM,.534
117,Glen Davis,267,.459,582,4,.364,11,77,28,29,243,271,.457,593,95,.693,137,68,44,1662,108,159,641,PF,58,76,351,TOT,.460
118,Austin Daye,12,.387,31,12,.324,37,8,25,4,22,24,.353,68,6,.600,10,22,1,148,5,18,66,SF,4,5,27,TOT,.441
119,Nando De Colo,46,.460,100,18,.340,53,65,26,6,59,64,.418,153,31,.886,35,47,3,494,14,48,177,SF,22,35,73,TOT,.477
120,Dewayne Dedmon,38,.458,83,0,,0,5,24,22,89,38,.458,83,21,.656,32,31,6,390,38,66,97,C,7,18,127,TOT,.458
121,Matthew Dellavedova,65,.461,141,57,.368,155,187,23,5,94,122,.412,296,38,.792,48,72,4,1271,29,121,339,SG,33,60,123,CLE,.508
122,Luol Deng,314,.468,671,57,.302,189,183,28,9,262,371,.431,860,212,.791,268,63,63,2213,99,111,1011,SF,62,114,361,TOT,.465
123,DeMar DeRozan,540,.451,1197,64,.305,210,313,24,28,292,604,.429,1407,519,.824,630,79,79,3017,51,197,1791,SG,86,176,343,TOR,.452
124,Boris Diaw,257,.549,468,45,.402,112,222,31,32,252,302,.521,580,68,.739,92,79,24,1974,74,140,717,PF,44,121,326,SAS,.559
125,Gorgui Dieng,112,.496,226,1,1.000,1,39,24,50,197,113,.498,227,59,.634,93,60,15,818,103,108,286,C,30,54,300,MIN,.500
126,Toney Douglas,42,.477,88,31,.304,102,68,27,5,69,73,.384,190,25,.735,34,51,17,675,18,81,202,PG,19,34,87,TOT,.466
127,Chris Douglas-Roberts,60,.500,120,51,.386,132,51,27,16,103,111,.440,252,66,.805,82,49,8,1016,16,61,339,SF,29,36,119,CHA,.542
128,Goran Dragic,430,.542,794,122,.408,299,447,27,22,176,552,.505,1093,316,.760,416,76,75,2668,69,206,1542,SG,104,213,245,PHO,.561
129,Andre Drummond,479,.625,767,0,.000,2,35,20,131,631,479,.623,769,137,.418,328,81,81,2619,440,273,1095,C,101,110,1071,DET,.623
130,Jared Dudley,115,.518,222,81,.360,225,104,28,10,124,196,.438,447,38,.655,58,74,43,1729,36,146,511,SF,41,56,160,LAC,.529
131,Tim Duncan,444,.493,901,0,.000,5,220,37,139,563,444,.490,906,231,.731,316,74,74,2158,158,134,1119,C,43,159,721,SAS,.490
132,Mike Dunleavy,210,.467,450,123,.380,324,186,33,46,299,333,.430,774,140,.854,164,82,61,2584,46,163,929,SF,64,108,345,CHI,.510
133,Kevin Durant,657,.549,1197,192,.391,491,445,25,59,540,849,.503,1688,703,.873,805,81,81,3122,58,174,2593,SF,103,285,598,OKC,.560
134,Shane Edwards,1,.333,3,0,,0,0,26,0,1,1,.333,3,0,,0,2,0,12,1,1,2,SF,0,1,2,CLE,.333
135,Wayne Ellington,30,.448,67,25,.424,59,19,26,2,35,55,.437,126,10,.909,11,45,1,393,8,33,145,SG,16,11,43,DAL,.536
136,Monta Ellis,507,.474,1069,69,.330,209,471,28,23,257,576,.451,1278,339,.788,430,82,82,3023,38,197,1560,SG,141,264,295,DAL,.478
137,Melvin Ely,3,.500,6,0,,0,0,35,1,1,3,.500,6,0,,0,2,0,27,0,5,6,C,0,0,1,NOP,.500
138,Jeremy Evans,175,.530,330,0,.000,2,44,26,46,190,175,.527,332,51,.680,75,66,4,1209,120,139,401,SF,42,40,310,UTA,.527
139,Reggie Evans,71,.473,150,0,,0,21,33,3,219,71,.473,150,72,.554,130,54,20,899,115,119,214,PF,37,58,334,TOT,.473
140,Tyreke Evans,370,.461,802,21,.221,95,363,24,21,265,391,.436,897,239,.771,310,72,22,2028,76,155,1042,SF,84,175,341,NOP,.448
141,Kenneth Faried,447,.547,817,0,.000,3,96,24,69,446,447,.545,820,202,.650,311,80,77,2178,238,193,1096,PF,70,135,684,DEN,.545
142,Jordan Farmar,81,.397,204,70,.438,160,199,27,8,84,151,.415,364,44,.746,59,41,5,912,20,65,416,PG,38,95,104,LAL,.511
143,Vitor Faverani,52,.486,107,12,.300,40,16,25,27,86,64,.435,147,24,.649,37,37,8,488,42,74,164,C,14,41,128,BOS,.476
144,Derrick Favors,390,.523,746,0,.000,1,91,22,108,438,390,.522,747,190,.669,284,73,73,2201,199,236,970,PF,75,129,637,UTA,.522
145,Carrick Felix,5,.556,9,2,.400,5,4,23,0,5,7,.500,14,3,.750,4,7,0,38,1,4,19,SG,0,4,6,CLE,.571
146,Raymond Felton,178,.431,413,62,.318,195,365,29,27,143,240,.395,608,88,.721,122,65,65,2017,54,157,630,PG,78,129,197,NYK,.446
147,Landry Fields,27,.435,62,0,.000,5,20,25,3,44,27,.403,67,14,.636,22,30,2,322,15,25,68,SF,10,11,59,TOR,.403
148,Derek Fisher,53,.402,132,88,.384,229,117,39,3,110,141,.391,361,55,.775,71,81,0,1428,12,157,425,SG,70,49,122,OKC,.512
149,Evan Fournier,139,.453,307,89,.376,237,112,21,7,168,228,.419,544,93,.756,123,76,4,1503,34,179,638,SG,34,100,202,DEN,.501
150,Randy Foye,172,.456,377,189,.380,498,287,30,39,196,361,.413,875,157,.849,185,81,78,2485,36,205,1068,SG,67,145,232,DEN,.521
151,Jamaal Franklin,11,.393,28,5,.455,11,6,22,2,19,16,.410,39,2,1.000,2,21,0,161,4,23,39,SG,4,11,23,MEM,.474
152,Jimmer Fredette,67,.469,143,40,.476,84,64,24,3,44,107,.471,227,19,.905,21,49,0,519,8,35,273,SG,14,48,52,TOT,.559
153,Joel Freeland,77,.481,160,0,.000,2,36,26,22,120,77,.475,162,20,.690,29,52,0,727,88,95,174,C,10,32,208,POR,.475
154,Channing Frye,176,.509,346,160,.370,432,98,30,63,343,336,.432,778,78,.821,95,82,82,2312,73,245,910,PF,60,89,416,PHO,.535
155,Francisco Garcia,49,.485,101,69,.358,193,63,32,33,101,118,.401,294,10,.526,19,55,4,1083,21,120,315,SF,27,30,122,HOU,.519
156,Kevin Garnett,157,.445,353,0,.000,3,82,37,40,298,157,.441,356,38,.809,47,54,54,1109,60,123,352,C,43,69,358,BRK,.441
157,Diante Garrett,65,.385,169,36,.375,96,120,25,5,86,101,.381,265,10,.833,12,71,0,1048,11,75,248,PG,41,75,97,UTA,.449
158,Marc Gasol,334,.477,700,2,.182,11,215,29,76,340,336,.473,711,185,.768,241,59,59,1970,84,150,859,C,59,111,424,MEM,.474
159,Pau Gasol,421,.483,871,4,.286,14,201,33,92,456,425,.480,885,187,.736,254,60,60,1884,124,124,1041,C,27,141,580,LAL,.482
160,Rudy Gay,472,.481,982,65,.330,197,209,27,56,324,537,.455,1179,318,.822,387,73,73,2531,113,171,1457,SF,95,224,437,TOT,.483
161,Alonzo Gee,79,.444,178,19,.328,58,47,26,15,114,98,.415,236,43,.705,61,65,24,1020,35,96,258,SF,39,44,149,CLE,.456
162,Paul George,395,.458,862,182,.364,500,283,23,22,478,577,.424,1362,401,.864,464,80,80,2898,64,198,1737,SF,151,224,542,IND,.490
163,Taj Gibson,429,.483,889,0,.000,7,91,28,112,358,429,.479,896,211,.751,281,82,8,2351,200,207,1069,PF,41,150,558,CHI,.479
164,Manu Ginobili,204,.553,369,90,.349,258,293,36,17,172,294,.469,627,160,.851,188,68,3,1550,30,128,838,SG,70,139,202,SAS,.541
165,Rudy Gobert,36,.486,74,0,,0,7,21,41,104,36,.486,74,32,.492,65,45,0,434,51,57,104,C,8,32,155,UTA,.486
166,Ryan Gomes,3,.500,6,0,.000,2,1,31,0,4,3,.375,8,0,,0,5,0,34,0,5,6,SF,0,1,4,OKC,.375
167,Drew Gooden,69,.548,126,7,.412,17,15,32,7,77,76,.531,143,24,.889,27,22,0,395,37,53,183,C,10,17,114,WAS,.556
168,Archie Goodwin,71,.542,131,5,.139,36,20,19,11,62,76,.455,167,37,.673,55,52,0,533,25,45,194,SG,20,44,87,PHO,.470
169,Ben Gordon,29,.367,79,8,.276,29,21,30,2,24,37,.343,108,17,.810,21,19,0,279,3,18,99,SG,10,21,27,CHA,.380
170,Eric Gordon,255,.456,559,101,.391,258,208,25,12,135,356,.436,817,175,.785,223,64,64,2057,30,114,988,SG,74,134,165,NOP,.498
171,Marcin Gortat,454,.541,839,1,1.000,1,138,29,121,565,455,.542,840,157,.686,229,81,80,2655,202,201,1068,C,41,126,767,WAS,.542
172,Danny Granger,73,.408,179,43,.336,128,41,30,17,102,116,.378,307,63,.940,67,41,2,847,31,62,338,SF,12,46,133,TOT,.448
173,Aaron Gray,27,.450,60,0,.000,1,22,29,8,69,27,.443,61,11,.550,20,37,6,355,42,64,65,C,10,31,111,TOT,.443
174,Danny Green,86,.460,187,132,.415,318,104,26,61,204,218,.432,505,50,.794,63,68,59,1651,25,107,618,SG,65,76,229,SAS,.562
175,Draymond Green,132,.449,294,55,.333,165,152,23,72,323,187,.407,459,82,.667,123,82,12,1797,86,231,511,SF,102,91,409,GSW,.467
176,Gerald Green,244,.492,496,204,.400,510,122,28,42,227,448,.445,1006,195,.848,230,82,48,2330,48,220,1295,SG,70,145,275,PHO,.547
177,Jeff Green,347,.448,775,135,.341,396,138,27,47,326,482,.412,1171,283,.795,356,82,82,2805,54,180,1382,SF,57,165,380,BOS,.469
178,Willie Green,61,.407,150,41,.339,121,50,32,11,66,102,.376,271,28,.824,34,55,9,869,12,96,273,SG,22,34,78,LAC,.452
179,Blake Griffin,706,.537,1315,12,.273,44,309,24,51,565,718,.528,1359,482,.715,674,80,80,2863,192,265,1930,PF,92,224,757,LAC,.533
180,Jorge Gutierrez,22,.524,42,3,.250,12,30,25,1,19,25,.463,54,9,.750,12,15,2,244,3,37,62,PG,10,14,22,BRK,.491
181,Jordan Hamilton,77,.433,178,70,.354,198,52,23,20,162,147,.391,376,40,.784,51,60,12,1019,32,67,404,SF,44,46,194,TOT,.484
182,Justin Hamilton,6,.545,11,3,.333,9,0,23,0,3,9,.450,20,5,1.000,5,8,0,72,4,8,26,C,5,4,7,TOT,.525
183,Tyler Hansbrough,93,.479,194,0,.000,2,17,28,19,167,93,.474,196,126,.681,185,64,4,978,120,132,312,PF,28,47,287,TOR,.474
184,Tim Hardaway,164,.498,329,130,.363,358,66,21,7,102,294,.428,687,106,.828,128,81,1,1875,19,144,824,SG,44,47,121,NYK,.523
185,James Harden,372,.515,722,177,.366,483,446,24,29,283,549,.456,1205,576,.866,665,73,73,2777,61,177,1851,SG,115,265,344,HOU,.529
186,Maurice Harkless,165,.502,329,59,.383,154,80,20,50,195,224,.464,483,85,.594,143,80,41,1950,69,140,592,SF,97,86,264,ORL,.525
187,Josh Harrellson,26,.510,51,12,.387,31,15,24,15,46,38,.463,82,5,.714,7,32,0,317,30,44,93,C,6,10,76,DET,.537
188,Al Harrington,48,.449,107,34,.340,100,28,33,0,65,82,.396,207,27,.771,35,34,0,511,15,72,225,PF,14,34,80,WAS,.478
189,Devin Harris,65,.425,153,31,.307,101,178,30,2,77,96,.378,254,92,.800,115,40,0,818,8,72,315,PG,28,59,85,DAL,.439
190,Elias Harris,0,.000,1,0,,0,1,24,0,0,0,.000,1,0,,0,2,0,11,1,0,0,SF,1,0,1,LAL,.000
191,Manny Harris,21,.420,50,7,.350,20,11,24,1,27,28,.400,70,10,.833,12,9,0,180,7,10,73,SG,4,9,34,LAL,.450
192,Mike Harris,29,.492,59,0,.000,2,5,30,7,18,29,.475,61,26,.963,27,20,0,225,15,36,84,PF,16,11,33,UTA,.475
193,Tobias Harris,300,.508,590,32,.254,126,82,21,24,336,332,.464,716,197,.807,244,61,36,1850,88,143,893,PF,41,78,424,ORL,.486
194,Udonis Haslem,74,.507,146,0,,0,13,33,15,133,74,.507,146,25,.568,44,46,18,653,42,79,173,PF,11,24,175,MIA,.507
195,Spencer Hawes,275,.478,575,128,.416,308,240,25,94,529,403,.456,883,119,.783,152,80,78,2470,131,237,1053,C,44,173,660,TOT,.529
196,Chuck Hayes,56,.434,129,0,.000,1,35,30,12,141,56,.431,130,20,.800,25,61,1,754,69,95,132,C,34,33,210,TOT,.431
197,Gordon Hayward,341,.453,752,85,.304,280,400,23,40,329,426,.413,1032,311,.816,381,77,77,2800,62,155,1248,SF,110,212,391,UTA,.454
198,Gerald Henderson,363,.445,815,40,.348,115,199,26,32,279,403,.433,930,235,.761,309,77,77,2461,31,159,1081,SG,51,113,310,CHA,.455
199,Xavier Henry,116,.439,264,28,.346,81,51,22,7,89,144,.417,345,116,.655,177,43,5,908,25,79,432,SF,44,57,114,LAL,.458
200,John Henson,344,.539,638,0,.000,1,113,23,116,326,344,.538,639,91,.514,177,70,23,1856,171,185,779,PF,41,114,497,MIL,.538
201,Roy Hibbert,329,.439,749,2,.400,5,91,27,182,336,331,.439,754,207,.770,269,81,81,2409,202,269,871,C,29,148,538,IND,.440
202,J.J. Hickson,332,.514,646,0,.000,8,96,25,51,426,332,.508,654,150,.517,290,69,52,1859,206,177,814,PF,47,128,632,DEN,.508
203,Nene Hilario,298,.506,589,1,.200,5,153,31,47,229,299,.503,594,155,.583,266,53,37,1560,65,164,754,PF,64,117,294,WAS,.504
204,George Hill,177,.497,356,95,.365,260,265,27,23,230,272,.442,616,142,.807,176,76,76,2434,53,158,781,PG,75,92,283,IND,.519
205,Jordan Hill,286,.550,520,0,.000,1,54,26,64,341,286,.549,521,124,.685,181,72,32,1500,194,172,696,PF,29,75,535,LAL,.549
206,Solomon Hill,10,.588,17,7,.304,23,12,22,2,32,17,.425,40,6,.857,7,28,0,226,9,19,47,SF,5,13,41,IND,.513
207,Kirk Hinrich,158,.419,377,85,.351,242,286,33,26,161,243,.393,619,95,.760,125,73,61,2116,31,203,666,PG,80,120,192,CHI,.461
208,Jrue Holiday,173,.459,377,30,.390,77,268,23,12,114,203,.447,454,51,.810,63,34,34,1143,28,92,487,PG,56,105,142,NOP,.480
209,Ryan Hollins,53,.736,72,0,,0,8,29,31,59,53,.736,72,35,.625,56,61,0,482,31,87,141,PF,9,29,90,LAC,.736
210,Scotty Hopson,0,.000,2,0,.000,2,1,24,0,0,0,.000,4,1,.500,2,2,0,7,0,0,1,SG,1,0,0,CLE,.000
211,Al Horford,234,.572,409,4,.364,11,76,27,44,178,238,.567,420,58,.682,85,29,29,958,66,56,538,C,27,64,244,ATL,.571
212,Dwight Howard,471,.594,793,2,.286,7,131,28,128,635,473,.591,800,349,.547,638,71,71,2396,231,240,1297,C,60,229,866,HOU,.593
213,Robbie Hummel,35,.398,88,32,.360,89,23,24,2,97,67,.379,177,15,.938,16,53,5,655,35,57,181,SF,16,10,132,MIN,.469
214,Kris Humphries,231,.503,459,0,.000,2,67,28,61,282,231,.501,461,117,.813,144,69,30,1376,127,136,579,PF,31,64,409,BOS,.501
215,Serge Ibaka,501,.546,918,23,.383,60,85,24,219,485,524,.536,978,156,.784,199,81,81,2666,224,233,1227,PF,39,123,709,OKC,.548
216,Andre Iguodala,158,.558,283,62,.354,175,263,30,18,240,220,.480,458,86,.652,132,63,63,2040,53,103,588,SF,95,100,293,GSW,.548
217,Ersan Ilyasova,200,.446,448,37,.282,131,72,26,8,235,237,.409,579,107,.823,130,55,47,1478,107,135,618,PF,46,61,342,MIL,.441
218,Kyrie Irving,409,.458,893,123,.358,344,433,21,23,207,532,.430,1237,291,.861,338,71,71,2496,52,163,1478,PG,108,190,259,CLE,.480
219,Royal Ivey,0,.000,1,0,.000,1,0,32,0,1,0,.000,2,0,,0,2,0,5,0,1,0,SG,0,0,1,OKC,.000
220,Jarrett Jack,223,.435,513,63,.341,185,324,30,22,201,286,.410,698,125,.839,149,80,31,2252,22,133,760,PG,56,133,223,CLE,.455
221,Reggie Jackson,320,.477,671,83,.339,245,331,23,9,270,403,.440,916,158,.893,177,80,36,2277,43,142,1047,PG,85,168,313,OKC,.485
222,Stephen Jackson,5,.417,12,1,.071,14,5,35,1,8,6,.231,26,2,.500,4,9,0,107,2,11,15,SF,6,6,10,LAC,.250
223,Bernard James,11,.500,22,0,.000,1,3,28,8,27,11,.478,23,6,.545,11,30,0,146,15,24,28,C,3,10,42,DAL,.478
224,Damion James,2,.286,7,0,.000,2,3,26,1,11,2,.222,9,2,1.000,2,5,1,50,1,3,6,SF,0,1,12,SAS,.222
225,LeBron James,651,.622,1047,116,.379,306,488,29,26,452,767,.567,1353,439,.750,585,77,77,2902,81,126,2089,PF,121,270,533,MIA,.610
226,Mike James,4,.250,16,1,.200,5,17,38,0,7,5,.238,21,0,.000,2,11,0,77,0,11,11,PG,2,5,7,CHI,.262
227,Antawn Jamison,21,.412,51,8,.195,41,7,37,3,46,29,.315,92,18,.720,25,22,0,248,9,29,84,PF,9,7,55,LAC,.359
228,Othyus Jeffers,3,.750,4,0,.000,2,1,28,0,8,3,.500,6,3,.750,4,6,1,47,1,3,9,SG,0,1,9,TOT,.500
229,Al Jefferson,697,.512,1361,3,.200,15,155,29,79,636,700,.509,1376,191,.690,277,73,73,2553,156,176,1594,C,67,124,792,CHA,.510
230,Richard Jefferson,171,.484,353,123,.409,301,130,33,14,201,294,.450,654,120,.741,162,82,78,2213,18,168,831,SF,56,94,219,UTA,.544
231,John Jenkins,12,.500,24,4,.222,18,11,22,1,19,16,.381,42,4,1.000,4,13,0,158,3,11,40,SG,1,11,22,ATL,.429
232,Brandon Jennings,269,.397,678,154,.337,457,609,24,8,185,423,.373,1135,241,.751,321,80,79,2728,59,157,1241,PG,101,215,244,DET,.441
233,Jonas Jerebko,67,.500,134,31,.419,74,39,26,6,124,98,.471,208,43,.729,59,64,0,741,51,85,270,PF,21,43,175,DET,.546
234,Amir Johnson,324,.593,546,20,.303,66,115,26,88,333,344,.562,612,91,.636,143,77,72,2214,172,271,799,PF,56,123,505,TOR,.578
235,Chris Johnson,42,.483,87,43,.339,127,31,23,4,66,85,.397,214,37,.860,43,40,0,789,31,63,250,SF,27,22,97,BOS,.498
236,James Johnson,121,.548,221,22,.253,87,111,26,57,106,143,.464,308,76,.844,90,52,4,956,60,102,384,SF,42,66,166,MEM,.500
237,Joe Johnson,300,.489,614,162,.401,404,216,32,10,222,462,.454,1018,159,.815,195,79,79,2575,48,129,1245,SG,47,120,270,BRK,.533
238,Orlando Johnson,27,.409,66,9,.191,47,20,24,2,46,36,.319,113,19,.731,26,45,0,392,9,26,100,SG,6,15,55,TOT,.358
239,Wesley Johnson,177,.466,380,100,.369,271,124,26,77,278,277,.425,651,61,.792,77,79,62,2240,70,207,715,SF,86,90,348,LAL,.502
240,Darius Johnson-Odom,0,.000,4,0,.000,3,1,24,0,2,0,.000,7,0,.000,2,3,0,15,0,3,0,SG,1,2,2,PHI,.000
241,James Jones,3,.214,14,28,.519,54,9,33,4,21,31,.456,68,7,.636,11,20,6,236,2,6,97,SF,3,4,23,MIA,.662
242,Perry Jones,61,.508,120,22,.361,61,26,22,19,86,83,.459,181,28,.667,42,62,7,764,28,62,216,PF,14,21,114,OKC,.519
243,Solomon Jones,6,.353,17,0,,0,2,29,2,8,6,.353,17,2,.500,4,11,0,85,8,12,14,PF,2,2,16,ORL,.353
244,Terrence Jones,355,.581,611,31,.307,101,87,22,99,366,386,.542,712,118,.605,195,76,71,2078,162,139,921,PF,53,71,528,HOU,.564
245,DeAndre Jordan,348,.676,515,0,,0,74,25,203,783,348,.676,515,160,.428,374,82,82,2870,331,264,856,C,80,123,1114,LAC,.676
246,Cory Joseph,114,.502,227,12,.316,38,114,22,14,75,126,.475,265,79,.823,96,68,19,936,32,84,343,SG,35,43,107,SAS,.498
247,Chris Kaman,176,.513,343,0,.000,3,58,31,40,175,176,.509,346,52,.765,68,39,13,736,54,93,404,C,11,74,229,LAL,.509
248,Enes Kanter,419,.492,852,0,.000,1,75,21,42,376,419,.491,853,149,.730,204,80,37,2138,222,230,987,C,28,144,598,UTA,.491
249,Sergey Karasev,8,.500,16,4,.211,19,6,20,1,16,12,.343,35,9,.900,10,22,1,156,0,22,37,SF,3,11,16,CLE,.400
250,Ryan Kelly,109,.476,229,48,.338,142,95,22,45,177,157,.423,371,110,.815,135,59,25,1312,42,147,472,PF,32,47,219,LAL,.488
251,Michael Kidd-Gilchrist,166,.483,344,1,.111,9,52,20,39,215,167,.473,353,113,.614,184,62,62,1502,109,145,448,SF,43,60,324,CHA,.475
252,Andrei Kirilenko,81,.523,155,1,.200,5,72,32,19,91,82,.513,160,61,.513,119,45,4,857,55,65,226,PF,40,54,146,BRK,.516
253,Brandon Knight,351,.466,754,110,.325,338,352,22,17,209,461,.422,1092,259,.802,323,72,69,2400,46,146,1291,PG,69,188,255,MIL,.473
254,Kyle Korver,104,.479,217,185,.472,392,208,32,24,260,289,.475,609,87,.926,94,71,71,2408,22,147,850,SG,70,102,282,ATL,.626
255,Kosta Koufos,227,.495,459,0,,0,39,24,71,258,227,.495,459,60,.645,93,80,22,1349,160,182,514,C,32,67,418,MEM,.495
256,Viacheslav Kravtsov,8,.533,15,0,,0,1,26,1,8,8,.533,15,4,.500,8,20,0,59,9,7,20,C,0,6,17,PHO,.533
257,Ognjen Kuzmic,5,.385,13,0,,0,2,23,4,11,5,.385,13,5,.455,11,21,0,92,10,17,15,C,3,10,21,GSW,.385
258,Doron Lamb,27,.386,70,36,.400,90,43,22,1,41,63,.394,160,29,.806,36,53,0,695,8,54,191,SG,11,27,49,ORL,.506
259,Jeremy Lamb,175,.483,362,88,.356,247,115,21,26,162,263,.432,609,51,.797,64,78,0,1538,27,143,665,SG,56,61,189,OKC,.504
260,Carl Landry,31,.517,60,0,,0,5,30,1,42,31,.517,60,14,.824,17,18,1,233,15,34,76,PF,3,9,57,SAC,.517
261,Shane Larkin,40,.404,99,12,.316,38,71,21,1,31,52,.380,137,16,.640,25,48,0,489,11,46,132,PG,26,39,42,DAL,.423
262,Ty Lawson,275,.455,604,72,.356,202,543,26,10,175,347,.431,806,324,.798,406,62,61,2222,40,113,1090,PG,100,200,215,DEN,.475
263,Ricky Ledo,3,.333,9,3,.375,8,2,21,0,2,6,.353,17,4,1.000,4,11,0,33,0,2,19,SG,1,2,2,DAL,.441
264,Courtney Lee,223,.531,420,72,.371,194,115,28,28,158,295,.480,614,99,.884,112,79,47,1973,29,127,761,SG,65,73,187,TOT,.539
265,David Lee,513,.523,980,0,.000,1,147,30,26,461,513,.523,981,231,.780,296,69,67,2288,182,206,1257,PF,48,152,643,GSW,.523
266,Alex Len,33,.423,78,0,,0,4,20,18,60,33,.423,78,20,.645,31,42,3,362,39,68,86,C,4,26,99,PHO,.423
267,Kawhi Leonard,268,.579,463,69,.379,182,133,22,50,336,337,.522,645,101,.802,126,66,65,1923,76,127,844,SF,114,80,412,SAS,.576
268,Meyers Leonard,41,.482,85,0,.000,6,18,21,5,85,41,.451,91,16,.762,21,40,0,355,26,76,98,C,7,15,111,POR,.451
269,Jon Leuer,98,.497,197,23,.469,49,20,24,13,121,121,.492,246,37,.787,47,49,0,642,37,63,302,PF,18,27,158,MEM,.539
270,Rashard Lewis,52,.510,102,46,.343,134,57,34,8,86,98,.415,236,26,.788,33,60,6,971,24,90,268,SF,53,35,110,MIA,.513
271,DeAndre Liggins,1,1.000,1,0,,0,0,25,0,0,1,1.000,1,0,,0,1,0,1,1,0,2,SG,0,0,1,MIA,1.000
272,Damian Lillard,335,.447,750,218,.394,554,457,23,22,253,553,.424,1304,371,.871,426,82,82,2937,35,197,1695,PG,64,193,288,POR,.508
273,Jeremy Lin,213,.492,433,82,.358,229,294,25,27,153,295,.446,662,218,.823,265,71,33,2054,34,166,890,PG,68,176,187,HOU,.508
274,Shaun Livingston,234,.486,481,1,.167,6,245,28,31,179,235,.483,487,158,.827,191,76,54,1974,67,172,629,PG,93,105,246,BRK,.484
275,Brook Lopez,129,.566,228,0,.000,1,16,25,30,63,129,.563,229,94,.817,115,17,17,533,39,52,352,C,9,28,102,BRK,.563
276,Robin Lopez,355,.552,643,0,.000,1,73,25,139,374,355,.551,644,198,.818,242,82,82,2603,326,196,908,C,25,84,700,POR,.551
277,Kevin Love,460,.502,916,190,.376,505,341,25,35,739,650,.457,1421,520,.821,633,77,77,2797,224,136,2010,PF,59,196,963,MIN,.524
278,Kyle Lowry,267,.460,580,190,.380,500,586,27,15,281,457,.423,1080,313,.813,385,79,79,2862,88,267,1417,PG,121,194,369,TOR,.511
279,John Lucas III,37,.349,106,25,.298,84,42,31,0,27,62,.326,190,10,.625,16,42,6,591,12,41,159,PG,14,22,39,UTA,.392
280,Shelvin Mack,147,.464,317,62,.337,184,271,23,2,139,209,.417,501,64,.865,74,73,11,1490,21,100,544,PG,50,89,160,ATL,.479
281,Ian Mahinmi,91,.484,188,0,.000,1,24,27,72,150,91,.481,189,90,.621,145,77,1,1248,107,207,272,C,41,58,257,IND,.481
282,Shawn Marion,283,.518,546,58,.358,162,124,35,37,365,341,.482,708,51,.785,65,76,76,2409,132,125,791,SF,90,95,497,DAL,.523
283,Kendall Marshall,99,.411,241,71,.399,178,477,22,4,140,170,.406,419,19,.528,36,54,45,1564,15,76,430,PG,48,150,155,LAL,.490
284,Cartier Martin,52,.460,113,59,.391,151,33,29,7,97,111,.420,264,48,.738,65,59,6,870,13,71,329,SF,27,34,110,TOT,.532
285,Kenyon Martin,63,.516,122,0,.000,1,50,36,27,98,63,.512,123,11,.579,19,32,15,633,36,85,137,PF,25,26,134,NYK,.512
286,Kevin Martin,325,.448,726,115,.387,297,121,30,6,169,440,.430,1023,303,.891,340,68,68,2177,34,123,1298,SG,66,106,203,MIN,.486
287,Roger Mason,8,.421,19,17,.354,48,19,33,1,21,25,.373,67,7,1.000,7,25,2,260,1,26,74,SG,6,9,22,MIA,.500
288,Wesley Matthews,244,.490,498,201,.393,511,197,27,14,238,445,.441,1009,252,.837,301,82,82,2780,51,176,1343,SG,76,110,289,POR,.541
289,Jason Maxiell,47,.448,105,0,,0,9,30,20,58,47,.448,105,15,.484,31,34,13,488,28,47,109,PF,8,14,86,ORL,.448
290,Eric Maynor,20,.313,64,12,.324,37,52,26,3,30,32,.317,101,6,.545,11,31,0,327,9,17,82,PG,9,29,39,TOT,.376
291,O.J. Mayo,140,.433,323,84,.370,227,113,26,13,100,224,.407,550,76,.864,88,52,23,1346,24,111,608,SG,28,95,124,MIL,.484
292,Luc Mbah a Moute,83,.472,176,4,.235,17,36,27,14,90,87,.451,193,46,.687,67,64,7,1003,56,68,224,PF-SF,30,40,146,TOT,.461
293,Ray McCallum,91,.378,241,22,.373,59,120,22,9,61,113,.377,300,32,.744,43,45,10,897,18,69,280,PG,22,39,79,SAC,.413
294,C.J. McCollum,44,.449,98,30,.375,80,27,22,2,41,74,.416,178,23,.676,34,38,0,476,7,53,201,SG,14,35,48,POR,.500
295,JaVale McGee,17,.447,38,0,,0,2,26,7,7,17,.447,38,1,1.000,1,5,5,79,10,16,35,C,1,8,17,DEN,.447
296,Ben McLemore,160,.419,382,95,.320,297,82,20,18,182,255,.376,679,115,.804,143,82,55,2187,53,201,720,SG,45,96,235,SAC,.446
297,Josh McRoberts,142,.516,275,105,.361,291,333,26,46,288,247,.436,566,62,.729,85,78,78,2360,85,189,661,PF,58,83,373,CHA,.529
298,Jodie Meeks,251,.514,488,162,.401,404,138,26,4,164,413,.463,892,221,.857,258,77,70,2556,30,119,1209,SG,111,111,194,LAL,.554
299,Gal Mekel,25,.379,66,5,.250,20,63,25,1,22,30,.349,86,8,.667,12,31,1,292,5,31,73,PG,4,31,27,DAL,.378
300,Khris Middleton,256,.454,564,120,.414,290,169,22,20,250,376,.440,854,118,.861,137,82,64,2460,60,243,990,SF,83,123,310,MIL,.511
301,C.J. Miles,95,.480,198,83,.393,211,52,26,15,85,178,.435,409,64,.853,75,51,34,984,18,103,503,SG,46,44,103,CLE,.537
302,Andre Miller,95,.452,210,11,.524,21,197,37,9,102,106,.459,231,60,.779,77,58,2,982,28,75,283,SG,34,61,130,TOT,.483
303,Darius Miller,48,.539,89,25,.325,77,43,23,9,43,73,.440,166,29,.806,36,45,7,723,9,88,200,SF,24,22,52,NOP,.515
304,Mike Miller,106,.505,210,107,.459,233,130,33,5,177,213,.481,443,46,.821,56,82,4,1707,30,95,579,SF,26,77,207,MEM,.602
305,Quincy Miller,64,.395,162,30,.319,94,26,21,32,111,94,.367,256,39,.709,55,52,16,789,36,70,257,PF,22,48,147,DEN,.426
306,Patty Mills,174,.500,348,135,.425,318,149,25,9,135,309,.464,666,73,.890,82,81,2,1527,34,114,826,PG,68,63,169,SAS,.565
307,Paul Millsap,407,.487,835,76,.358,212,232,28,78,473,483,.461,1047,286,.731,391,74,73,2482,154,210,1328,PF,129,185,627,ATL,.498
308,Tony Mitchell,4,.364,11,1,1.000,1,2,21,3,11,5,.417,12,11,.579,19,21,0,79,15,9,22,PF,6,4,26,DET,.458
309,Tony Mitchell,3,.750,4,0,.000,1,1,24,0,0,3,.600,5,0,,0,3,0,10,1,0,6,SF,1,0,1,MIL,.600
310,Nazr Mohammed,54,.429,126,0,,0,20,36,30,109,54,.429,126,16,.533,30,80,1,562,66,77,124,C,14,37,175,CHI,.429
311,Greg Monroe,504,.497,1014,0,.000,1,171,23,47,504,504,.497,1015,241,.657,367,82,82,2690,256,205,1249,PF,91,166,760,DET,.497
312,E'Twaun Moore,138,.468,295,57,.354,161,112,24,13,107,195,.428,456,52,.765,68,79,3,1506,29,106,499,SG,60,55,136,ORL,.490
313,Darius Morris,27,.466,58,12,.316,38,44,23,0,19,39,.406,96,17,.654,26,27,0,313,7,33,107,PG,13,27,26,TOT,.469
314,Marcus Morris,189,.483,391,99,.381,260,88,24,18,235,288,.442,651,121,.761,159,82,1,1800,84,157,796,SF,72,95,319,PHO,.518
315,Markieff Morris,377,.512,737,34,.315,108,144,24,51,346,411,.486,845,259,.792,327,81,0,2153,139,232,1115,PF,68,147,485,PHO,.507
316,Anthony Morrow,150,.462,325,88,.451,195,59,28,12,111,238,.458,520,72,.828,87,76,9,1426,29,102,636,SG,38,51,140,NOP,.542
317,Donatas Motiejunas,110,.519,212,21,.250,84,34,23,21,165,131,.443,296,58,.604,96,62,3,952,60,132,341,PF,20,49,225,HOU,.478
318,Arnett Moultrie,16,.421,38,0,,0,2,23,4,24,16,.421,38,4,.800,5,12,2,187,11,22,36,PF,8,7,35,PHI,.421
319,Timofey Mozgov,281,.539,521,4,.167,24,62,27,100,357,285,.523,545,196,.754,260,82,30,1770,171,213,770,C,27,122,528,DEN,.527
320,Shabazz Muhammad,54,.478,113,3,.273,11,6,21,1,29,57,.460,124,26,.650,40,37,0,290,24,24,143,SG,8,16,53,MIN,.472
321,Byron Mullens,40,.526,76,33,.371,89,14,24,11,68,73,.442,165,10,.500,20,45,0,414,24,64,189,C,15,27,92,TOT,.542
322,Erik Murphy,3,.300,10,0,.000,3,2,23,4,6,3,.231,13,0,,0,24,0,62,2,7,6,C,0,2,8,CHI,.231
323,Toure' Murry,51,.436,117,5,.417,12,49,24,1,31,56,.434,129,23,.590,39,51,0,373,13,46,140,PG,19,34,44,NYK,.453
324,Mike Muscala,31,.443,70,0,.000,3,7,22,10,35,31,.425,73,14,1.000,14,20,0,215,17,29,76,PF,3,12,52,ATL,.425
325,Hamady N'Diaye,3,.333,9,0,,0,3,27,4,13,3,.333,9,0,.000,1,14,0,74,5,15,6,C,0,3,18,SAC,.333
326,Steve Nash,28,.400,70,8,.333,24,86,39,2,25,36,.383,94,22,.917,24,15,10,313,4,18,102,PG,7,31,29,LAL,.426
327,Gary Neal,125,.430,291,68,.378,180,83,29,0,80,193,.410,471,94,.895,105,52,3,1114,10,65,548,SG,18,64,90,TOT,.482
328,Nemanja Nedovic,5,.238,21,3,.167,18,13,22,1,12,8,.205,39,7,.875,8,24,0,142,3,13,26,SG,0,13,15,GSW,.244
329,Jameer Nelson,158,.444,356,136,.348,391,476,31,5,202,294,.394,747,96,.857,112,68,68,2179,29,146,820,PG,52,166,231,ORL,.485
330,Andrew Nicholson,152,.459,331,28,.315,89,25,24,23,202,180,.429,420,47,.825,57,76,5,1174,53,150,435,PF,18,51,255,ORL,.462
331,Joakim Noah,380,.476,798,0,.000,2,431,28,121,618,380,.475,800,247,.737,335,80,80,2820,282,245,1007,C,99,194,900,CHI,.475
332,Steve Novak,8,.333,24,52,.426,122,13,30,4,50,60,.411,146,6,1.000,6,54,1,540,8,44,178,PF,12,5,58,TOR,.589
333,Dirk Nowitzki,502,.532,944,131,.398,329,216,35,45,458,633,.497,1273,338,.899,376,80,80,2628,40,165,1735,PF,73,117,498,DAL,.549
334,James Nunnally,7,.333,21,8,.320,25,8,23,2,18,15,.326,46,6,.667,9,13,0,165,1,11,44,SF,6,7,19,TOT,.413
335,Jermaine O'Neal,125,.504,248,0,,0,25,35,40,157,125,.504,248,99,.750,132,44,13,883,85,102,349,PF,14,52,242,GSW,.504
336,Kyle O'Quinn,186,.505,368,0,.000,3,78,23,88,264,186,.501,371,57,.687,83,69,19,1188,100,165,429,C,39,78,364,ORL,.501
337,Greg Oden,27,.551,49,0,,0,1,26,13,31,27,.551,49,13,.565,23,23,6,212,23,52,67,C,7,12,54,MIA,.551
338,Victor Oladipo,318,.448,710,74,.327,226,327,21,37,286,392,.419,936,248,.780,318,80,44,2487,43,210,1106,PG,129,256,329,ORL,.458
339,Kelly Olynyk,194,.500,388,40,.351,114,109,22,27,225,234,.466,502,99,.811,122,70,9,1400,140,227,607,C,35,106,365,BOS,.506
340,Arinze Onuaku,1,.200,5,0,,0,3,26,0,6,1,.200,5,1,.500,2,5,0,30,2,3,3,PF,0,1,8,TOT,.200
341,Daniel Orton,21,.447,47,0,,0,15,23,16,45,21,.447,47,23,.767,30,22,4,251,16,38,65,C,6,18,61,PHI,.447
342,Travis Outlaw,89,.426,209,41,.350,117,48,29,19,132,130,.399,326,42,.808,52,63,4,1065,36,94,343,SF,20,26,168,SAC,.462
343,Zaza Pachulia,149,.428,348,0,.000,1,136,29,14,192,149,.427,349,110,.846,130,53,43,1325,141,124,408,C,45,92,333,MIL,.427
344,Jannero Pargo,28,.483,58,24,.400,60,52,34,1,19,52,.441,118,8,.727,11,29,0,242,1,17,136,PG,14,26,20,CHA,.542
345,Tony Parker,431,.509,847,25,.373,67,388,31,9,138,456,.499,914,197,.811,243,68,68,1997,17,86,1134,PG,36,151,155,SAS,.513
346,Chandler Parsons,336,.528,636,130,.370,351,298,25,29,340,466,.472,987,164,.742,221,74,74,2783,69,168,1226,SF,88,144,409,HOU,.538
347,Patrick Patterson,170,.503,338,55,.364,151,78,24,37,225,225,.460,489,50,.704,71,65,13,1533,117,159,555,PF,55,65,342,TOT,.516
348,Chris Paul,328,.498,658,78,.368,212,663,28,4,230,406,.467,870,295,.855,345,62,62,2171,38,157,1185,PG,154,145,268,LAC,.511
349,Nikola Pekovic,379,.541,701,0,,0,50,28,23,262,379,.541,701,186,.747,249,54,54,1663,206,129,944,C,30,84,468,MIN,.541
350,Kendrick Perkins,87,.453,192,0,.000,1,67,29,32,223,87,.451,193,37,.552,67,62,62,1207,82,177,211,C,26,90,305,OKC,.451
351,Paul Pierce,209,.507,412,112,.373,300,178,36,31,322,321,.451,712,256,.826,310,75,68,2098,26,190,1010,SF,86,153,348,BRK,.529
352,Dexter Pittman,0,.000,1,0,,0,0,25,0,0,0,.000,1,0,.000,2,2,0,3,3,0,0,C,0,0,3,ATL,.000
353,Mason Plumlee,199,.666,299,0,.000,3,60,23,55,209,199,.659,302,122,.626,195,70,22,1275,99,171,520,C,49,77,308,BRK,.659
354,Miles Plumlee,286,.517,553,0,,0,43,25,90,428,286,.517,553,74,.561,132,80,79,1964,198,185,646,C,50,111,626,PHO,.517
355,Quincy Pondexter,20,.444,45,11,.324,34,20,25,1,16,31,.392,79,21,.808,26,15,2,270,10,18,94,SG,5,15,26,MEM,.462
356,Otto Porter,29,.414,70,4,.190,21,10,20,1,36,33,.363,91,8,.667,12,37,0,319,21,26,78,SF,8,14,57,WAS,.385
357,Josh Powell,2,.333,6,0,,0,0,31,1,5,2,.333,6,0,,0,1,0,19,0,1,4,PF,0,1,5,HOU,.333
358,Phil Pressey,50,.340,147,28,.264,106,241,22,5,85,78,.308,253,29,.644,45,75,11,1132,20,97,213,PG,68,87,105,BOS,.364
359,A.J. Price,13,.542,24,6,.273,22,13,27,0,9,19,.413,46,0,.000,2,28,0,99,1,5,44,SG,1,7,10,MIN,.478
360,Ronnie Price,19,.388,49,9,.209,43,66,30,2,35,28,.304,92,9,.692,13,31,2,377,8,50,74,SG,25,26,43,ORL,.353
361,Pablo Prigioni,23,.451,51,65,.464,140,228,36,2,93,88,.461,191,11,.917,12,66,27,1283,36,132,252,PG,67,60,129,NYK,.631
362,Tayshaun Prince,180,.426,423,20,.290,69,119,33,19,202,200,.407,492,34,.567,60,76,76,1948,32,63,454,SF,39,41,234,MEM,.427
363,Miroslav Raduljica,68,.540,126,0,,0,23,26,13,54,68,.540,126,45,.818,55,48,2,465,54,84,181,C,7,28,108,MIL,.540
364,Anthony Randolph,50,.435,115,18,.295,61,32,24,19,102,68,.386,176,52,.754,69,43,5,527,20,64,206,PF,26,39,122,DEN,.438
365,Shavlik Randolph,7,.500,14,0,,0,1,30,1,18,7,.500,14,6,.545,11,14,0,95,7,15,20,PF,3,5,25,PHO,.500
366,Zach Randolph,558,.474,1178,2,.100,20,200,32,23,530,560,.467,1198,250,.742,337,79,79,2705,265,210,1372,PF,54,183,795,MEM,.468
367,J.J. Redick,108,.507,213,73,.395,185,78,29,3,65,181,.455,398,97,.915,106,35,34,987,9,65,532,SG,28,42,74,LAC,.546
368,Glen Rice,6,.300,20,5,.294,17,7,23,1,16,11,.297,37,5,.714,7,11,1,109,4,7,32,SG,6,9,20,WAS,.365
369,Luke Ridnour,89,.406,219,37,.343,108,176,32,8,74,126,.385,327,17,.654,26,61,14,1141,23,92,306,PG,32,66,97,TOT,.442
370,Austin Rivers,156,.416,375,36,.364,99,160,21,9,103,192,.405,474,110,.636,173,69,4,1339,26,134,530,PG,45,77,129,NOP,.443
371,Andre Roberson,31,.564,55,2,.154,13,15,22,10,58,33,.485,68,7,.700,10,40,16,399,36,74,75,SG,19,19,94,OKC,.500
372,Brian Roberts,180,.447,403,64,.360,178,234,28,7,119,244,.420,581,125,.940,133,72,42,1667,17,132,677,PG,43,95,136,NOP,.475
373,Nate Robinson,106,.463,229,58,.377,154,112,29,4,60,164,.428,383,71,.835,85,44,1,866,21,92,457,PG,36,58,81,DEN,.504
374,Thomas Robinson,141,.483,292,0,.000,1,34,22,20,202,141,.481,293,57,.564,101,70,0,873,105,131,339,PF,23,57,307,POR,.481
375,Rajon Rondo,115,.442,260,26,.289,90,294,27,2,142,141,.403,350,42,.627,67,30,30,998,22,65,350,PG,40,99,164,BOS,.440
376,Derrick Rose,42,.359,117,16,.340,47,43,25,1,23,58,.354,164,27,.844,32,10,10,311,9,15,159,PG,5,34,32,CHI,.402
377,Terrence Ross,157,.458,343,161,.395,408,79,22,27,209,318,.423,751,82,.837,98,81,62,2159,43,183,879,SG,64,88,252,TOR,.531
378,Ricky Rubio,211,.393,537,44,.331,133,704,23,11,281,255,.381,670,227,.802,283,82,82,2638,61,218,781,PG,191,221,342,MIN,.413
379,Brandon Rush,14,.326,43,16,.340,47,24,28,9,39,30,.333,90,3,.600,5,38,0,418,5,31,79,SG,5,20,44,UTA,.422
380,Robert Sacre,143,.477,300,0,,0,51,24,47,172,143,.477,300,64,.681,94,65,13,1089,82,134,350,C,24,44,254,LAL,.477
381,John Salmons,87,.348,250,63,.387,163,147,34,19,143,150,.363,413,40,.769,52,78,8,1726,20,124,403,SG-SF,47,54,163,TOT,.439
382,Larry Sanders,76,.472,161,0,.000,1,19,25,40,105,76,.469,162,26,.473,55,23,20,584,60,74,178,C,18,26,165,MIL,.469
383,Dennis Schroder,62,.425,146,10,.238,42,93,20,0,55,72,.383,188,29,.674,43,49,0,641,5,54,183,PG,17,61,60,ATL,.410
384,Luis Scola,262,.474,553,1,.143,7,81,33,16,305,263,.470,560,99,.728,136,82,2,1399,86,164,626,PF,26,108,391,IND,.471
385,Mike Scott,239,.558,428,62,.310,200,75,25,7,222,301,.479,628,103,.780,132,80,6,1482,62,121,767,PF,30,79,284,ATL,.529
386,Thabo Sefolosha,93,.495,188,48,.316,152,94,29,17,170,141,.415,340,53,.768,69,61,61,1584,50,90,383,SG,79,55,220,OKC,.485
387,Kevin Seraphin,111,.505,220,0,,0,17,24,26,75,111,.505,220,27,.871,31,53,1,578,53,103,249,C,3,41,128,WAS,.505
388,Ramon Sessions,295,.457,645,35,.282,124,340,27,9,165,330,.429,769,326,.807,404,83,19,2214,38,90,1021,PG,49,148,203,TOT,.452
389,Mustafa Shakur,0,.000,2,0,.000,1,4,29,0,0,0,.000,3,1,.500,2,3,0,11,0,2,1,PG,0,2,0,OKC,.000
390,Tornike Shengelia,13,.591,22,0,.000,6,14,22,1,12,13,.464,28,3,.375,8,26,0,154,4,18,29,SF,3,12,16,TOT,.464
391,Iman Shumpert,107,.418,256,76,.333,228,129,23,13,227,183,.378,484,53,.746,71,74,58,1962,81,209,495,SG,92,79,308,NYK,.457
392,Alexey Shved,46,.341,135,30,.294,102,68,25,16,60,76,.321,237,68,.756,90,63,0,664,21,36,250,SG,26,48,81,MIN,.384
393,Henry Sims,130,.476,273,0,.000,1,52,23,20,133,130,.474,274,90,.744,121,46,25,875,104,116,350,C,28,41,237,TOT,.474
394,Kyle Singler,175,.492,356,94,.382,246,75,25,38,187,269,.447,602,152,.826,184,82,36,2337,116,211,784,SF,61,79,303,DET,.525
395,Chris Singleton,18,.375,48,7,.368,19,6,24,3,37,25,.373,67,18,.720,25,25,0,250,18,25,75,SF,9,17,55,WAS,.425
396,Peyton Siva,11,.344,32,7,.280,25,34,23,1,12,18,.316,57,11,.733,15,24,0,224,2,27,54,SG,9,18,14,DET,.377
397,Donald Sloan,34,.453,75,10,.238,42,50,26,1,40,44,.376,117,12,.600,20,48,1,392,4,19,110,SG,10,22,44,IND,.419
398,Chris Smith,0,,0,0,,0,0,26,0,0,0,,0,0,,0,2,0,2,0,0,0,PG,0,0,0,NYK,
399,Greg Smith,18,.643,28,0,,0,0,23,2,16,18,.643,28,2,.400,5,11,0,100,11,17,38,C,1,5,27,HOU,.643
400,Ish Smith,118,.457,258,1,.043,23,179,25,13,98,119,.423,281,22,.564,39,70,1,1006,31,66,261,PG,49,65,129,PHO,.425
401,J.R. Smith,207,.436,475,189,.394,480,219,28,20,261,396,.415,955,90,.652,138,74,37,2421,35,196,1071,SF,65,108,296,NYK,.514
402,Jason Smith,131,.465,282,0,,0,29,27,29,130,131,.465,282,39,.780,50,31,27,830,51,100,301,PF,11,28,181,NOP,.465
403,Josh Smith,447,.462,968,70,.264,265,252,28,110,418,517,.419,1233,160,.532,301,77,76,2730,102,197,1264,SF,105,199,520,DET,.448
404,Tony Snell,72,.456,158,57,.320,178,68,22,15,105,129,.384,336,31,.756,41,77,12,1231,19,84,346,SG,29,44,124,CHI,.469
405,James Southerland,2,.222,9,3,.500,6,0,23,2,8,5,.333,15,1,.500,2,4,0,30,0,3,14,SF,1,1,8,TOT,.433
406,Marreese Speights,187,.455,411,8,.258,31,32,26,34,189,195,.441,442,110,.821,134,79,3,982,101,148,508,C,10,66,290,GSW,.450
407,Tiago Splitter,181,.528,343,0,.000,3,90,29,31,240,181,.523,346,121,.699,173,59,50,1271,123,117,483,C,29,75,363,SAS,.523
408,D.J. Stephens,3,.429,7,0,,0,0,23,0,4,3,.429,7,1,1.000,1,3,0,15,1,0,7,SG,0,0,5,MIL,.429
409,Lance Stephenson,341,.545,626,86,.352,244,359,23,7,463,427,.491,870,140,.711,197,78,78,2752,95,195,1080,SG,54,210,558,IND,.540
410,Greg Stiemsma,70,.579,121,0,.000,1,36,28,57,154,70,.574,122,19,.594,32,55,20,1007,72,169,159,C,35,44,226,NOP,.574
411,Julyan Stone,5,.556,9,2,.250,8,12,25,0,18,7,.412,17,2,.667,3,21,0,120,2,13,18,SG,3,5,20,TOR,.471
412,Amar'e Stoudemire,311,.557,558,0,,0,34,31,37,208,311,.557,558,150,.739,203,65,21,1466,112,159,772,C,23,91,320,NYK,.557
413,Rodney Stuckey,348,.455,765,24,.273,88,152,27,10,130,372,.436,853,244,.836,292,73,5,1950,39,131,1012,SG,54,125,169,DET,.450
414,Jared Sullinger,328,.475,691,56,.269,208,118,21,49,360,384,.427,899,158,.778,203,74,44,2041,241,251,982,PF,35,119,601,BOS,.458
415,Jeffery Taylor,64,.424,151,18,.269,67,22,24,5,45,82,.376,218,26,.553,47,26,8,629,15,62,208,SF,13,25,60,CHA,.417
416,Tyshawn Taylor,28,.354,79,3,.250,12,36,23,1,12,31,.341,91,24,.800,30,23,3,270,3,29,89,PG,12,31,15,BRK,.357
417,Jeff Teague,382,.469,815,74,.329,225,528,25,17,174,456,.438,1040,318,.846,376,79,79,2542,34,158,1304,PG,89,232,208,ATL,.474
418,Marquis Teague,33,.327,101,5,.278,18,58,20,5,39,38,.319,119,26,.743,35,40,3,443,1,46,107,SG,10,39,40,TOT,.340
419,Mirza Teletovic,85,.472,180,136,.390,349,57,28,23,206,221,.418,529,44,.710,62,72,7,1396,60,143,622,SF,29,54,266,BRK,.546
420,Garrett Temple,45,.402,112,6,.207,29,72,27,11,47,51,.362,141,30,.698,43,75,0,638,21,72,138,SG,35,42,68,WAS,.383
421,Jason Terry,16,.327,49,39,.379,103,56,36,0,33,55,.362,152,10,.667,15,35,0,570,4,48,159,PG,13,27,37,BRK,.490
422,Hasheem Thabeet,13,.565,23,0,,0,1,26,9,31,13,.565,23,1,.200,5,23,0,192,9,47,27,C,4,14,40,OKC,.565
423,Adonis Thomas,5,.556,9,1,.200,5,3,20,0,3,6,.429,14,1,1.000,1,6,1,37,0,6,14,SF,0,1,3,TOT,.464
424,Isaiah Thomas,369,.504,732,127,.349,364,454,24,8,163,496,.453,1096,346,.850,407,72,54,2497,47,185,1465,PG,93,213,210,SAC,.510
425,Lance Thomas,2,.222,9,0,,0,3,25,0,5,2,.222,9,2,.500,4,5,0,42,2,4,6,SF,0,2,7,NOP,.222
426,Malcolm Thomas,6,.500,12,1,.250,4,2,25,3,16,7,.438,16,0,.000,2,8,0,63,5,5,15,PF,0,9,21,TOT,.469
427,Hollis Thompson,104,.507,205,67,.401,167,73,22,12,174,171,.460,372,52,.712,73,77,41,1742,73,144,461,SF,53,60,247,PHI,.550
428,Jason Thompson,251,.506,496,0,,0,53,27,56,374,251,.506,496,84,.579,145,82,61,2007,153,251,586,PF,32,95,527,SAC,.506
429,Klay Thompson,336,.464,724,223,.417,535,181,23,37,211,559,.444,1259,147,.795,185,81,81,2868,38,234,1488,SG,74,135,249,GSW,.533
430,Tristan Thompson,363,.478,760,0,.000,1,72,22,35,485,363,.477,761,235,.693,339,82,82,2594,269,188,961,PF,42,108,754,CLE,.477
431,Marcus Thornton,143,.443,323,109,.345,316,77,26,11,141,252,.394,639,90,.804,112,72,27,1741,57,110,703,SG,58,67,198,TOT,.480
432,Jamaal Tinsley,3,.600,5,1,.067,15,23,35,0,9,4,.200,20,0,,0,8,5,110,2,10,9,PG,2,9,11,UTA,.225
433,Anthony Tolliver,27,.450,60,102,.413,247,42,28,15,135,129,.420,307,33,.805,41,64,9,1298,33,82,393,PF,19,23,168,CHA,.586
434,P.J. Tucker,191,.450,424,74,.387,191,141,28,23,368,265,.431,615,156,.776,201,81,81,2490,161,204,760,SF,110,102,529,PHO,.491
435,Ronny Turiaf,64,.598,107,0,,0,24,31,50,119,64,.598,107,21,.420,50,31,10,606,55,65,149,C,8,24,174,MIN,.598
436,Hedo Turkoglu,20,.339,59,22,.440,50,33,34,10,78,42,.385,109,9,.500,18,38,0,392,11,50,115,SF,19,16,89,LAC,.486
437,Evan Turner,384,.444,865,50,.321,156,262,25,7,346,434,.425,1021,213,.813,262,81,56,2457,62,195,1131,SF,67,189,408,TOT,.450
438,Jeremy Tyler,60,.517,116,0,,0,8,22,20,71,60,.517,116,26,.542,48,41,0,398,38,70,146,C,6,26,109,NYK,.517
439,Ekpe Udoh,57,.399,143,0,,0,31,26,44,87,57,.399,143,30,.638,47,42,14,804,61,96,144,PF,15,38,148,MIL,.399
440,Beno Udrih,59,.434,136,19,.452,42,116,31,4,49,78,.438,178,25,.833,30,41,12,643,10,50,200,SG,23,47,59,TOT,.492
441,Jonas Valanciunas,359,.532,675,0,.000,1,57,21,71,488,359,.531,676,198,.762,260,81,81,2282,226,249,916,C,24,136,714,TOR,.531
442,Anderson Varejao,227,.502,452,0,.000,7,140,31,39,442,227,.495,459,92,.681,135,65,29,1800,187,164,546,C,69,72,629,CLE,.495
443,Jarvis Varnado,36,.600,60,0,,0,13,25,29,44,36,.600,60,27,.519,52,24,0,339,19,62,99,PF,10,10,63,TOT,.600
444,Greivis Vasquez,168,.455,369,109,.377,289,323,27,5,153,277,.421,658,95,.880,108,79,23,1779,20,143,758,SG-PG,31,128,173,TOT,.504
445,Jan Vesely,89,.514,173,0,,0,21,23,35,110,89,.514,173,19,.339,56,54,1,776,81,121,197,PF,53,36,191,TOT,.514
446,Charlie Villanueva,21,.583,36,14,.250,56,6,29,5,28,35,.380,92,8,.571,14,20,0,180,6,16,92,PF,4,7,34,DET,.457
447,Nikola Vucevic,353,.507,696,0,,0,104,23,47,441,353,.507,696,105,.766,137,57,57,1812,185,169,811,C,60,112,626,ORL,.507
448,Sasha Vujacic,1,.333,3,1,.500,2,0,29,0,3,2,.400,5,0,,0,2,0,10,0,1,5,SG,1,3,3,LAC,.500
449,Dwyane Wade,406,.557,729,9,.281,32,252,32,29,181,415,.545,761,189,.733,258,54,53,1775,60,106,1028,SG,79,161,241,MIA,.551
450,Dion Waiters,338,.455,743,92,.368,250,209,22,17,163,430,.433,993,161,.685,235,70,24,2072,32,153,1113,SG,63,154,195,CLE,.479
451,Kemba Walker,340,.417,816,109,.333,327,447,23,32,267,449,.393,1143,282,.837,337,73,73,2614,39,128,1289,PG,86,169,306,CHA,.441
452,John Wall,471,.458,1029,108,.351,308,721,23,40,295,579,.433,1337,317,.805,394,82,82,2980,38,219,1583,PG,149,295,333,WAS,.473
453,Gerald Wallace,97,.584,166,19,.297,64,143,31,14,176,116,.504,230,47,.465,101,58,16,1416,36,79,298,SF,73,97,212,BOS,.546
454,Casper Ware,11,.524,21,7,.333,21,10,24,0,9,18,.429,42,5,.833,6,9,0,116,0,11,48,PG,8,5,9,PHI,.512
455,C.J. Watson,93,.492,189,53,.366,145,107,29,8,82,146,.437,334,69,.784,88,63,5,1193,19,66,414,PG,60,60,101,IND,.516
456,Earl Watson,1,.250,4,2,.286,7,28,34,1,10,3,.273,11,4,1.000,4,24,0,161,5,33,12,PG,5,17,15,POR,.364
457,Maalik Wayns,1,.500,2,0,,0,2,22,0,2,1,.500,2,0,,0,2,0,9,0,4,2,PG,2,0,2,LAC,.500
458,Martell Webster,108,.502,215,146,.392,372,97,27,15,184,254,.433,587,105,.840,125,78,13,2157,38,150,759,SF,41,58,222,WAS,.557
459,David West,454,.491,924,4,.267,15,223,33,74,422,458,.488,939,198,.789,251,80,80,2472,120,186,1118,PF,61,133,542,IND,.490
460,Russell Westbrook,278,.482,577,68,.318,214,319,25,7,208,346,.437,791,242,.826,293,46,46,1412,55,104,1002,PG,88,177,263,OKC,.480
461,D.J. White,0,.000,1,0,,0,0,27,0,2,0,.000,1,0,,0,2,0,10,0,1,0,PF,1,0,2,CHA,.000
462,Royce White,0,.000,1,0,,0,0,22,0,0,0,.000,1,0,,0,3,0,9,0,2,0,PF,0,0,0,SAC,.000
463,Deron Williams,224,.500,448,98,.366,268,392,29,13,153,322,.450,716,173,.801,216,64,58,2059,15,148,915,PG,93,143,168,BRK,.518
464,Derrick Williams,180,.470,383,26,.263,99,56,22,20,252,206,.427,482,186,.718,259,78,15,1820,71,114,624,SF-PF,48,76,323,TOT,.454
465,Elliot Williams,103,.486,212,37,.296,125,72,24,3,100,140,.415,337,87,.731,119,67,2,1157,30,126,404,SG,35,68,130,PHI,.470
466,Lou Williams,118,.450,262,79,.342,231,210,27,4,114,197,.400,493,152,.849,179,60,7,1445,10,65,625,PG,45,92,124,ATL,.480
467,Marvin Williams,147,.503,292,84,.359,234,78,27,31,252,231,.439,526,57,.781,73,66,50,1674,82,151,603,PF,54,53,334,UTA,.519
468,Mo Williams,197,.441,447,83,.369,225,321,31,10,111,280,.417,672,78,.876,89,74,0,1834,42,197,721,PG,55,149,153,POR,.478
469,Reggie Williams,4,.667,6,1,.333,3,1,27,0,0,5,.556,9,0,,0,3,0,17,0,1,11,SF,1,2,0,OKC,.611
470,Shawne Williams,31,.492,63,42,.326,129,30,27,30,142,73,.380,192,14,.700,20,36,13,751,25,93,202,PF,19,21,167,LAL,.490
471,Jeff Withey,69,.539,128,0,.000,1,26,23,50,101,69,.535,129,52,.712,73,58,4,684,49,73,190,C,15,20,150,NOP,.535
472,Nate Wolters,152,.465,327,18,.290,62,187,22,15,116,170,.437,389,59,.656,90,58,31,1309,33,67,417,PG,35,57,149,MIL,.460
473,Metta World Peace,39,.448,87,17,.315,54,17,34,8,41,56,.397,141,10,.625,16,29,1,388,18,44,139,SF,24,19,59,NYK,.457
474,Brandan Wright,224,.677,331,0,,0,31,26,55,142,224,.677,331,77,.726,106,58,0,1077,102,94,525,C,32,35,244,DAL,.677
475,Chris Wright,21,.618,34,0,.000,1,5,25,5,10,21,.600,35,6,.400,15,8,0,126,10,17,48,SF,7,5,20,MIL,.600
476,Dorell Wright,42,.442,95,69,.342,202,64,28,16,162,111,.374,297,52,.754,69,68,13,984,29,62,343,SF,23,39,191,POR,.490
477,Tony Wroten,305,.492,620,40,.213,188,217,20,16,159,345,.427,808,209,.641,326,72,16,1765,69,151,939,PG,78,204,228,PHI,.452
478,Nick Young,252,.468,539,135,.386,350,95,28,12,137,387,.435,889,235,.825,285,64,9,1810,29,156,1144,SG,46,95,166,LAL,.511
479,Thaddeus Young,492,.496,991,90,.308,292,182,25,36,310,582,.454,1283,163,.712,229,79,78,2718,166,213,1417,PF,167,165,476,PHI,.489
480,Cody Zeller,172,.427,403,0,.000,1,92,21,41,235,172,.426,404,146,.730,200,82,3,1416,118,170,490,C,40,87,353,CHA,.426
481,Tyler Zeller,156,.540,289,0,.000,1,36,24,38,179,156,.538,290,87,.719,121,70,9,1049,103,137,399,C,18,60,282,CLE,.538
