,Player_Name,2P,2P%,2PA,3P,3P%,3PA,AST,Age,BLK,DRB,FG,FG%,FGA,FT,FT%,FTA,Games,Games_Strated,Minutes_Played,ORB,PF,PTS,Position,STL,TOV,TRB,Team,eFG%
0,Quincy Acy,134,.494,271,18,.300,60,68,24,22,222,152,.459,331,76,.784,97,68,22,1287,79,147,398,PF,27,60,301,NYK,.486
1,Jordan Adams,25,.410,61,10,.400,25,16,20,7,19,35,.407,86,14,.609,23,30,0,248,9,24,94,SG,16,14,28,MEM,.465
2,Steven Adams,217,.547,397,0,.000,2,66,21,86,324,217,.544,399,103,.502,205,70,67,1771,199,222,537,C,38,99,523,OKC,.544
3,Jeff Adrien,19,.432,44,0,,0,15,28,9,54,19,.432,44,22,.579,38,17,0,215,23,30,60,PF,4,9,77,MIN,.432
4,Arron Afflalo,257,.466,551,118,.354,333,129,29,7,220,375,.424,884,167,.843,198,78,72,2502,27,167,1035,SG,41,116,247,TOT,.491
5,Alexis Ajinca,181,.550,329,0,,0,47,26,51,211,181,.550,329,81,.818,99,68,8,957,104,151,443,C,21,69,315,NOP,.550
6,Furkan Aldemir,40,.548,73,0,.000,5,28,23,16,98,40,.513,78,13,.481,27,41,9,540,78,96,93,PF,17,17,176,PHI,.513
7,Cole Aldrich,144,.478,301,0,,0,75,26,65,237,144,.478,301,50,.781,64,61,16,976,101,122,338,C,37,59,338,NYK,.478
8,LaMarcus Aldridge,622,.475,1310,37,.352,105,124,29,68,549,659,.466,1415,306,.845,362,71,71,2512,177,125,1661,PF,48,122,726,POR,.479
9,Lavoy Allen,141,.472,299,0,,0,73,25,42,200,141,.472,299,33,.702,47,63,0,1070,123,102,315,C,15,40,323,IND,.472
10,Tony Allen,215,.505,426,10,.345,29,86,33,30,177,225,.495,455,79,.627,126,63,41,1648,103,166,539,SG,129,86,280,MEM,.505
11,Al-Farouq Aminu,113,.485,233,34,.274,124,59,24,62,228,147,.412,357,84,.712,118,74,3,1366,114,137,412,SF,70,55,342,DAL,.459
12,Lou Amundson,109,.429,254,0,.000,1,70,32,52,174,109,.427,255,41,.471,87,53,35,937,94,126,259,PF,22,62,268,TOT,.427
13,Chris Andersen,116,.598,194,4,.308,13,43,36,61,223,120,.580,207,76,.667,114,60,20,1132,76,88,320,C,26,40,299,MIA,.589
14,Alan Anderson,122,.530,230,73,.348,210,83,32,5,173,195,.443,440,82,.812,101,74,19,1744,31,148,545,SG,56,60,204,BRK,.526
15,Kyle Anderson,28,.359,78,3,.273,11,28,21,7,67,31,.348,89,9,.643,14,33,8,358,5,28,74,SF,15,10,72,SAS,.365
16,Ryan Anderson,169,.457,370,122,.340,359,55,26,20,187,291,.399,729,129,.854,151,61,5,1675,108,113,833,PF,33,62,295,NOP,.483
17,Giannis Antetokounmpo,376,.511,736,7,.159,44,207,20,85,442,383,.491,780,257,.741,347,81,71,2541,100,254,1030,SG,73,173,542,MIL,.496
18,Carmelo Anthony,297,.474,627,61,.341,179,122,30,17,192,358,.444,806,189,.797,237,40,40,1428,72,87,966,SF,40,89,264,NYK,.482
19,Joel Anthony,36,.581,62,0,,0,5,32,49,61,36,.581,62,15,.682,22,49,0,406,32,55,87,C,12,12,93,DET,.581
20,Pero Antic,56,.455,123,52,.301,173,49,32,14,131,108,.365,296,88,.715,123,63,3,1037,58,132,356,C,18,49,189,ATL,.453
21,Trevor Ariza,172,.485,355,194,.350,555,209,29,17,382,366,.402,910,122,.853,143,82,82,2930,77,186,1048,SF,152,141,459,HOU,.509
22,Darrell Arthur,129,.471,274,26,.236,110,57,26,26,118,155,.404,384,46,.780,59,58,4,988,53,146,382,PF,48,47,171,DEN,.438
23,Omer Asik,213,.517,412,0,,0,72,28,54,504,213,.517,412,131,.582,225,76,76,1982,244,144,557,C,29,95,748,NOP,.517
24,D.J. Augustin,175,.436,401,83,.337,246,353,27,3,141,258,.399,647,178,.868,205,82,14,1964,20,93,777,PG,49,145,161,TOT,.463
25,Jeff Ayres,55,.579,95,0,,0,14,27,8,80,55,.579,95,27,.750,36,51,0,383,37,60,137,PF,8,26,117,SAS,.579
26,Luke Babbitt,33,.429,77,59,.513,115,24,25,11,99,92,.479,192,13,.684,19,63,19,830,12,63,256,SF,17,26,111,NOP,.633
27,Cameron Bairstow,3,.214,14,0,,0,1,24,1,2,3,.214,14,4,.800,5,18,1,64,6,8,10,PF,2,3,8,CHI,.214
28,Leandro Barbosa,140,.511,274,43,.384,112,99,32,8,68,183,.474,386,58,.784,74,66,1,982,23,87,467,SG,41,44,91,GSW,.530
29,J.J. Barea,171,.463,369,54,.323,167,263,30,1,111,225,.420,536,76,.809,94,77,10,1362,23,104,580,PG,33,70,134,DAL,.470
30,Andrea Bargnani,149,.466,320,15,.366,41,46,29,27,95,164,.454,361,87,.813,107,29,22,785,32,53,430,C,2,42,127,NYK,.475
31,Harrison Barnes,229,.519,441,87,.405,215,116,22,19,336,316,.482,656,108,.720,150,82,82,2318,117,146,827,SF,61,71,453,GSW,.548
32,Matt Barnes,141,.569,248,136,.362,376,114,34,50,251,277,.444,624,74,.779,95,76,74,2271,51,240,764,SF,67,87,302,LAC,.553
33,Earl Barron,10,.286,35,2,.500,4,5,33,2,14,12,.308,39,6,.500,12,16,1,143,14,26,32,C,4,5,28,PHO,.333
34,Will Barton,127,.474,268,23,.271,85,81,24,19,136,150,.425,353,74,.787,94,58,0,983,26,70,397,SG,48,61,162,TOT,.458
35,Brandon Bass,335,.515,651,9,.281,32,104,29,32,259,344,.504,683,169,.790,214,82,43,1929,139,140,866,PF,41,83,398,BOS,.510
36,Nicolas Batum,140,.481,291,100,.324,309,341,26,40,354,240,.400,600,84,.857,98,71,71,2380,62,106,664,SF,78,132,416,POR,.483
37,Jerryd Bayless,183,.462,396,37,.308,120,233,26,12,189,220,.426,516,121,.883,137,77,4,1717,22,163,598,PG,59,133,211,MIL,.462
38,Aron Baynes,184,.570,323,1,.250,4,35,28,22,209,185,.566,327,90,.865,104,70,17,1122,109,162,461,C,16,65,318,SAS,.567
39,Kent Bazemore,93,.467,199,48,.364,132,78,25,33,201,141,.426,331,60,.600,100,75,10,1324,21,127,390,SG,52,73,222,ATL,.498
40,Bradley Beal,257,.434,592,106,.409,259,194,21,18,184,363,.427,851,130,.783,166,63,59,2107,57,136,962,SG,76,123,241,WAS,.489
41,Michael Beasley,84,.472,178,8,.235,34,32,26,13,77,92,.434,212,20,.769,26,24,1,505,12,66,212,PF,15,37,89,MIA,.453
42,Marco Belinelli,113,.471,240,86,.374,230,94,28,3,131,199,.423,470,84,.848,99,62,9,1388,26,85,568,SG,31,61,157,SAS,.515
43,Jerrelle Benimon,0,,0,0,,0,0,23,0,2,0,,0,0,,0,2,0,3,1,0,0,PF,0,1,3,UTA,
44,Anthony Bennett,118,.431,274,7,.304,23,48,21,16,164,125,.421,297,41,.641,64,57,3,894,52,87,298,PF,27,36,216,MIN,.433
45,Patrick Beverley,89,.426,209,115,.356,323,192,26,23,170,204,.383,532,45,.750,60,56,55,1727,67,182,568,PG,59,83,237,HOU,.492
46,Sim Bhullar,1,.500,2,0,,0,1,22,1,1,1,.500,2,0,,0,3,0,3,0,0,2,C,0,0,1,SAC,.500
47,Bismack Biyombo,101,.543,186,0,,0,16,22,99,248,101,.543,186,102,.583,175,64,21,1243,159,140,304,C,18,52,407,CHO,.543
48,Tarik Black,157,.577,272,0,.000,1,42,23,24,226,157,.575,273,65,.551,118,63,39,1196,142,158,379,C,19,48,368,TOT,.575
49,DeJuan Blair,26,.456,57,0,,0,3,25,1,40,26,.456,57,4,.667,6,29,0,180,16,41,56,PF,7,13,56,WAS,.456
50,Steve Blake,45,.417,108,77,.352,219,288,34,5,121,122,.373,327,29,.707,41,81,0,1529,16,118,350,PG,41,104,137,POR,.491
51,Eric Bledsoe,380,.491,774,88,.324,272,493,25,45,351,468,.447,1046,353,.800,441,81,81,2800,72,189,1377,PG,127,274,423,PHO,.489
52,Vander Blue,7,.350,20,2,.200,10,8,22,0,7,9,.300,30,2,.400,5,2,1,74,2,4,22,SG,3,6,9,LAL,.333
53,Bojan Bogdanovic,170,.531,320,91,.355,256,68,25,9,163,261,.453,576,87,.821,106,78,28,1854,50,104,700,SF,34,78,213,BRK,.532
54,Andrew Bogut,200,.563,355,0,,0,180,30,113,402,200,.563,355,22,.524,42,67,65,1583,141,188,422,C,39,106,543,GSW,.563
55,Matt Bonner,48,.462,104,46,.365,126,47,34,12,86,94,.409,230,30,.811,37,72,19,935,29,65,264,PF,10,11,115,SAS,.509
56,Trevor Booker,197,.518,380,29,.345,84,83,27,41,258,226,.487,464,86,.581,148,79,5,1564,139,144,567,PF,43,88,397,UTA,.518
57,Carlos Boozer,371,.499,743,0,,0,95,33,12,371,371,.499,743,94,.627,150,71,26,1692,111,184,836,PF,41,92,482,LAL,.499
58,Chris Bosh,280,.485,577,63,.375,168,95,30,25,264,343,.460,745,179,.772,232,44,44,1556,46,69,928,C,41,95,310,MIA,.503
59,Avery Bradley,310,.470,660,124,.352,352,135,24,15,195,434,.429,1012,79,.790,100,77,77,2428,46,177,1071,SG,82,109,241,BOS,.490
60,Elton Brand,42,.447,94,0,.000,1,22,35,25,72,42,.442,95,12,.522,23,36,4,486,28,54,96,C,17,18,100,ATL,.442
61,Corey Brewer,280,.491,570,63,.268,235,173,28,19,217,343,.426,805,168,.743,226,80,17,2087,80,173,917,SF,114,131,297,TOT,.465
62,Aaron Brooks,223,.442,504,121,.387,313,261,30,15,134,344,.421,817,145,.833,174,82,21,1885,32,189,954,PG,54,157,166,CHI,.495
63,Jabari Brown,47,.435,108,23,.371,62,40,22,2,33,70,.412,170,64,.753,85,19,5,568,3,33,227,SG,12,32,36,LAL,.479
64,Lorenzo Brown,46,.489,94,6,.214,28,90,24,6,56,52,.426,122,12,.632,19,29,7,549,14,49,122,PG,28,30,70,MIN,.451
65,Markel Brown,59,.404,146,17,.266,64,39,23,12,91,76,.362,210,47,.825,57,47,29,781,16,57,216,SG,31,27,107,BRK,.402
66,Shannon Brown,4,.333,12,3,.429,7,3,29,0,1,7,.368,19,3,.750,4,5,2,89,0,8,20,SG,4,4,1,MIA,.447
67,Kobe Bryant,212,.401,529,54,.293,184,197,36,7,173,266,.373,713,196,.813,241,35,35,1207,26,65,782,SG,47,128,199,LAL,.411
68,Chase Budinger,117,.474,247,52,.364,143,64,26,10,165,169,.433,390,67,.827,81,67,4,1286,33,72,457,SF,44,49,198,MIN,.500
69,Reggie Bullock,9,.375,24,15,.326,46,8,23,4,49,24,.343,70,6,.667,9,36,2,338,1,19,69,SF,10,8,50,TOT,.450
70,Trey Burke,246,.400,615,124,.318,390,328,22,15,173,370,.368,1005,109,.752,145,76,43,2288,31,119,973,PG,65,124,204,UTA,.430
71,Alec Burks,95,.409,232,26,.382,68,82,23,5,95,121,.403,300,106,.822,129,27,27,899,19,64,374,SG,17,52,114,UTA,.447
72,Caron Butler,78,.441,177,83,.379,219,79,34,4,175,161,.407,396,55,.902,61,78,21,1623,21,120,460,SF,43,49,196,DET,.511
73,Jimmy Butler,348,.484,719,73,.378,193,212,25,36,265,421,.462,912,386,.834,463,65,65,2513,114,108,1301,SG,114,93,379,CHI,.502
74,Rasual Butler,127,.450,282,91,.387,235,63,35,22,170,218,.422,517,53,.791,67,75,1,1505,27,98,580,SF,29,48,197,WAS,.510
75,Dwight Buycks,11,.379,29,7,.636,11,14,25,0,10,18,.450,40,9,.900,10,6,0,123,2,3,52,PG,3,12,12,LAL,.538
76,Will Bynum,10,.455,22,0,.000,9,18,32,1,4,10,.323,31,2,.500,4,7,0,67,2,9,22,SG,1,8,6,WAS,.323
77,Bruno Caboclo,2,.222,9,2,.667,3,0,19,1,1,4,.333,12,0,,0,8,0,23,1,3,10,SF,0,4,2,TOR,.417
78,Nick Calathes,93,.456,204,11,.256,43,146,25,5,87,104,.421,247,24,.533,45,58,0,838,19,100,243,SG,63,61,106,MEM,.443
79,Jose Calderon,88,.415,212,59,.415,142,198,33,0,105,147,.415,354,29,.906,32,42,42,1270,19,76,382,PG,31,75,124,NYK,.499
80,Kentavious Caldwell-Pope,237,.449,528,153,.345,444,109,21,18,209,390,.401,972,110,.696,158,82,82,2587,46,161,1043,SG,93,94,255,DET,.480
81,Isaiah Canaan,55,.417,132,91,.370,246,98,23,3,69,146,.386,378,49,.817,60,47,21,938,18,83,432,PG,29,62,87,TOT,.507
82,Clint Capela,14,.483,29,0,,0,2,20,9,26,14,.483,29,4,.174,23,12,0,90,10,14,32,C,1,5,36,HOU,.483
83,DeMarre Carroll,198,.567,349,120,.395,304,118,28,17,273,318,.487,653,127,.702,181,70,69,2189,99,154,883,SF,94,75,372,ATL,.579
84,Vince Carter,66,.379,174,69,.297,232,79,38,14,106,135,.333,406,45,.789,57,66,1,1091,27,102,384,SG,43,43,133,MEM,.417
85,Michael Carter-Williams,328,.428,766,36,.235,153,442,23,30,289,364,.396,919,202,.694,291,66,63,2149,64,167,966,PG,111,253,353,TOT,.416
86,Omri Casspi,174,.512,340,35,.402,87,102,26,9,206,209,.489,427,140,.733,191,67,19,1416,54,107,593,SF,31,88,260,SAC,.530
87,Mario Chalmers,194,.467,415,73,.294,248,307,28,10,182,267,.403,663,206,.774,266,80,37,2368,24,251,813,PG,122,173,206,MIA,.458
88,Tyson Chandler,293,.666,440,0,,0,84,32,91,570,293,.666,440,185,.720,257,75,75,2286,294,169,771,C,42,105,864,DAL,.666
89,Wilson Chandler,279,.490,569,139,.342,406,134,27,29,379,418,.429,975,110,.775,142,78,75,2471,96,231,1085,SF,58,110,475,DEN,.500
90,Will Cherry,3,.300,10,2,.222,9,8,23,1,4,5,.263,19,3,.500,6,8,0,69,1,10,15,PG,6,4,5,CLE,.316
91,Patrick Christopher,3,.375,8,0,.000,4,0,26,0,4,3,.250,12,0,,0,4,1,29,2,6,6,SG,1,1,6,UTA,.250
92,Earl Clark,7,.438,16,4,.286,14,3,27,4,22,11,.367,30,1,.250,4,10,0,93,1,12,27,PF,3,6,23,BRK,.433
93,Ian Clark,9,.360,25,10,.333,30,12,23,3,12,19,.345,55,9,1.000,9,30,0,192,4,20,57,SG,9,9,16,TOT,.436
94,Jordan Clarkson,229,.482,475,38,.314,121,206,22,12,135,267,.448,596,131,.829,158,59,38,1476,56,109,703,PG,51,96,191,LAL,.480
95,Victor Claver,3,.333,9,6,.545,11,1,26,1,17,9,.450,20,0,,0,10,0,76,3,12,24,SF,1,4,20,POR,.600
96,Norris Cole,175,.458,382,55,.313,176,255,26,15,146,230,.412,558,58,.716,81,75,25,1831,13,124,573,PG,57,99,159,TOT,.461
97,Darren Collison,200,.514,389,60,.373,161,252,27,14,124,260,.473,550,145,.788,184,45,45,1565,19,95,725,PG,67,112,143,SAC,.527
98,Nick Collison,90,.466,193,16,.267,60,90,34,25,160,106,.419,253,45,.692,65,66,2,1101,90,156,273,PF,35,45,250,OKC,.451
99,Mike Conley,286,.473,605,107,.386,277,375,27,14,180,393,.446,882,214,.859,249,70,70,2225,29,139,1107,PG,89,156,209,MEM,.506
100,Jack Cooley,9,.409,22,0,,0,1,23,3,15,9,.409,22,9,.429,21,16,0,87,10,23,27,PF,6,3,25,UTA,.409
101,Chris Copeland,60,.420,143,52,.311,167,51,30,11,88,112,.361,310,33,.733,45,50,12,828,23,78,309,SF,11,59,111,IND,.445
102,Bryce Cotton,22,.449,49,7,.350,20,15,22,0,15,29,.420,69,15,.833,18,15,0,159,3,6,80,PG,4,12,18,UTA,.471
103,DeMarcus Cousins,496,.469,1058,2,.250,8,210,24,103,562,498,.467,1066,423,.782,541,59,59,2013,185,241,1421,C,90,254,747,SAC,.468
104,Robert Covington,132,.426,310,167,.374,446,105,24,31,251,299,.396,756,178,.820,217,70,49,1956,65,189,943,SF,97,128,316,PHI,.506
105,Allen Crabbe,33,.485,68,30,.353,85,39,22,15,66,63,.412,153,12,.750,16,51,9,683,7,74,168,SG,19,15,73,POR,.510
106,Jamal Crawford,213,.448,475,119,.327,364,158,34,14,106,332,.396,839,227,.901,252,64,4,1703,18,108,1010,SG,59,92,124,LAC,.467
107,Jae Crowder,168,.499,337,61,.293,208,94,24,25,221,229,.420,545,109,.773,141,82,17,1647,72,137,628,SF,72,49,293,TOT,.476
108,Dante Cunningham,154,.468,329,1,.100,10,50,27,37,186,155,.457,339,29,.617,47,66,27,1652,70,101,340,PF,46,35,256,NOP,.459
109,Jared Cunningham,8,.400,20,4,.308,13,10,23,0,8,12,.364,33,7,.538,13,19,0,89,1,12,35,SG,3,7,9,LAC,.424
110,Seth Curry,0,.000,2,0,.000,1,1,24,0,2,0,.000,3,0,,0,2,0,8,0,2,0,PG,0,0,2,PHO,.000
111,Stephen Curry,367,.528,695,286,.443,646,619,26,16,285,653,.487,1341,308,.914,337,80,80,2613,56,158,1900,PG,163,249,341,GSW,.594
112,Samuel Dalembert,57,.438,130,0,,0,29,33,41,115,57,.438,130,14,.700,20,32,21,544,53,70,128,C,14,39,168,NYK,.438
113,Troy Daniels,18,.383,47,43,.364,118,22,23,1,25,61,.370,165,11,.846,13,47,0,397,8,40,176,SG,6,20,33,TOT,.500
114,Luigi Datome,25,.510,49,18,.450,40,9,27,7,26,43,.483,89,1,1.000,1,21,1,209,3,15,105,SF,2,9,29,TOT,.584
115,Brandon Davies,47,.456,103,8,.235,34,30,23,7,45,55,.401,137,24,.649,37,27,6,423,38,59,142,PF,18,29,83,TOT,.431
116,Anthony Davis,641,.540,1187,1,.083,12,149,21,200,523,642,.535,1199,371,.805,461,68,68,2455,173,141,1656,PF,100,95,696,NOP,.536
117,Ed Davis,282,.601,469,0,,0,94,25,98,370,282,.601,469,92,.487,189,79,24,1840,230,202,656,PF,49,58,600,LAL,.601
118,Glen Davis,117,.466,251,0,.000,4,39,29,21,126,117,.459,255,60,.632,95,74,0,904,43,132,294,PF,41,39,169,LAC,.459
119,Andre Dawkins,0,,0,1,.167,6,1,23,0,2,1,.167,6,0,,0,4,0,22,0,3,3,SG,0,1,2,MIA,.250
120,Austin Daye,26,.371,70,24,.338,71,17,26,5,65,50,.355,141,5,.833,6,34,4,344,10,39,129,SF,12,23,75,TOT,.440
121,Dewayne Dedmon,91,.565,161,0,.000,1,9,25,50,177,91,.562,162,34,.531,64,59,15,845,118,141,216,C,16,51,295,ORL,.562
122,Matthew Dellavedova,43,.307,140,68,.407,167,204,24,2,89,111,.362,307,29,.763,38,67,13,1380,37,152,319,SG,24,61,126,CLE,.472
123,Luol Deng,291,.513,567,78,.355,220,139,29,22,273,369,.469,787,191,.761,251,72,72,2421,103,109,1007,SF,65,108,376,MIA,.518
124,DeMar DeRozan,384,.426,902,25,.284,88,210,25,11,236,409,.413,990,361,.832,434,60,60,2100,41,122,1204,SG,73,137,277,TOR,.426
125,Boris Diaw,237,.512,463,54,.320,169,233,32,23,270,291,.460,632,72,.774,93,81,15,1984,78,148,708,PF,36,126,348,SAS,.503
126,Gorgui Dieng,258,.510,506,1,.167,6,146,25,126,386,259,.506,512,191,.783,244,73,49,2193,223,188,710,C,71,126,609,MIN,.507
127,Spencer Dinwiddie,39,.375,104,12,.185,65,104,21,6,44,51,.302,169,31,.912,34,34,1,455,4,53,145,PG,19,33,48,DET,.337
128,Joey Dorsey,80,.556,144,0,.000,1,25,31,25,176,80,.552,145,24,.289,83,69,17,854,103,157,184,PF,40,41,279,HOU,.552
129,Toney Douglas,14,.424,33,5,.278,18,24,28,4,20,19,.373,51,8,.615,13,12,0,177,2,20,51,SG,11,10,22,NOP,.422
130,Chris Douglas-Roberts,4,.286,14,1,.143,7,4,28,0,11,5,.238,21,8,1.000,8,12,0,103,1,14,19,SG,1,0,12,LAC,.262
131,Goran Dragic,412,.555,743,90,.347,259,350,28,15,193,502,.501,1002,181,.774,234,78,78,2640,81,195,1275,SG-PG,78,173,274,TOT,.546
132,Zoran Dragic,8,.500,16,3,.214,14,5,25,0,3,11,.367,30,3,.600,5,16,1,75,5,6,28,SG,2,5,8,TOT,.417
133,Larry Drew,16,.500,32,4,.154,26,45,24,0,14,20,.345,58,2,.667,3,12,1,219,1,13,46,PG,6,25,15,PHI,.379
134,Andre Drummond,494,.515,959,0,.000,2,55,21,153,667,494,.514,961,142,.389,365,82,82,2502,437,285,1130,C,73,120,1104,DET,.514
135,Jared Dudley,124,.537,231,74,.385,192,130,29,11,175,198,.468,423,48,.716,67,72,22,1717,45,113,518,SG,72,62,220,MIL,.556
136,Tim Duncan,417,.514,812,2,.286,7,230,38,151,534,419,.512,819,230,.740,311,77,77,2227,170,165,1070,C,63,131,704,SAS,.513
137,Mike Dunleavy,102,.468,218,107,.407,263,114,34,21,220,209,.435,481,70,.805,87,63,63,1838,28,123,595,SF,39,60,248,CHI,.546
138,Kevin Durant,174,.565,308,64,.403,159,110,26,25,162,238,.510,467,146,.854,171,27,27,913,16,40,686,SF,24,74,178,OKC,.578
139,Cleanthony Early,54,.415,130,22,.262,84,36,23,12,75,76,.355,214,36,.750,48,39,7,647,22,57,210,SF,24,40,97,NYK,.407
140,Wayne Ellington,164,.439,374,90,.370,243,105,27,2,179,254,.412,617,52,.813,64,65,36,1675,31,77,650,SG,33,50,210,LAL,.485
141,Monta Ellis,521,.487,1070,81,.285,284,329,29,25,156,602,.445,1354,228,.752,303,80,80,2699,34,197,1513,SG,148,198,190,DAL,.475
142,James Ennis,70,.461,152,31,.326,95,48,24,17,125,101,.409,247,79,.840,94,62,3,1051,51,89,312,SF,25,39,176,MIA,.472
143,Tyler Ennis,40,.396,101,12,.279,43,73,20,5,28,52,.361,144,5,.714,7,33,1,411,7,36,121,PG,18,42,35,TOT,.403
144,Jeremy Evans,30,.566,53,2,.400,5,13,27,12,45,32,.552,58,24,.828,29,38,0,266,26,29,90,SF,11,5,71,UTA,.569
145,Reggie Evans,58,.430,135,0,.000,2,32,34,5,202,58,.423,137,60,.619,97,47,7,764,97,91,176,PF,22,45,299,SAC,.423
146,Tyreke Evans,452,.482,938,69,.304,227,521,25,37,334,521,.447,1165,202,.694,291,79,76,2690,82,198,1313,SG,100,246,416,NOP,.477
147,Dante Exum,62,.408,152,83,.314,264,198,19,14,104,145,.349,416,20,.625,32,82,41,1817,27,147,393,PG,41,118,131,UTA,.448
148,Festus Ezeli,76,.547,139,0,,0,9,25,42,95,76,.547,139,49,.628,78,46,7,504,60,77,201,C,7,32,155,GSW,.547
149,Kenneth Faried,372,.511,728,1,.125,8,89,25,57,426,373,.507,736,199,.691,288,75,71,2086,242,211,946,PF,62,118,668,DEN,.507
150,Jordan Farmar,26,.426,61,35,.361,97,67,28,5,34,61,.386,158,10,.909,11,36,0,529,8,52,167,PG,20,32,42,LAC,.497
151,Derrick Favors,481,.527,912,1,.167,6,112,23,123,411,482,.525,918,222,.669,332,74,74,2280,196,210,1187,PF,60,121,607,UTA,.526
152,Raymond Felton,33,.458,72,10,.294,34,41,30,4,24,43,.406,106,12,.800,15,29,3,281,2,17,108,PG,11,18,26,DAL,.453
153,Landry Fields,19,.487,39,1,.500,2,15,26,0,16,20,.488,41,5,.833,6,26,9,216,10,9,46,SF,11,8,26,TOR,.500
154,Evan Fournier,168,.480,350,85,.378,225,120,22,2,125,253,.440,575,107,.728,147,58,32,1661,28,116,698,SG,40,82,153,ORL,.514
155,Randy Foye,54,.388,139,94,.357,263,119,31,11,76,148,.368,402,45,.818,55,50,21,1087,9,97,435,SG,34,60,85,DEN,.485
156,Jamaal Franklin,0,,0,1,.500,2,3,23,1,1,1,.500,2,0,,0,3,0,13,1,4,3,SG,0,3,2,DEN,.750
157,Tim Frazier,16,.364,44,5,.294,17,60,24,0,22,21,.344,61,10,.476,21,11,3,239,6,26,57,PG,8,25,28,TOT,.385
158,Jimmer Fredette,54,.458,118,9,.188,48,58,25,2,32,63,.380,166,43,.956,45,50,0,509,8,43,178,PG,15,33,40,NOP,.407
159,Joel Freeland,74,.490,151,0,,0,16,27,23,129,74,.490,151,21,.840,25,48,8,617,62,93,169,C,9,23,191,POR,.490
160,Channing Frye,55,.390,141,136,.393,346,94,31,39,266,191,.392,487,31,.886,35,75,51,1870,27,191,549,PF,47,78,293,ORL,.532
161,Danilo Gallinari,121,.453,267,107,.355,301,83,26,20,187,228,.401,568,171,.895,191,59,27,1426,31,94,734,SF,47,57,218,DEN,.496
162,Langston Galloway,142,.424,335,62,.352,176,150,23,12,153,204,.399,511,63,.808,78,45,41,1457,37,129,533,PG,52,61,190,NYK,.460
163,Francisco Garcia,7,.389,18,10,.222,45,15,33,5,14,17,.270,63,1,.250,4,14,0,200,3,20,45,SF,9,10,17,HOU,.349
164,Kevin Garnett,142,.475,299,1,.143,7,77,38,17,263,143,.467,306,36,.800,45,47,47,952,48,109,323,PF,46,46,311,TOT,.469
165,Marc Gasol,527,.500,1055,3,.176,17,307,30,131,515,530,.494,1072,350,.795,440,81,81,2687,115,208,1413,C,70,176,630,MEM,.496
166,Pau Gasol,558,.495,1127,12,.462,26,210,34,147,699,570,.494,1153,294,.803,366,78,78,2681,220,147,1446,PF,25,158,919,CHI,.500
167,Rudy Gay,429,.479,896,79,.359,220,250,28,41,301,508,.455,1116,337,.858,393,68,67,2408,98,157,1432,SF,71,183,399,SAC,.491
168,Alonzo Gee,74,.490,151,13,.371,35,25,27,7,57,87,.468,186,54,.701,77,54,2,662,37,58,241,SF,35,33,94,TOT,.503
169,Paul George,9,.333,27,9,.409,22,6,24,1,18,18,.367,49,8,.727,11,6,0,91,4,11,53,SF,5,12,22,IND,.459
170,Taj Gibson,254,.502,506,0,,0,71,29,75,234,254,.502,506,132,.717,184,62,17,1692,162,162,640,PF,36,77,396,CHI,.502
171,Manu Ginobili,162,.489,331,89,.345,258,293,37,20,183,251,.426,589,147,.721,204,70,0,1587,28,138,738,SG,67,154,211,SAS,.502
172,Rudy Gobert,258,.607,425,0,.000,2,109,22,189,510,258,.604,427,170,.623,273,82,37,2158,265,175,686,C,64,111,775,UTA,.604
173,Drew Gooden,87,.401,217,23,.390,59,49,33,9,151,110,.399,276,34,.773,44,51,7,864,72,91,277,PF,21,28,223,WAS,.440
174,Archie Goodwin,67,.419,160,12,.293,41,44,20,9,47,79,.393,201,61,.735,83,41,2,535,27,55,231,SG,18,48,74,PHO,.423
175,Aaron Gordon,80,.500,160,13,.271,48,33,19,22,123,93,.447,208,44,.721,61,47,8,797,46,83,243,PF,21,38,169,ORL,.478
176,Ben Gordon,94,.475,198,35,.361,97,50,31,1,57,129,.437,295,56,.836,67,56,0,790,6,60,349,SG,14,55,63,ORL,.497
177,Drew Gordon,8,.500,16,0,.000,3,2,24,0,11,8,.421,19,1,.500,2,9,0,71,7,7,17,PF,1,8,18,PHI,.421
178,Eric Gordon,144,.380,379,141,.448,315,229,26,14,131,285,.411,694,107,.805,133,61,60,2018,28,145,818,SG,50,122,159,NOP,.512
179,Marcin Gortat,439,.569,772,0,.000,3,97,30,110,537,439,.566,775,123,.703,175,82,82,2453,180,191,1001,C,49,100,717,WAS,.566
180,Danny Granger,35,.449,78,30,.357,84,17,31,6,60,65,.401,162,28,.757,37,30,6,613,20,67,188,SF,13,24,80,MIA,.494
181,Jerami Grant,75,.383,196,49,.314,156,79,20,68,149,124,.352,352,114,.591,193,65,11,1377,49,144,411,SF,40,85,198,PHI,.422
182,Danny Green,131,.466,281,191,.418,457,158,27,87,289,322,.436,738,111,.874,127,81,80,2312,54,163,946,SG,101,93,343,SAS,.566
183,Draymond Green,228,.523,436,111,.337,329,291,24,99,533,339,.443,765,132,.660,200,79,79,2490,114,253,921,PF,123,133,647,GSW,.516
184,Erick Green,47,.409,115,14,.298,47,39,23,0,24,61,.377,162,10,.833,12,43,1,410,7,26,146,PG,12,14,31,DEN,.420
185,Gerald Green,187,.478,391,137,.354,387,91,29,12,153,324,.416,778,99,.825,120,74,4,1446,33,145,884,SG,42,104,186,PHO,.504
186,JaMychal Green,27,.659,41,0,.000,6,4,24,5,26,27,.574,47,8,.800,10,24,1,164,19,25,62,PF,5,14,45,TOT,.574
187,Jeff Green,319,.473,675,97,.332,292,134,28,34,264,416,.430,967,239,.833,287,78,70,2454,64,147,1168,SF,53,108,328,TOT,.480
188,Willie Green,76,.411,185,42,.347,121,68,33,5,65,118,.386,306,28,.824,34,52,2,951,14,81,306,SG,26,48,79,ORL,.454
189,Blake Griffin,564,.504,1119,10,.400,25,354,25,35,382,574,.502,1144,311,.728,427,67,67,2356,126,196,1469,PF,63,152,508,LAC,.506
190,Jorge Gutierrez,22,.579,38,0,.000,3,22,26,0,20,22,.537,41,9,.692,13,20,1,175,5,25,53,PG,6,12,25,TOT,.537
191,P.J. Hairston,38,.358,106,49,.301,163,21,22,13,70,87,.323,269,31,.861,36,45,2,687,22,61,254,SG,21,22,92,CHO,.414
192,Jordan Hamilton,4,.286,14,10,.476,21,7,24,0,14,14,.400,35,0,,0,14,2,122,2,14,38,SF,2,4,16,LAC,.543
193,Justin Hamilton,75,.510,147,10,.323,31,36,24,30,77,85,.478,178,39,.830,47,41,14,712,57,70,219,C,27,26,134,TOT,.506
194,Tyler Hansbrough,85,.538,158,1,.143,7,21,29,15,159,86,.521,165,97,.698,139,74,8,1058,106,141,270,PF,30,20,265,TOR,.524
195,Tim Hardaway,158,.435,363,121,.342,354,127,22,14,144,279,.389,717,125,.801,156,70,30,1681,12,119,804,SG,20,82,156,NYK,.474
196,James Harden,439,.480,915,208,.375,555,565,25,60,384,647,.440,1470,715,.868,824,81,81,2981,75,208,2217,SG,154,321,459,HOU,.511
197,Maurice Harkless,53,.520,102,10,.179,56,25,21,9,68,63,.399,158,22,.537,41,45,4,674,38,66,158,SF,32,27,106,ORL,.430
198,Devin Harris,124,.481,258,95,.357,266,237,31,14,122,219,.418,524,132,.815,162,76,3,1685,13,147,665,PG,78,85,135,DAL,.509
199,Gary Harris,45,.395,114,21,.204,103,29,20,7,43,66,.304,217,35,.745,47,55,6,719,21,71,188,SG,39,38,64,DEN,.353
200,Joe Harris,17,.472,36,31,.369,84,26,23,2,34,48,.400,120,9,.600,15,51,1,493,7,62,136,SG,7,27,41,CLE,.529
201,Tobias Harris,355,.500,710,87,.364,239,124,22,36,357,442,.466,949,193,.788,245,68,63,2369,73,134,1164,SF,69,115,430,ORL,.512
202,Udonis Haslem,105,.459,229,2,.200,10,46,34,13,187,107,.448,239,45,.703,64,62,25,995,71,113,261,PF,21,41,258,MIA,.452
203,Spencer Hawes,108,.452,239,55,.313,176,88,26,53,228,163,.393,415,44,.647,68,73,15,1274,30,173,425,PF,24,61,258,LAC,.459
204,Chuck Hayes,22,.478,46,0,,0,20,31,4,33,22,.478,46,6,.545,11,29,0,255,18,37,50,C,10,8,51,TOR,.478
205,Gordon Hayward,364,.481,757,120,.364,330,313,24,30,319,484,.445,1087,375,.812,462,76,76,2618,54,131,1463,SF,108,206,373,UTA,.500
206,Brendan Haywood,14,.467,30,0,,0,2,35,10,23,14,.467,30,7,.538,13,22,1,119,6,17,35,C,2,10,29,CLE,.467
207,Gerald Henderson,325,.457,711,45,.331,136,206,27,22,237,370,.437,847,184,.848,217,80,72,2315,36,135,969,SG,51,110,273,CHO,.463
208,Xavier Henry,3,.231,13,0,,0,3,23,0,2,3,.231,13,14,.583,24,9,0,86,2,6,20,SF,3,3,4,LAL,.231
209,John Henson,196,.566,346,0,,0,59,24,135,188,196,.566,346,78,.569,137,67,11,1228,124,152,470,C,28,87,312,MIL,.566
210,Roy Hibbert,317,.448,708,0,.000,2,84,28,125,384,317,.446,710,168,.824,204,76,76,1926,156,216,802,C,18,107,540,IND,.446
211,J.J. Hickson,218,.477,457,0,.000,2,57,26,35,302,218,.475,459,116,.577,201,73,8,1411,150,136,552,C,36,96,452,DEN,.475
212,Nene Hilario,306,.513,596,1,.200,5,123,32,22,261,307,.511,601,122,.604,202,67,58,1693,84,180,737,PF,66,124,345,WAS,.512
213,George Hill,186,.544,342,69,.358,193,220,28,14,154,255,.477,535,113,.790,143,43,36,1267,25,111,692,PG,44,69,179,IND,.541
214,Jordan Hill,354,.462,766,3,.273,11,103,27,52,382,357,.459,777,124,.738,168,70,57,1874,174,164,841,C,34,106,556,LAL,.461
215,Solomon Hill,183,.430,426,68,.327,208,184,23,18,244,251,.396,634,159,.824,193,82,78,2381,70,177,729,SF,66,115,314,IND,.450
216,Kirk Hinrich,84,.394,213,58,.345,168,148,34,14,101,142,.373,381,35,.700,50,66,22,1610,20,144,377,SG,46,73,121,CHI,.449
217,Jrue Holiday,187,.469,399,51,.378,135,274,24,23,103,238,.446,534,65,.855,76,40,37,1303,32,110,592,PG,63,91,135,NOP,.493
218,Justin Holiday,56,.444,126,35,.321,109,48,25,12,61,91,.387,235,37,.822,45,59,4,657,12,54,254,SG,40,29,73,GSW,.462
219,Ryan Hollins,53,.646,82,0,,0,14,30,19,67,53,.646,82,31,.574,54,46,9,441,36,65,137,C,6,25,103,SAC,.646
220,Rodney Hood,93,.456,204,62,.365,170,83,22,12,108,155,.414,374,61,.763,80,50,21,1064,9,119,433,SG,30,45,117,UTA,.497
221,Al Horford,508,.547,929,11,.306,36,244,28,98,413,519,.538,965,107,.759,141,76,76,2318,131,121,1156,C,68,100,544,ATL,.544
222,Dwight Howard,250,.594,421,1,.500,2,50,29,53,321,251,.593,423,143,.528,271,41,41,1223,110,137,646,C,28,115,431,HOU,.595
223,Lester Hudson,3,.375,8,3,.500,6,5,30,1,7,6,.429,14,3,.750,4,5,0,56,1,4,18,SG,6,3,8,LAC,.536
224,Robbie Hummel,63,.521,121,16,.314,51,27,25,9,103,79,.459,172,24,.828,29,45,4,742,31,86,198,SF,16,18,134,MIN,.506
225,Kris Humphries,211,.481,439,0,.000,7,57,29,25,298,211,.473,446,87,.744,117,64,17,1345,118,130,509,PF,34,46,416,WAS,.473
226,Serge Ibaka,297,.511,581,77,.376,205,55,25,155,364,374,.476,786,92,.836,110,64,64,2116,135,194,917,PF,30,97,499,OKC,.525
227,Andre Iguodala,157,.553,284,74,.349,212,228,31,25,213,231,.466,496,68,.596,114,77,0,2069,44,100,604,SF,89,88,257,GSW,.540
228,Ersan Ilyasova,189,.515,367,74,.389,190,56,27,19,197,263,.472,557,69,.645,107,58,36,1319,80,149,669,PF,36,45,277,MIL,.539
229,Joe Ingles,75,.493,152,72,.356,202,182,27,10,153,147,.415,354,30,.750,40,79,32,1673,22,124,396,SF,72,98,175,UTA,.517
230,Kyrie Irving,421,.491,857,157,.415,378,389,22,20,182,578,.468,1235,315,.863,365,75,75,2730,55,146,1628,PG,114,186,237,CLE,.532
231,Jarrett Jack,320,.477,671,39,.267,146,373,31,13,226,359,.439,817,200,.881,227,80,27,2241,19,143,957,PG,75,191,245,BRK,.463
232,Reggie Jackson,360,.477,755,72,.299,241,462,24,9,271,432,.434,996,181,.830,218,77,40,2268,56,167,1117,PG,62,186,327,TOT,.470
233,Bernard James,12,.444,27,0,,0,4,29,15,21,12,.444,27,20,.870,23,16,2,158,18,17,44,C,2,6,39,DAL,.444
234,LeBron James,504,.536,940,120,.354,339,511,30,49,365,624,.488,1279,375,.710,528,69,69,2493,51,135,1743,SF,109,272,416,CLE,.535
235,Al Jefferson,484,.482,1005,2,.400,5,113,30,84,449,486,.481,1010,108,.655,165,65,61,1992,99,139,1082,C,47,68,548,CHO,.482
236,Cory Jefferson,73,.480,152,2,.133,15,16,24,21,98,75,.449,167,31,.574,54,50,1,531,47,61,183,PF,10,20,145,BRK,.455
237,Richard Jefferson,78,.462,169,66,.426,155,61,34,11,158,144,.444,324,78,.684,114,74,18,1244,25,115,432,SF,32,52,183,DAL,.546
238,John Jenkins,28,.596,47,21,.404,52,13,23,0,37,49,.495,99,16,.842,19,24,3,297,2,15,135,SG,10,8,39,ATL,.601
239,Brandon Jennings,142,.428,332,76,.360,211,272,25,4,83,218,.401,543,120,.839,143,41,41,1173,21,64,632,PG,44,90,104,DET,.471
240,Jonas Jerebko,115,.481,239,54,.386,140,71,27,18,189,169,.446,379,56,.848,66,75,0,1230,93,135,448,PF,46,44,282,TOT,.517
241,Grant Jerrett,6,.545,11,1,.067,15,3,21,2,7,7,.269,26,1,1.000,1,8,0,51,2,11,16,PF,2,3,9,TOT,.288
242,Amir Johnson,279,.590,473,19,.413,46,117,27,59,297,298,.574,519,79,.612,129,75,72,1979,159,225,694,PF,44,110,456,TOR,.592
243,Chris Johnson,34,.576,59,28,.295,95,15,24,7,47,62,.403,154,14,.875,16,29,2,526,8,44,166,SF,26,15,55,TOT,.494
244,James Johnson,227,.643,353,11,.216,51,95,27,70,196,238,.589,404,67,.657,102,70,17,1370,61,155,554,PF,54,79,257,TOR,.603
245,Joe Johnson,325,.472,688,121,.359,337,292,33,14,331,446,.435,1025,141,.801,176,80,80,2791,53,120,1154,SG,59,137,384,BRK,.494
246,Nick Johnson,21,.389,54,5,.238,21,11,22,3,26,26,.347,75,17,.680,25,28,0,262,13,34,74,SG,7,19,39,HOU,.380
247,Tyler Johnson,52,.437,119,18,.375,48,42,22,9,67,70,.419,167,32,.681,47,32,2,603,14,42,190,SG,33,30,81,MIA,.473
248,Wesley Johnson,195,.451,432,91,.351,259,124,27,45,252,286,.414,691,90,.804,112,76,59,2245,67,162,753,SF,59,87,319,LAL,.480
249,Dahntay Jones,6,.353,17,0,.000,4,2,34,0,10,6,.286,21,9,.818,11,33,0,123,1,23,21,SF,3,1,11,LAC,.286
250,James Jones,11,.423,26,63,.360,175,24,34,8,53,74,.368,201,39,.848,46,57,2,669,9,67,250,SF,13,13,62,CLE,.525
251,Perry Jones,59,.476,124,14,.233,60,18,23,8,70,73,.397,184,24,.649,37,43,13,631,6,50,184,SF,17,24,76,OKC,.435
252,Terrence Jones,145,.553,262,13,.351,37,36,23,59,142,158,.528,299,57,.606,94,33,24,889,78,78,386,PF,18,37,220,HOU,.550
253,DeAndre Jordan,378,.713,530,1,.250,4,61,26,183,829,379,.710,534,187,.397,471,82,82,2820,397,245,946,C,81,109,1226,LAC,.711
254,Jerome Jordan,50,.532,94,0,,0,13,28,15,53,50,.532,94,38,.864,44,44,0,383,52,58,138,C,8,22,105,BRK,.532
255,Cory Joseph,191,.520,367,16,.364,44,188,23,17,148,207,.504,411,105,.734,143,79,14,1444,44,105,535,PG,46,67,192,SAS,.523
256,Chris Kaman,283,.515,549,0,,0,65,32,54,335,283,.515,549,72,.706,102,74,13,1398,149,140,638,C,18,108,484,POR,.515
257,Enes Kanter,466,.528,883,16,.356,45,55,22,29,394,482,.519,928,183,.782,234,75,74,2135,277,189,1163,C,36,145,671,TOT,.528
258,Sergey Karasev,38,.475,80,16,.296,54,46,21,1,44,54,.403,134,29,.763,38,33,16,555,22,45,153,SG,23,24,66,BRK,.463
259,Ryan Kelly,59,.337,175,45,.336,134,92,23,24,133,104,.337,309,79,.832,95,52,34,1233,13,118,332,PF,30,37,146,LAL,.409
260,Michael Kidd-Gilchrist,224,.465,482,0,,0,77,21,38,307,224,.465,482,150,.701,214,55,52,1587,109,115,598,SF,30,63,416,CHO,.465
261,Sean Kilpatrick,3,.429,7,4,.308,13,4,25,0,5,7,.350,20,4,1.000,4,4,0,72,1,3,22,SG,3,2,6,MIN,.450
262,Andrei Kirilenko,0,.000,5,0,,0,1,33,0,6,0,.000,5,3,.750,4,7,0,36,2,1,3,SF,1,1,8,BRK,.000
263,Alex Kirk,1,.250,4,0,,0,1,23,0,0,1,.250,4,2,1.000,2,5,0,14,1,1,4,C,0,0,1,CLE,.250
264,Brandon Knight,250,.441,567,125,.389,321,330,23,10,216,375,.422,888,195,.874,223,63,61,2035,28,114,1070,PG-SG,90,189,244,TOT,.493
265,Kyle Korver,71,.470,151,221,.492,449,196,33,42,289,292,.487,600,106,.898,118,75,75,2418,15,140,911,SG,52,107,304,ATL,.671
266,Kosta Koufos,182,.508,358,0,,0,37,25,63,305,182,.508,358,55,.647,85,81,3,1348,121,148,419,C,29,69,426,MEM,.508
267,Ognjen Kuzmic,8,.667,12,0,,0,6,24,1,10,8,.667,12,4,1.000,4,16,0,72,7,13,20,C,2,5,17,GSW,.667
268,Jeremy Lamb,66,.475,139,38,.342,111,44,22,6,99,104,.416,250,49,.891,55,47,8,633,8,52,295,SG,21,27,107,OKC,.492
269,Carl Landry,190,.515,369,0,,0,26,31,17,169,190,.515,369,123,.820,150,70,15,1192,99,132,503,PF,15,54,268,SAC,.515
270,Shane Larkin,152,.481,316,35,.302,116,226,22,9,147,187,.433,432,61,.782,78,76,22,1865,29,150,470,PG,93,83,176,NYK,.473
271,Joffrey Lauvergne,33,.452,73,3,.188,16,13,23,10,50,36,.404,89,18,.643,28,24,1,268,27,43,93,C,8,22,77,DEN,.421
272,Zach LaVine,229,.449,510,57,.341,167,276,19,10,187,286,.422,677,149,.842,177,77,40,1902,27,158,778,PG,54,193,214,MIN,.465
273,Ty Lawson,334,.463,721,70,.341,205,720,27,9,192,404,.436,926,265,.730,363,75,75,2665,42,128,1143,PG,92,185,234,DEN,.474
274,Ricky Ledo,22,.319,69,10,.370,27,19,22,1,20,32,.333,96,16,.727,22,17,0,244,16,21,90,SG,6,26,36,TOT,.385
275,Courtney Lee,198,.473,419,90,.402,224,151,29,12,157,288,.448,643,111,.860,129,77,74,2354,21,129,777,SG,75,78,178,MEM,.518
276,David Lee,160,.514,311,0,.000,2,85,31,26,176,160,.511,313,68,.654,104,49,4,904,81,83,388,PF,31,49,257,GSW,.511
277,Malcolm Lee,0,.000,1,0,,0,0,24,0,0,0,.000,1,0,,0,1,0,2,0,0,0,SG,0,0,0,PHI,.000
278,Alex Len,178,.509,350,1,.333,3,32,21,105,312,179,.507,353,73,.702,104,69,44,1518,142,213,432,C,34,74,454,PHO,.508
279,Kawhi Leonard,327,.519,630,67,.349,192,161,23,48,376,394,.479,822,202,.802,252,64,64,2033,85,128,1057,SF,148,97,461,SAS,.520
280,Meyers Leonard,78,.586,133,47,.420,112,32,22,14,204,125,.510,245,30,.938,32,55,7,847,46,113,327,C,10,39,250,POR,.606
281,Jon Leuer,114,.467,244,7,.241,29,46,25,9,157,121,.443,273,37,.627,59,63,6,824,50,86,286,PF,17,35,207,MEM,.456
282,Damian Lillard,394,.500,788,196,.343,572,507,24,21,329,590,.434,1360,344,.864,398,82,82,2925,49,164,1720,PG,97,222,378,POR,.506
283,Jeremy Lin,212,.444,478,65,.369,176,339,26,32,170,277,.424,654,213,.795,268,74,30,1907,26,189,832,PG,82,166,196,LAL,.473
284,Shaun Livingston,198,.503,394,0,.000,2,259,29,20,140,198,.500,396,65,.714,91,78,2,1468,43,110,461,PG,49,102,183,GSW,.500
285,Brook Lopez,505,.517,977,1,.100,10,50,26,126,321,506,.513,987,223,.814,274,72,44,2100,214,206,1236,C,43,104,535,BRK,.513
286,Robin Lopez,234,.537,436,0,.000,1,55,26,84,204,234,.535,437,98,.772,127,59,59,1638,190,122,566,C,16,73,394,POR,.535
287,Kevin Love,269,.480,560,144,.367,392,168,26,39,589,413,.434,952,258,.804,321,75,75,2532,142,140,1228,PF,51,122,731,CLE,.509
288,Kyle Lowry,298,.457,652,132,.338,391,473,28,13,274,430,.412,1043,252,.808,312,70,70,2414,54,212,1244,PG,109,173,328,TOR,.476
289,Kalin Lucas,0,.000,1,0,,0,0,25,0,0,0,.000,1,0,,0,1,0,6,0,1,0,PG,1,0,0,MEM,.000
290,John Lucas III,33,.440,75,9,.310,29,60,32,0,12,42,.404,104,5,1.000,5,21,0,272,4,18,98,PG,8,16,16,DET,.447
291,Shelvin Mack,77,.467,165,40,.315,127,155,24,2,71,117,.401,292,25,.806,31,55,0,833,8,32,299,PG,30,49,79,ATL,.469
292,Ian Mahinmi,117,.552,212,0,,0,33,28,46,251,117,.552,212,31,.304,102,61,6,1146,105,172,265,C,30,59,356,IND,.552
293,Devyn Marble,10,.455,22,4,.182,22,17,22,2,26,14,.318,44,5,.313,16,16,7,208,5,14,37,SG,9,9,31,ORL,.364
294,Shawn Marion,107,.484,221,12,.261,46,51,36,27,138,119,.446,267,26,.765,34,57,24,1101,64,58,276,SF,27,33,202,CLE,.468
295,Kendall Marshall,28,.509,55,18,.391,46,86,23,0,26,46,.455,101,8,.889,9,28,3,417,2,26,118,PG,21,35,28,MIL,.545
296,Cartier Martin,9,.450,20,6,.182,33,11,30,1,20,15,.283,53,0,,0,23,0,198,0,20,36,SF,3,5,20,DET,.340
297,Kenyon Martin,9,.409,22,0,,0,5,37,6,13,9,.409,22,2,1.000,2,11,0,104,6,13,20,PF,5,3,19,MIL,.409
298,Kevin Martin,192,.442,434,75,.393,191,89,31,1,123,267,.427,625,170,.881,193,39,36,1302,19,76,779,SG,33,76,142,MIN,.487
299,Wesley Matthews,164,.534,307,173,.389,445,139,28,10,184,337,.448,752,109,.752,145,60,60,2024,38,132,956,SG,77,81,222,POR,.563
300,Jason Maxiell,81,.422,192,0,,0,19,31,44,117,81,.422,192,41,.577,71,61,0,878,86,96,203,PF,18,29,203,CHO,.422
301,O.J. Mayo,197,.465,424,99,.357,277,197,27,18,157,296,.422,701,115,.827,139,71,15,1697,30,165,806,SG,57,128,187,MIL,.493
302,Luc Mbah a Moute,189,.435,434,62,.307,202,106,28,21,246,251,.395,636,96,.589,163,67,61,1916,82,104,660,PF,81,99,328,PHI,.443
303,James Michael McAdoo,24,.545,44,0,,0,2,22,9,22,24,.545,44,14,.560,25,15,0,137,15,21,62,PF,5,6,37,GSW,.545
304,Ray McCallum,172,.479,359,34,.306,111,188,23,11,128,206,.438,470,57,.679,84,68,30,1436,52,92,503,PG,45,85,180,SAC,.474
305,C.J. McCollum,104,.460,226,55,.396,139,64,23,8,77,159,.436,365,51,.699,73,62,3,973,14,81,424,SG,43,48,91,POR,.511
306,K.J. McDaniels,129,.454,284,43,.287,150,72,21,70,135,172,.396,434,100,.752,133,62,15,1352,65,126,487,SG,44,105,200,TOT,.446
307,Doug McDermott,30,.455,66,13,.317,41,6,23,1,37,43,.402,107,10,.667,15,36,0,321,6,29,109,SF,4,17,43,CHI,.463
308,Mitch McGary,88,.540,163,0,.000,2,14,22,16,112,88,.533,165,25,.625,40,32,2,485,53,72,201,PF,16,31,165,OKC,.533
309,JaVale McGee,42,.532,79,0,,0,3,27,20,43,42,.532,79,22,.667,33,23,0,256,18,30,106,C,2,18,61,TOT,.532
310,Ben McLemore,223,.507,440,140,.358,391,140,21,19,210,363,.437,831,130,.813,160,82,82,2670,31,219,996,SG,77,138,241,SAC,.521
311,Jerel McNeal,2,.222,9,1,.500,2,2,27,1,3,3,.273,11,2,1.000,2,6,0,36,0,5,9,PG,3,5,3,PHO,.318
312,Josh McRoberts,20,.588,34,8,.421,19,33,27,3,38,28,.528,53,8,.615,13,17,4,296,7,41,72,PF,12,22,45,MIA,.604
313,Jodie Meeks,148,.460,322,74,.349,212,79,27,6,92,222,.416,534,145,.906,160,60,0,1462,12,76,663,SG,59,57,104,DET,.485
314,Gal Mekel,3,.176,17,0,.000,3,13,26,0,1,3,.150,20,0,,0,4,0,43,0,1,6,PG,2,2,1,NOP,.150
315,Khris Middleton,297,.494,601,109,.407,268,182,23,11,299,406,.467,869,134,.859,156,79,58,2378,48,183,1055,SF,122,113,347,MIL,.530
316,C.J. Miles,175,.459,381,154,.345,446,75,27,26,196,329,.398,827,130,.807,161,70,40,1841,18,132,942,SG,60,73,214,IND,.491
317,Andre Miller,138,.539,256,7,.206,34,284,38,6,116,145,.500,290,58,.753,77,81,0,1253,37,103,355,PG,32,104,153,TOT,.512
318,Darius Miller,1,.167,6,0,.000,1,2,24,0,1,1,.143,7,0,,0,5,1,43,0,8,2,SF,1,1,1,NOP,.143
319,Mike Miller,5,.313,16,32,.327,98,46,34,4,87,37,.325,114,3,.750,4,52,15,701,4,74,109,SF,14,23,91,CLE,.465
320,Quincy Miller,6,.300,20,3,.167,18,8,22,5,16,9,.237,38,8,.727,11,10,0,119,4,9,29,PF,7,5,20,TOT,.276
321,Patty Mills,66,.429,154,62,.341,182,87,26,2,54,128,.381,336,33,.825,40,51,0,801,21,58,351,PG,28,35,75,SAS,.473
322,Elijah Millsap,53,.358,148,28,.311,90,58,27,16,122,81,.340,238,58,.674,86,47,5,924,28,124,248,SG,56,67,150,UTA,.399
323,Paul Millsap,366,.513,714,77,.356,216,223,29,69,431,443,.476,930,255,.757,337,73,73,2390,139,201,1218,PF,130,166,570,ATL,.518
324,Nikola Mirotic,154,.495,311,99,.316,313,97,23,54,341,253,.405,624,228,.803,284,82,3,1654,63,172,833,PF,54,89,404,CHI,.485
325,Nazr Mohammed,13,.433,30,0,,0,3,37,5,27,13,.433,30,1,.333,3,23,0,128,11,16,27,C,4,7,38,CHI,.433
326,Greg Monroe,423,.496,853,0,,0,142,24,34,475,423,.496,853,252,.750,336,69,57,2137,229,148,1098,PF,78,149,704,DET,.496
327,E'Twaun Moore,49,.485,101,13,.342,38,33,25,6,34,62,.446,139,12,.600,20,56,0,504,12,45,149,SG,20,14,46,CHI,.493
328,Eric Moreland,1,1.000,1,0,,0,0,23,0,1,1,1.000,1,0,,0,3,0,2,0,1,2,PF,0,0,1,SAC,1.000
329,Darius Morris,29,.397,73,7,.212,33,48,24,0,20,36,.340,106,4,.444,9,38,0,299,7,20,83,PG,9,21,27,BRK,.373
330,Marcus Morris,219,.487,450,112,.358,313,133,25,16,312,331,.434,763,71,.628,113,81,35,2045,73,188,845,PF,63,73,385,PHO,.507
331,Markieff Morris,455,.494,921,57,.318,179,192,25,39,396,512,.465,1100,177,.763,232,82,82,2581,110,245,1258,PF,101,170,506,PHO,.491
332,Anthony Morrow,144,.497,290,141,.434,325,60,29,11,155,285,.463,615,79,.888,89,74,0,1806,40,135,790,SG,54,38,195,OKC,.578
333,Donatas Motiejunas,304,.536,567,49,.368,133,130,24,34,284,353,.504,700,100,.602,166,71,62,2037,137,203,855,PF,56,123,421,HOU,.539
334,Timofey Mozgov,312,.557,560,2,.333,6,55,28,97,388,314,.555,566,155,.718,216,81,80,2045,203,227,785,C,33,116,591,TOT,.557
335,Shabazz Muhammad,174,.503,346,20,.392,51,44,22,7,91,194,.489,397,104,.717,145,38,13,866,63,49,512,SG,18,35,154,MIN,.514
336,Toure' Murry,2,.400,5,0,,0,1,25,0,0,2,.400,5,2,1.000,2,5,0,18,1,2,6,SG-PG,1,4,1,TOT,.400
337,Mike Muscala,74,.574,129,9,.409,22,25,23,19,67,83,.550,151,22,.880,25,40,8,502,52,52,197,PF,16,21,119,ATL,.579
338,Shabazz Napier,44,.400,110,43,.364,118,130,23,4,96,87,.382,228,44,.786,56,51,10,1012,17,76,261,PG,40,81,113,MIA,.476
339,Gary Neal,138,.407,339,50,.305,164,100,30,1,115,188,.374,503,117,.867,135,54,1,1193,14,88,543,SG,23,65,129,TOT,.423
340,Jameer Nelson,116,.472,246,89,.345,258,253,32,6,113,205,.407,504,24,.667,36,63,29,1407,33,136,523,PG,47,109,146,TOT,.495
341,Andrew Nicholson,70,.470,149,13,.317,41,22,25,12,65,83,.437,190,15,.600,25,40,3,492,17,51,194,PF,6,24,82,ORL,.471
342,Joakim Noah,190,.447,425,0,.000,2,312,29,74,427,190,.445,427,105,.603,174,67,67,2049,219,203,485,C,48,123,646,CHI,.445
343,Nerlens Noel,302,.462,653,0,,0,128,20,142,426,302,.462,653,140,.609,230,75,71,2311,185,208,744,C,133,146,611,PHI,.462
344,Lucas Nogueira,2,.250,8,0,,0,1,22,0,9,2,.250,8,2,.500,4,6,0,23,2,6,6,C,2,2,11,TOR,.250
345,Steve Novak,3,.375,8,19,.396,48,11,31,2,20,22,.393,56,0,.000,2,35,0,197,2,23,63,SF-PF,0,5,22,TOT,.563
346,Dirk Nowitzki,383,.486,788,104,.380,274,143,36,33,413,487,.459,1062,255,.882,289,77,77,2282,44,160,1333,PF,39,82,457,DAL,.508
347,Jusuf Nurkic,171,.449,381,0,.000,2,50,20,68,257,171,.446,383,84,.636,132,62,27,1103,125,207,426,C,52,86,382,DEN,.446
348,Johnny O'Bryant,44,.367,120,0,,0,17,21,4,38,44,.367,120,12,.444,27,34,15,368,26,44,100,PF,5,25,64,MIL,.367
349,Kyle O'Quinn,107,.538,199,12,.279,43,59,24,39,153,119,.492,242,44,.772,57,51,17,824,46,110,294,PF,31,55,199,ORL,.517
350,Victor Oladipo,389,.464,838,84,.339,248,295,22,19,251,473,.436,1086,262,.819,320,72,71,2573,51,187,1292,SG,120,204,302,ORL,.474
351,Kelly Olynyk,190,.538,353,61,.349,175,109,23,39,211,251,.475,528,93,.684,136,64,13,1423,92,213,656,C,64,98,303,BOS,.533
352,Arinze Onuaku,12,.857,14,0,,0,4,27,3,14,12,.857,14,3,.375,8,6,1,68,7,6,27,C,1,2,21,MIN,.857
353,Zaza Pachulia,240,.456,526,0,.000,3,178,30,21,303,240,.454,529,126,.788,160,73,45,1730,197,170,606,C,80,133,500,MIL,.454
354,Kostas Papanikolaou,38,.418,91,31,.292,106,85,24,13,79,69,.350,197,13,.722,18,43,1,795,39,71,182,SF,29,55,118,HOU,.429
355,Jannero Pargo,6,.462,13,9,.409,22,8,35,0,3,15,.429,35,2,1.000,2,9,0,73,0,8,41,PG,0,3,3,CHO,.557
356,Jabari Parker,125,.506,247,4,.250,16,42,19,5,88,129,.490,263,46,.697,66,25,25,738,50,42,308,PF,31,47,138,MIL,.498
357,Tony Parker,366,.493,743,38,.427,89,335,32,2,114,404,.486,832,130,.783,166,68,68,1953,15,108,976,PG,44,146,129,SAS,.508
358,Chandler Parsons,251,.521,482,132,.380,347,161,26,19,259,383,.462,829,139,.720,193,66,66,2186,64,140,1037,SF,69,96,323,DAL,.542
359,Patrick Patterson,135,.536,252,105,.371,283,155,25,44,306,240,.449,535,63,.788,80,81,4,2156,127,149,648,PF,60,54,433,TOR,.547
360,Chris Paul,429,.523,821,139,.398,349,838,29,15,324,568,.485,1170,289,.900,321,82,82,2857,52,203,1564,PG,156,190,376,LAC,.545
361,Adreian Payne,90,.427,211,1,.111,9,30,23,9,114,91,.414,220,30,.652,46,32,22,739,48,88,213,PF,19,44,162,TOT,.416
362,Elfrid Payton,290,.435,666,11,.262,42,533,20,20,242,301,.425,708,118,.551,214,82,63,2489,107,193,731,PG,142,203,349,ORL,.433
363,Nikola Pekovic,139,.424,328,0,,0,27,29,12,145,139,.424,328,108,.837,129,31,29,815,89,59,386,C,19,42,234,MIN,.424
364,Kendrick Perkins,102,.451,226,0,.000,1,51,30,42,229,102,.449,227,42,.506,83,68,3,1148,91,162,246,C,16,95,320,TOT,.449
365,Paul Pierce,175,.496,353,118,.389,303,144,37,24,249,293,.447,656,164,.781,210,73,73,1914,45,160,868,SF,46,92,294,WAS,.537
366,Mason Plumlee,280,.576,486,0,.000,3,74,24,63,337,280,.573,489,157,.495,317,82,45,1743,175,207,717,C,65,106,512,BRK,.573
367,Miles Plumlee,136,.535,254,0,,0,34,26,66,208,136,.535,254,22,.478,46,73,28,1194,112,111,294,C,41,51,320,TOT,.535
368,Quincy Pondexter,97,.478,203,91,.373,244,94,26,24,142,188,.421,447,71,.740,96,75,30,1793,53,150,538,SF-SG,19,51,195,TOT,.522
369,Otto Porter,141,.491,287,35,.337,104,65,21,30,151,176,.450,391,58,.734,79,74,13,1432,70,97,445,SF,44,52,221,WAS,.495
370,Dwight Powell,28,.500,56,3,.273,11,9,23,6,32,31,.463,67,25,.758,33,29,0,236,18,40,90,PF,9,11,50,TOT,.485
371,Phil Pressey,48,.440,109,16,.246,65,117,23,6,67,64,.368,174,33,.673,49,50,0,600,13,54,177,PG,30,41,80,BOS,.414
372,A.J. Price,36,.450,80,15,.263,57,46,28,0,26,51,.372,137,16,.667,24,26,0,324,6,15,133,PG,7,14,32,TOT,.427
373,Ronnie Price,46,.404,114,31,.284,109,165,31,4,50,77,.345,223,36,.800,45,43,20,982,19,118,221,PG,67,52,69,LAL,.415
374,Pablo Prigioni,34,.548,62,57,.343,166,171,37,1,89,91,.399,228,35,.854,41,67,3,1197,30,88,274,PG,79,62,119,TOT,.524
375,Tayshaun Prince,146,.436,335,31,.463,67,93,34,16,158,177,.440,402,49,.754,65,58,16,1397,52,55,434,SF,29,35,210,TOT,.479
376,Miroslav Raduljica,3,.375,8,0,,0,0,27,0,3,3,.375,8,2,1.000,2,5,0,23,2,8,8,C,1,2,5,MIN,.375
377,Julius Randle,1,.333,3,0,,0,0,20,0,0,1,.333,3,0,.000,2,1,0,14,0,1,2,PF,0,1,0,LAL,.333
378,Shavlik Randolph,9,.300,30,0,.000,5,4,31,3,22,9,.257,35,6,.500,12,21,0,126,16,16,24,PF,5,3,38,TOT,.257
379,Zach Randolph,447,.490,912,7,.350,20,153,33,14,522,454,.487,932,228,.765,298,71,71,2304,225,175,1143,PF,69,156,747,MEM,.491
380,J.J. Redick,247,.515,480,200,.437,458,137,30,8,145,447,.477,938,183,.901,203,78,78,2409,22,134,1277,SG,39,95,167,LAC,.583
381,Glen Rice,2,.250,8,1,.143,7,2,24,0,2,3,.200,15,4,.667,6,5,0,43,2,11,11,SG,0,2,4,WAS,.233
382,Jason Richardson,31,.378,82,31,.323,96,38,34,3,53,62,.348,178,17,.773,22,19,15,416,13,28,172,SG,13,16,66,PHI,.435
383,Luke Ridnour,55,.487,113,20,.317,63,96,33,4,60,75,.426,176,18,.857,21,47,0,683,8,67,188,PG,20,38,68,ORL,.483
384,Austin Rivers,164,.449,365,39,.298,131,155,22,14,125,203,.409,496,85,.675,126,76,5,1563,27,146,530,PG-SG,48,65,152,TOT,.449
385,Andre Roberson,71,.612,116,21,.247,85,70,23,29,195,92,.458,201,23,.479,48,67,65,1286,60,141,228,SG,53,46,255,OKC,.510
386,Brian Roberts,114,.440,259,62,.321,193,162,29,6,96,176,.389,452,66,.892,74,72,10,1330,13,75,480,PG,33,57,109,CHO,.458
387,Glenn Robinson,21,.438,48,5,.263,19,11,21,1,24,26,.388,67,16,.667,24,35,1,261,15,15,73,SG-SF,6,11,39,TOT,.425
388,Nate Robinson,57,.399,143,31,.277,112,97,30,3,33,88,.345,255,31,.674,46,42,1,591,17,76,238,PG,20,30,50,TOT,.406
389,Thomas Robinson,126,.488,258,0,.000,2,33,23,20,208,126,.485,260,56,.528,106,54,4,798,95,104,308,PF,32,59,303,TOT,.485
390,Rajon Rondo,248,.444,559,27,.314,86,538,28,7,300,275,.426,645,31,.397,78,68,68,2018,73,153,608,PG,91,210,373,TOT,.447
391,Derrick Rose,262,.465,564,76,.280,271,251,26,16,126,338,.405,835,152,.813,187,51,51,1530,35,63,904,PG,36,161,161,CHI,.450
392,Terrence Ross,164,.452,363,145,.372,390,86,23,25,194,309,.410,753,44,.786,56,82,61,2092,32,136,807,SF,53,69,226,TOR,.507
393,Ricky Rubio,65,.387,168,13,.255,51,193,24,1,106,78,.356,219,57,.803,71,22,22,692,19,59,226,PG,38,64,125,MIN,.386
394,Damjan Rudez,50,.538,93,69,.406,170,53,28,5,39,119,.452,263,16,.696,23,68,2,1047,8,79,323,SF,16,47,47,IND,.584
395,Brandon Rush,8,.296,27,3,.111,27,12,29,12,37,11,.204,54,5,.455,11,33,0,271,4,27,30,SG,5,11,41,GSW,.231
396,Robert Sacre,126,.413,305,0,.000,1,55,25,43,144,126,.412,306,55,.671,82,67,18,1133,89,121,307,C,28,36,233,LAL,.412
397,John Salmons,8,.364,22,8,.308,26,13,35,4,17,16,.333,48,2,.500,4,21,0,270,4,25,42,SF,9,5,21,NOP,.417
398,JaKarr Sampson,115,.525,219,31,.244,127,77,21,26,128,146,.422,346,63,.670,94,74,32,1131,35,135,386,SF,38,76,163,PHI,.467
399,Larry Sanders,86,.500,172,0,,0,23,26,39,99,86,.500,172,24,.500,48,27,26,586,67,104,196,C,26,28,166,MIL,.500
400,Dennis Schroder,232,.449,517,52,.351,148,317,21,4,135,284,.427,665,148,.827,179,77,10,1516,29,127,768,PG,49,150,164,ATL,.466
401,Luis Scola,295,.474,622,5,.250,20,105,34,18,388,300,.467,642,158,.699,226,81,16,1659,138,192,763,PF,47,94,526,IND,.471
402,Mike Scott,135,.517,261,66,.344,192,75,26,3,154,201,.444,453,61,.792,77,68,0,1123,45,83,529,PF,25,39,199,ATL,.517
403,Thabo Sefolosha,79,.462,171,25,.321,78,75,30,21,170,104,.418,249,45,.776,58,52,7,976,53,67,278,SF,53,38,223,ATL,.468
404,Kevin Seraphin,231,.516,448,0,.000,2,59,25,59,201,231,.513,450,58,.707,82,79,0,1235,87,197,520,C,10,98,288,WAS,.513
405,Ramon Sessions,106,.387,274,19,.317,60,182,28,0,121,125,.374,334,133,.769,173,64,10,1188,23,73,402,PG,29,86,144,TOT,.403
406,Iman Shumpert,126,.458,275,67,.342,196,135,24,16,169,193,.410,471,43,.672,64,62,25,1545,55,138,496,SG,81,91,224,TOT,.481
407,Alexey Shved,86,.439,196,47,.338,139,106,26,6,76,133,.397,335,121,.807,150,42,9,767,23,48,434,SG,30,48,99,TOT,.467
408,Henry Sims,234,.488,480,4,.182,22,79,24,30,238,238,.474,502,106,.774,137,73,32,1399,121,135,586,C,39,99,359,PHI,.478
409,Kyle Singler,76,.371,205,96,.398,241,85,26,21,161,172,.386,446,40,.769,52,80,58,1743,33,153,480,SF,47,55,194,TOT,.493
410,Donald Sloan,104,.464,224,41,.313,131,190,27,0,131,145,.408,355,60,.779,77,53,21,1107,12,47,391,PG,23,65,143,IND,.466
411,Marcus Smart,84,.410,205,91,.335,272,208,20,18,161,175,.367,477,82,.646,127,67,38,1808,61,176,523,PG,99,90,222,BOS,.462
412,Greg Smith,30,.612,49,0,,0,9,24,11,53,30,.612,49,20,.513,39,42,2,363,26,53,80,PF,7,11,79,DAL,.612
413,Ish Smith,125,.407,307,18,.300,60,180,26,6,85,143,.390,367,34,.596,57,55,14,832,15,50,338,PG,36,78,100,TOT,.414
414,J.R. Smith,152,.462,329,163,.383,426,195,29,22,188,315,.417,755,54,.750,72,70,51,2080,30,163,847,SG,82,97,218,TOT,.525
415,Jason Smith,242,.440,550,15,.357,42,140,28,44,226,257,.434,592,127,.830,153,82,31,1785,98,205,656,C,32,104,324,NYK,.447
416,Josh Smith,342,.451,759,72,.316,228,277,29,116,378,414,.419,987,127,.498,255,83,35,2300,152,228,1027,PF,87,206,530,TOT,.456
417,Russ Smith,6,.429,14,2,.182,11,8,23,0,5,8,.320,25,12,.923,13,12,0,65,1,13,30,PG,3,12,6,TOT,.360
418,Tony Snell,86,.494,174,73,.371,197,62,23,11,145,159,.429,371,44,.800,55,72,22,1412,31,86,435,SF,32,48,176,CHI,.527
419,Marreese Speights,313,.498,628,5,.278,18,72,27,34,216,318,.492,646,150,.843,178,76,9,1207,109,189,791,C,20,82,325,GSW,.496
420,Tiago Splitter,169,.558,303,0,,0,78,30,37,161,169,.558,303,90,.750,120,52,35,1030,91,103,428,C,35,60,252,SAS,.558
421,Nik Stauskas,60,.408,147,48,.322,149,67,21,17,77,108,.365,296,55,.859,64,73,1,1127,11,92,319,SG,20,40,88,SAC,.446
422,Lance Stephenson,189,.425,445,18,.171,105,240,24,8,238,207,.376,550,69,.627,110,61,25,1573,39,134,501,SG,38,128,277,CHO,.393
423,Greg Stiemsma,6,.750,8,0,,0,3,29,0,6,6,.750,8,2,.500,4,17,0,66,9,15,14,C,2,7,15,TOR,.750
424,David Stockton,1,.250,4,1,.500,2,9,23,0,2,2,.333,6,3,.500,6,3,0,33,0,1,8,PG,2,4,2,SAC,.417
425,Jarnell Stokes,21,.568,37,0,,0,4,21,5,18,21,.568,37,15,.536,28,19,2,126,16,25,57,PF,5,7,34,MEM,.568
426,Amar'e Stoudemire,273,.562,486,0,.000,4,45,32,38,219,273,.557,490,134,.720,186,59,15,1245,110,161,680,PF,29,78,329,TOT,.557
427,Rodney Stuckey,277,.452,613,55,.390,141,219,28,10,212,332,.440,754,177,.819,216,71,36,1874,36,131,896,PG,56,118,248,IND,.477
428,Jared Sullinger,259,.494,524,52,.283,184,134,22,42,294,311,.439,708,96,.744,129,58,49,1566,147,153,770,PF,44,78,441,BOS,.476
429,Jeffery Taylor,34,.436,78,11,.306,36,22,25,1,39,45,.395,114,26,.634,41,29,13,430,14,36,127,SF,12,19,53,CHO,.443
430,Jeff Teague,337,.496,680,71,.343,207,513,26,31,154,408,.460,887,275,.862,319,73,72,2228,30,139,1162,PG,125,205,184,ATL,.500
431,Mirza Teletovic,60,.476,126,62,.321,193,46,29,16,167,122,.382,319,33,.717,46,40,4,892,27,74,339,PF,14,53,194,BRK,.480
432,Sebastian Telfair,28,.431,65,18,.300,60,45,29,0,28,46,.368,125,24,.706,34,16,1,327,2,29,134,PG,10,18,30,OKC,.440
433,Garrett Temple,35,.427,82,33,.375,88,56,28,9,66,68,.400,170,35,.729,48,52,18,735,24,76,204,SG,42,34,90,WAS,.497
434,Jason Terry,62,.504,123,126,.390,323,147,37,19,106,188,.422,446,39,.813,48,77,18,1641,15,116,541,SG,66,74,121,HOU,.563
435,Isaiah Thomas,206,.457,451,129,.373,346,284,25,5,120,335,.420,797,302,.868,348,67,1,1726,33,150,1101,PG,57,143,153,TOT,.501
436,Lance Thomas,175,.417,420,7,.318,22,69,26,8,130,182,.412,442,72,.727,99,62,37,1490,65,101,443,PF-SF,37,74,195,TOT,.420
437,Malcolm Thomas,18,.545,33,0,.000,7,7,26,1,40,18,.450,40,9,.692,13,17,0,194,16,17,45,PF,3,13,56,PHI,.450
438,Tyrus Thomas,1,1.000,1,0,,0,1,28,0,0,1,1.000,1,2,1.000,2,2,0,7,0,0,4,PF,0,0,0,MEM,1.000
439,Hollis Thompson,109,.426,256,115,.401,287,85,23,26,145,224,.413,543,63,.708,89,71,23,1776,53,141,626,SG,57,66,198,PHI,.518
440,Jason Thompson,201,.471,427,0,.000,1,85,28,57,391,201,.470,428,89,.622,143,81,63,1991,139,239,491,PF,33,84,530,SAC,.470
441,Klay Thompson,363,.481,754,239,.439,545,222,24,60,220,602,.463,1299,225,.879,256,77,77,2455,27,122,1668,SG,87,149,247,GSW,.555
442,Tristan Thompson,267,.547,488,0,,0,39,23,61,383,267,.547,488,159,.641,248,82,15,2194,274,189,693,PF,34,83,657,CLE,.547
443,Marcus Thornton,86,.426,202,54,.378,143,36,27,7,63,140,.406,345,46,.821,56,48,0,721,23,38,380,SG,27,27,86,TOT,.484
444,Anthony Tolliver,55,.534,103,106,.366,290,59,29,16,185,161,.410,393,54,.783,69,76,11,1432,51,137,482,PF,24,51,236,TOT,.545
445,P.J. Tucker,174,.506,344,87,.345,252,122,29,23,388,261,.438,596,104,.727,143,78,63,2383,114,179,713,SF,107,96,502,PHO,.511
446,Ronny Turiaf,0,,0,0,,0,2,32,0,1,0,,0,0,,0,2,0,19,0,0,0,C,0,0,1,MIN,
447,Hedo Turkoglu,23,.469,49,60,.432,139,37,35,7,94,83,.441,188,6,.545,11,62,2,705,5,66,232,SF,19,29,99,LAC,.601
448,Evan Turner,287,.458,627,33,.277,119,449,26,19,377,320,.429,746,106,.752,141,82,57,2260,40,180,779,SG,83,198,417,BOS,.451
449,Ekpe Udoh,11,.458,24,0,,0,8,27,7,19,11,.458,24,7,.778,9,33,0,128,7,20,29,PF,8,7,26,LAC,.458
450,Beno Udrih,220,.539,408,26,.268,97,220,32,8,123,246,.487,505,87,.853,102,79,12,1494,20,88,605,PG,46,89,143,MEM,.513
451,Jonas Valanciunas,373,.573,651,0,.000,1,39,22,95,478,373,.572,652,217,.786,276,80,80,2096,215,222,963,C,33,109,693,TOR,.572
452,Anderson Varejao,111,.561,198,0,.000,2,35,32,16,113,111,.555,200,33,.733,45,26,26,636,57,58,255,C,19,35,170,CLE,.555
453,Greivis Vasquez,163,.436,374,133,.379,351,302,28,10,194,296,.408,725,50,.758,66,82,29,1991,22,177,775,PG,46,119,216,TOR,.500
454,Charlie Villanueva,67,.475,141,83,.376,221,19,30,22,119,150,.414,362,20,.571,35,64,1,678,30,64,403,PF,15,28,149,DAL,.529
455,Noah Vonleh,25,.397,63,5,.385,13,4,19,9,58,30,.395,76,18,.692,26,25,0,259,28,20,83,PF,4,11,86,CHO,.428
456,Nikola Vucevic,629,.524,1200,2,.333,6,147,24,54,572,631,.523,1206,164,.752,218,74,74,2529,238,220,1428,C,54,148,810,ORL,.524
457,Dwyane Wade,480,.489,982,29,.284,102,299,33,21,161,509,.470,1084,284,.768,370,62,62,1971,58,105,1331,SG,73,209,219,MIA,.483
458,Dion Waiters,302,.431,700,73,.297,246,163,23,21,151,375,.396,946,117,.680,172,80,23,2208,41,155,940,SG,90,113,192,TOT,.435
459,Henry Walker,13,.361,36,45,.341,132,29,27,9,75,58,.345,168,14,.778,18,24,13,628,7,76,175,SF,24,24,82,MIA,.479
460,Kemba Walker,293,.418,701,85,.304,280,318,24,31,185,378,.385,981,234,.827,283,62,58,2119,35,92,1075,PG,89,100,220,CHO,.429
461,John Wall,454,.478,949,65,.300,217,792,24,45,330,519,.445,1166,284,.785,362,79,79,2837,36,180,1387,PG,138,304,366,WAS,.473
462,Gerald Wallace,13,.419,31,1,.333,3,11,32,4,40,14,.412,34,6,.400,15,32,0,286,17,19,35,SF,15,18,57,BOS,.426
463,T.J. Warren,108,.560,193,5,.238,21,25,21,9,44,113,.528,214,14,.737,19,40,1,614,41,51,245,SF,18,27,85,PHO,.540
464,C.J. Watson,111,.459,242,70,.400,175,208,30,9,145,181,.434,417,138,.826,167,57,21,1422,18,107,570,PG,57,100,163,IND,.518
465,David Wear,0,.000,1,0,.000,1,1,24,0,0,0,.000,2,0,,0,2,0,7,2,1,0,PF,0,0,2,SAC,.000
466,Travis Wear,73,.408,179,11,.367,30,40,24,11,75,84,.402,209,20,.769,26,51,1,672,31,55,199,SF,15,35,106,NYK,.428
467,Martell Webster,14,.292,48,10,.233,43,17,28,1,36,24,.264,91,48,.750,64,32,0,352,10,24,106,SF,7,22,46,WAS,.319
468,David West,319,.479,666,4,.200,20,223,34,48,341,323,.471,686,119,.739,161,66,66,1895,108,160,769,PF,48,120,449,IND,.474
469,Russell Westbrook,541,.457,1183,86,.299,288,574,26,14,364,627,.426,1471,546,.835,654,67,67,2302,124,184,1886,PG,140,293,488,OKC,.455
470,Hassan Whiteside,243,.628,387,0,,0,6,25,123,337,243,.628,387,78,.500,156,48,32,1142,145,129,564,C,27,58,482,MIA,.628
471,Shayne Whittington,18,.500,36,1,.167,6,6,23,2,19,19,.452,42,18,.783,23,20,0,108,10,18,57,PF,5,5,29,IND,.464
472,Andrew Wiggins,458,.453,1011,39,.310,126,170,19,50,240,497,.437,1137,354,.760,466,82,82,2969,134,190,1387,SF,86,177,374,MIN,.454
473,C.J. Wilcox,9,.474,19,7,.368,19,8,24,1,6,16,.421,38,2,1.000,2,21,0,101,1,7,41,SG,3,10,7,LAC,.513
474,Deron Williams,211,.395,534,87,.367,237,448,30,17,208,298,.387,771,201,.834,241,68,55,2114,29,157,884,PG,64,154,237,BRK,.443
475,Derrick Williams,168,.511,329,49,.314,156,50,23,4,161,217,.447,485,134,.684,196,74,6,1462,41,67,617,PF,34,56,202,SAC,.498
476,Elliot Williams,6,.316,19,8,.444,18,12,25,0,8,14,.378,37,1,.250,4,13,0,119,0,12,37,SG,4,4,8,TOT,.486
477,Lou Williams,223,.464,481,152,.340,447,164,28,10,127,375,.404,928,340,.861,395,80,0,2016,24,103,1242,SG,88,101,151,TOR,.486
478,Marvin Williams,115,.500,230,95,.358,265,100,28,36,328,210,.424,495,62,.713,87,78,37,2035,58,146,577,PF,69,60,386,CHO,.520
479,Mo Williams,222,.434,512,119,.342,348,424,32,14,152,341,.397,860,163,.872,187,68,33,1980,22,162,964,PG,46,172,174,TOT,.466
480,Reggie Williams,12,.600,20,3,.158,19,10,28,0,12,15,.385,39,4,1.000,4,20,0,105,5,12,37,SF,1,2,17,SAS,.423
481,Shawne Williams,57,.467,122,64,.360,178,44,28,21,130,121,.403,300,35,.875,40,63,22,1087,36,135,341,SF,25,30,166,TOT,.510
482,Jeff Withey,32,.500,64,0,,0,11,24,18,41,32,.500,64,34,.680,50,37,0,259,23,26,98,C,4,12,64,NOP,.500
483,Nate Wolters,20,.400,50,0,.000,7,21,23,2,26,20,.351,57,2,.333,6,21,0,247,8,18,42,PG,8,13,34,TOT,.351
484,Brandan Wright,233,.647,360,0,.000,3,41,27,94,193,233,.642,363,78,.696,112,75,7,1449,128,102,544,PF,50,34,321,TOT,.642
485,Dorell Wright,31,.378,82,41,.380,108,41,29,11,97,72,.379,190,34,.810,42,48,2,592,14,55,219,SF,20,18,111,POR,.487
486,Tony Wroten,138,.473,292,37,.261,142,157,21,8,64,175,.403,434,120,.667,180,30,15,895,22,72,507,PG,48,113,86,PHI,.446
487,James Young,19,.528,36,17,.258,66,13,19,2,33,36,.353,102,16,.552,29,31,0,332,9,22,105,SG,8,5,42,BOS,.436
488,Nick Young,91,.363,251,83,.369,225,41,29,11,79,174,.366,476,132,.892,148,42,0,1000,17,83,563,SG,23,44,96,LAL,.453
489,Thaddeus Young,413,.484,853,38,.330,115,173,26,25,284,451,.466,968,131,.655,200,76,68,2434,127,171,1071,PF,124,117,411,TOT,.486
490,Cody Zeller,171,.460,372,1,1.000,1,100,22,49,265,172,.461,373,127,.774,164,62,45,1487,97,156,472,C,34,62,362,CHO,.462
491,Tyler Zeller,340,.549,619,0,,0,113,25,52,319,340,.549,619,153,.823,186,82,59,1731,146,205,833,C,18,76,465,BOS,.549
