,Player_Name,2P,2P%,2PA,3P,3P%,3PA,AST,Age,BLK,DRB,FG,FG%,FGA,FT,FT%,FTA,Games,Games_Strated,Minutes_Played,ORB,PF,PTS,Position,STL,TOV,TRB,Team,eFG%
0,Quincy Acy,100,.606,165,19,.388,49,27,25,24,123,119,.556,214,50,.735,68,59,29,876,65,103,307,PF,29,27,188,SAC,.600
1,Jordan Adams,2,.400,5,0,.000,1,3,21,0,2,2,.333,6,3,.600,5,2,0,15,0,2,7,SG,3,2,2,MEM,.333
2,Steven Adams,261,.613,426,0,,0,62,22,89,314,261,.613,426,114,.582,196,80,80,2014,219,223,636,C,42,84,533,OKC,.613
3,Arron Afflalo,263,.469,561,91,.382,238,144,30,10,243,354,.443,799,110,.840,131,71,57,2371,23,142,909,SG,25,82,266,NYK,.500
4,Alexis Ajinca,150,.478,314,0,.000,1,31,27,36,194,150,.476,315,52,.839,62,59,17,861,75,134,352,C,19,54,269,NOP,.476
5,Cole Aldrich,134,.596,225,0,,0,50,27,68,202,134,.596,225,60,.714,84,60,5,800,86,139,328,C,47,64,288,LAC,.596
6,LaMarcus Aldridge,536,.521,1029,0,.000,16,110,30,81,456,536,.513,1045,259,.858,302,74,74,2261,176,151,1331,PF,38,99,632,SAS,.513
7,Cliff Alexander,5,.500,10,0,,0,0,20,2,4,5,.500,10,0,,0,8,0,36,2,1,10,PF,1,1,6,POR,.500
8,Lavoy Allen,191,.516,370,0,,0,76,26,42,262,191,.516,370,46,.630,73,79,28,1599,162,147,428,PF,26,69,424,IND,.516
9,Tony Allen,200,.468,427,15,.357,42,70,34,18,192,215,.458,469,90,.652,138,64,57,1620,104,175,535,SG,110,78,296,MEM,.474
10,Al-Farouq Aminu,173,.468,370,126,.361,349,138,25,53,401,299,.416,719,115,.737,156,82,82,2341,98,171,839,SF,72,120,499,POR,.503
11,Lou Amundson,19,.358,53,0,,0,12,33,7,26,19,.358,53,14,.519,27,29,0,204,23,44,52,PF,6,15,49,NYK,.358
12,Chris Andersen,34,.586,58,4,.286,14,12,37,13,62,38,.528,72,25,.694,36,27,15,402,36,29,105,C,15,9,98,TOT,.556
13,Alan Anderson,9,.409,22,12,.324,37,14,33,1,26,21,.356,59,11,.733,15,13,0,192,1,25,65,SG,4,2,27,WAS,.458
14,James Anderson,44,.478,92,23,.267,86,41,26,14,73,67,.376,178,22,.759,29,51,15,721,13,54,179,SG,21,42,86,SAC,.441
15,Justin Anderson,49,.533,92,22,.265,83,29,22,25,114,71,.406,175,44,.800,55,55,9,647,18,45,208,SF,19,24,132,DAL,.469
16,Kyle Anderson,126,.488,258,12,.324,37,123,22,29,219,138,.468,295,62,.747,83,78,11,1245,25,97,350,SF,60,59,244,SAS,.488
17,Ryan Anderson,266,.466,571,131,.366,358,73,27,25,265,397,.427,929,199,.873,228,66,7,2008,131,109,1124,PF,38,90,396,NOP,.498
18,Giannis Antetokounmpo,485,.537,904,28,.257,109,345,21,113,499,513,.506,1013,296,.724,409,80,79,2823,113,258,1350,PG,94,208,612,MIL,.520
19,Thanasis Antetokounmpo,3,1.000,3,0,.000,1,0,23,0,1,3,.750,4,0,,0,2,0,6,0,2,6,SF,0,0,1,NYK,.750
20,Carmelo Anthony,462,.463,997,105,.339,310,299,31,38,458,567,.434,1307,334,.829,403,72,72,2530,98,180,1573,SF,62,176,556,NYK,.474
21,Joel Anthony,6,.600,10,0,,0,1,33,12,13,6,.600,10,6,.750,8,19,0,96,8,15,18,C,2,2,21,DET,.600
22,Keith Appling,2,.400,5,0,.000,3,1,23,0,1,2,.250,8,2,1.000,2,5,0,27,0,5,6,PG,1,3,1,ORL,.250
23,Trevor Ariza,172,.478,360,185,.371,499,188,30,26,299,357,.416,859,126,.783,161,81,81,2859,67,177,1025,SF,160,113,366,HOU,.523
24,Darrell Arthur,176,.473,372,45,.385,117,96,27,48,207,221,.452,489,40,.755,53,70,16,1516,86,185,527,PF,53,66,293,DEN,.498
25,Omer Asik,104,.533,195,0,,0,26,29,23,294,104,.533,195,61,.545,112,68,64,1178,120,124,269,C,21,60,414,NOP,.533
26,D.J. Augustin,80,.440,182,68,.405,168,198,28,4,87,148,.423,350,103,.805,128,62,0,1178,8,85,467,PG,38,84,95,TOT,.520
27,Jeff Ayres,12,.545,22,0,.000,1,5,28,3,18,12,.522,23,6,1.000,6,17,0,107,4,18,30,C,0,6,22,LAC,.522
28,Luke Babbitt,78,.433,180,44,.404,109,53,26,7,123,122,.422,289,39,.780,50,47,13,845,25,90,327,SF,11,23,148,NOP,.498
29,Cameron Bairstow,12,.343,35,1,.200,5,6,25,3,24,13,.325,40,7,.875,8,18,2,103,4,19,34,C,2,4,28,CHI,.338
30,Leandro Barbosa,132,.508,260,39,.355,110,82,33,10,89,171,.462,370,52,.839,62,68,0,1079,28,107,433,SG,44,53,117,GSW,.515
31,J.J. Barea,217,.481,451,100,.385,260,302,31,2,126,317,.446,711,74,.771,96,74,16,1667,26,110,808,PG,26,113,152,DAL,.516
32,Andrea Bargnani,124,.471,263,3,.188,16,18,30,9,69,127,.455,279,47,.825,57,46,0,634,28,61,304,C,4,26,97,BRK,.461
33,Harrison Barnes,213,.508,419,82,.383,214,117,23,10,248,295,.466,633,102,.761,134,66,59,2042,77,136,774,SF,41,57,325,GSW,.531
34,Matt Barnes,145,.449,323,119,.322,370,163,35,57,336,264,.381,693,111,.804,138,76,45,2190,84,234,758,SF,78,121,420,MEM,.467
35,Will Barton,313,.476,658,112,.345,325,203,25,39,417,425,.432,983,216,.806,268,82,1,2353,59,147,1178,SG,71,139,476,DEN,.489
36,Brandon Bass,174,.552,315,0,.000,2,74,30,55,181,174,.549,317,125,.845,148,66,0,1342,104,125,473,PF,33,42,285,LAL,.549
37,Nicolas Batum,233,.492,474,139,.348,399,403,27,43,373,372,.426,873,163,.849,192,70,70,2448,55,114,1046,SF,65,205,428,CHO,.506
38,Jerryd Bayless,84,.408,206,101,.437,231,163,27,11,120,185,.423,437,70,.778,90,52,18,1505,21,111,541,SG,47,73,141,MIL,.539
39,Aron Baynes,194,.508,382,0,.000,2,51,29,52,244,194,.505,384,126,.764,165,81,1,1233,140,151,514,C,21,67,384,DET,.505
40,Kent Bazemore,211,.502,420,109,.357,305,171,26,38,351,320,.441,725,123,.815,151,75,68,2083,28,176,872,SF,98,138,379,ATL,.517
41,Bradley Beal,254,.481,528,105,.387,271,162,22,11,147,359,.449,799,135,.767,176,55,35,1708,41,117,958,SG,54,112,188,WAS,.515
42,Michael Beasley,104,.531,196,3,.333,9,16,27,9,69,107,.522,205,38,.776,49,20,0,363,29,39,255,PF,11,24,98,HOU,.529
43,Marco Belinelli,154,.456,338,91,.306,297,127,29,2,107,245,.386,635,115,.833,138,68,7,1672,10,91,696,SG,37,80,117,SAC,.457
44,Anthony Bennett,5,.385,13,3,.214,14,0,22,0,17,8,.296,27,9,.900,10,19,0,84,6,8,28,PF,5,4,23,TOR,.352
45,Patrick Beverley,134,.472,284,124,.400,310,239,27,26,177,258,.434,594,60,.682,88,71,63,2041,73,234,700,PG,94,91,250,HOU,.539
46,Bismack Biyombo,156,.544,287,0,.000,1,29,23,133,473,156,.542,288,142,.628,226,82,22,1808,182,225,454,C,19,71,655,TOR,.542
47,Nemanja Bjelica,62,.564,110,48,.384,125,83,27,21,161,110,.468,235,40,.727,55,60,0,1075,49,154,308,PF,26,47,210,MIN,.570
48,Tarik Black,57,.548,104,0,,0,16,24,18,113,57,.548,104,19,.422,45,39,0,496,44,78,133,C,14,22,157,LAL,.548
49,DeJuan Blair,28,.418,67,0,.000,1,11,26,2,37,28,.412,68,5,.385,13,29,0,218,20,53,61,C,8,15,57,WAS,.412
50,Steve Blake,41,.461,89,52,.344,151,200,35,5,80,93,.388,240,16,.800,20,58,2,986,9,70,254,PG,24,81,89,DET,.496
51,Eric Bledsoe,175,.482,363,48,.372,129,190,26,19,107,223,.453,492,138,.802,172,31,31,1059,18,75,632,PG,63,110,125,PHO,.502
52,Bojan Bogdanovic,195,.474,411,129,.382,338,99,26,5,219,324,.433,749,110,.833,132,79,39,2115,36,119,887,SF,29,115,255,BRK,.519
53,Andrew Bogut,174,.626,278,1,1.000,1,162,31,114,371,175,.627,279,24,.480,50,70,66,1451,121,221,375,C,33,83,492,GSW,.629
54,Matt Bonner,14,.609,23,15,.441,34,9,35,1,24,29,.509,57,3,.750,4,30,2,206,3,16,76,C,6,3,27,SAS,.640
55,Devin Booker,268,.464,578,99,.343,289,200,19,20,160,367,.423,867,215,.840,256,76,51,2108,27,225,1048,SG,44,160,187,PHO,.480
56,Trevor Booker,178,.513,347,12,.293,41,84,28,41,286,190,.490,388,71,.670,106,79,2,1632,166,169,463,PF,59,81,452,UTA,.505
57,Chris Bosh,277,.508,545,81,.365,222,128,31,34,342,358,.467,767,213,.795,268,53,53,1778,48,101,1010,PF,36,78,390,MIA,.520
58,Avery Bradley,309,.505,612,147,.361,407,158,25,19,172,456,.447,1019,96,.780,123,76,72,2536,48,164,1155,SG,117,109,220,BOS,.520
59,Elton Brand,31,.437,71,0,.000,1,18,36,8,54,31,.431,72,8,.889,9,17,1,225,9,32,70,C,9,11,63,PHI,.431
60,Corey Brewer,151,.460,328,61,.272,224,109,29,19,157,212,.384,552,105,.750,140,82,12,1669,42,168,590,SF,84,78,199,HOU,.439
61,Aaron Brooks,122,.430,284,66,.357,185,180,31,10,80,188,.401,469,49,.766,64,69,0,1108,21,132,491,PG,30,82,101,CHI,.471
62,Anthony Brown,19,.339,56,20,.286,70,19,23,5,61,39,.310,126,17,.850,20,29,11,599,9,34,115,SF,14,15,70,LAL,.389
63,Lorenzo Brown,7,.412,17,1,.125,8,11,25,1,7,8,.320,25,3,.750,4,8,0,61,0,4,20,PG,3,9,7,PHO,.340
64,Markel Brown,89,.443,201,38,.314,121,91,24,15,99,127,.394,322,71,.755,94,62,6,982,23,94,363,SG,38,54,122,BRK,.453
65,Kobe Bryant,265,.410,646,133,.285,467,184,37,13,206,398,.358,1113,232,.826,281,66,66,1863,41,115,1161,SF,62,129,247,LAL,.417
66,Chase Budinger,80,.523,153,24,.279,86,64,27,10,107,104,.435,239,39,.696,56,66,2,929,43,62,271,SF,32,44,150,TOT,.485
67,Reggie Bullock,21,.467,45,22,.415,53,27,24,2,54,43,.439,98,14,.933,15,37,0,429,14,29,122,SF,10,8,68,DET,.551
68,Trey Burke,174,.460,378,88,.344,256,148,23,6,94,262,.413,634,67,.817,82,64,0,1366,18,86,679,PG,35,80,112,UTA,.483
69,Alec Burks,105,.412,255,32,.405,79,63,24,4,93,137,.410,334,106,.752,141,31,3,797,16,71,412,SG,18,51,109,UTA,.458
70,Caron Butler,22,.537,41,3,.167,18,10,35,1,17,25,.424,59,10,.833,12,17,1,176,5,19,63,SF,9,3,22,SAC,.449
71,Jimmy Butler,406,.489,830,64,.312,205,321,26,43,279,470,.454,1035,395,.832,475,67,67,2474,79,124,1399,SG,110,132,358,CHI,.485
72,Rasual Butler,34,.618,55,15,.306,49,24,36,23,53,49,.471,104,11,.688,16,46,0,432,3,11,124,SF,13,8,56,SAS,.543
73,Bruno Caboclo,0,.000,5,1,.143,7,1,20,1,1,1,.083,12,0,,0,6,1,43,1,2,3,SF,2,4,2,TOR,.125
74,Jose Calderon,125,.496,252,84,.414,203,298,34,7,207,209,.459,455,42,.875,48,72,72,2024,22,135,544,PG,63,87,229,NYK,.552
75,Kentavious Caldwell-Pope,289,.489,591,114,.309,369,138,22,17,212,403,.420,960,185,.811,228,76,76,2789,70,167,1105,SG,110,105,282,DET,.479
76,Isaiah Canaan,84,.354,237,176,.363,485,137,24,12,154,260,.360,722,150,.833,180,77,39,1966,20,133,846,SG,56,91,174,PHI,.482
77,Clint Capela,231,.583,396,0,.000,1,47,21,92,300,231,.582,397,80,.379,211,77,35,1471,194,190,542,C,59,60,494,HOU,.582
78,DeMarre Carroll,59,.388,152,46,.390,118,27,29,6,91,105,.389,270,30,.600,50,26,22,786,31,63,286,SF,44,28,122,TOR,.474
79,Vince Carter,74,.425,174,59,.349,169,56,39,16,115,133,.388,343,70,.833,84,60,3,1005,31,101,395,SG,38,35,146,MEM,.474
80,Michael Carter-Williams,236,.472,500,15,.273,55,281,24,41,228,251,.452,555,106,.654,162,54,37,1649,48,162,623,PG,80,153,276,MIL,.466
81,Omri Casspi,187,.537,348,112,.409,274,95,27,17,352,299,.481,622,103,.648,159,69,21,1880,58,154,813,SF,56,94,410,SAC,.571
82,Willie Cauley-Stein,191,.567,337,0,.000,2,37,22,66,218,191,.563,339,81,.648,125,66,39,1412,134,146,463,C,48,46,352,SAC,.563
83,Mario Chalmers,136,.461,295,46,.309,149,230,29,13,133,182,.410,444,218,.832,262,61,7,1373,24,181,628,PG,88,110,157,TOT,.462
84,Tyson Chandler,183,.585,313,0,.000,1,64,33,44,401,183,.583,314,106,.620,171,66,60,1618,175,145,472,C,36,93,576,PHO,.583
85,Rakeem Christmas,2,1.000,2,0,,0,0,24,0,0,2,1.000,2,0,,0,1,0,6,1,1,4,PF,0,0,1,IND,1.000
86,Ian Clark,59,.500,118,30,.357,84,64,24,13,55,89,.441,202,28,.824,34,66,1,578,13,58,236,SG,17,43,68,GSW,.515
87,Coty Clarke,0,.000,2,2,1.000,2,0,23,0,1,2,.500,4,0,,0,3,0,6,0,0,6,SF,0,1,1,BOS,.750
88,Jordan Clarkson,364,.468,778,111,.347,320,192,23,7,220,475,.433,1098,164,.804,204,79,79,2552,93,168,1225,SG,88,135,313,LAL,.483
89,Norris Cole,163,.427,382,33,.324,102,167,27,5,141,196,.405,484,52,.800,65,45,23,1198,10,102,477,PG,37,75,151,NOP,.439
90,Darren Collison,290,.519,559,87,.401,217,318,28,4,141,377,.486,776,194,.858,226,74,15,2219,28,142,1035,PG,76,130,169,SAC,.542
91,Nick Collison,50,.467,107,0,.000,2,52,35,16,103,50,.459,109,23,.697,33,59,4,699,68,107,123,PF,15,50,171,OKC,.459
92,Mike Conley,216,.449,481,78,.363,215,342,28,16,138,294,.422,696,191,.834,229,56,56,1761,26,100,857,PG,67,84,164,MEM,.478
93,Pat Connaughton,8,.286,28,5,.238,21,10,23,0,21,13,.265,49,5,1.000,5,34,0,143,11,6,36,SG,2,10,32,POR,.316
94,Chris Copeland,7,.467,15,10,.278,36,11,31,0,9,17,.333,51,6,.857,7,24,1,156,1,17,50,PF,2,6,10,MIL,.431
95,Bryce Cotton,4,.571,7,0,.000,3,3,23,0,0,4,.400,10,0,,0,8,0,39,0,2,8,PG,3,5,0,TOT,.400
96,DeMarcus Cousins,531,.473,1122,70,.333,210,214,25,92,589,601,.451,1332,476,.718,663,65,65,2246,158,236,1748,C,101,249,747,SAC,.477
97,Robert Covington,104,.452,230,170,.353,482,97,25,40,354,274,.385,712,140,.791,177,67,49,1903,65,232,858,SF,105,143,419,PHI,.504
98,Allen Crabbe,199,.506,393,112,.393,285,99,23,16,189,311,.459,678,98,.867,113,81,8,2105,27,192,832,SG,63,64,216,POR,.541
99,Jamal Crawford,262,.440,595,117,.340,344,183,35,12,125,379,.404,939,245,.904,271,79,5,2126,20,122,1120,SG,52,113,145,LAC,.466
100,Jae Crowder,238,.529,450,122,.336,363,135,25,35,303,360,.443,813,196,.820,239,73,73,2308,70,198,1038,SF,126,83,373,BOS,.518
101,Dante Cunningham,131,.550,238,55,.316,174,77,28,33,179,186,.451,412,57,.695,82,80,46,1971,57,173,484,SF,42,41,236,NOP,.518
102,Jared Cunningham,24,.364,66,12,.308,39,20,24,2,35,36,.343,105,36,.655,55,44,3,410,3,41,120,SG,14,21,38,TOT,.400
103,Seth Curry,52,.460,113,50,.450,111,67,25,3,51,102,.455,224,45,.833,54,44,9,692,9,41,299,PG,22,36,60,SAC,.567
104,Stephen Curry,403,.566,712,402,.454,886,527,27,15,362,805,.504,1598,363,.908,400,79,79,2700,68,161,2375,PG,169,262,430,GSW,.630
105,Troy Daniels,30,.462,65,59,.484,122,21,24,3,50,89,.476,187,5,.556,9,43,0,476,7,40,242,SG,11,24,57,CHO,.634
106,Anthony Davis,525,.511,1028,35,.324,108,116,22,125,497,560,.493,1136,326,.758,430,61,61,2164,130,148,1481,C,78,121,627,NOP,.508
107,Ed Davis,206,.611,337,0,,0,88,26,72,375,206,.611,337,114,.559,204,81,0,1684,224,202,526,PF,57,64,599,POR,.611
108,Branden Dawson,2,.400,5,0,,0,0,22,1,2,2,.400,5,1,1.000,1,6,0,29,2,2,5,PF,0,0,4,LAC,.400
109,Dewayne Dedmon,99,.559,177,0,,0,13,26,46,161,99,.559,177,57,.750,76,58,20,705,67,109,255,C,22,32,228,ORL,.559
110,Bryce Dejean-Jones,16,.432,37,12,.375,32,15,23,2,40,28,.406,69,11,.524,21,14,11,279,8,17,79,SG,10,11,48,NOP,.493
111,Sam Dekker,0,,0,0,,0,0,21,0,1,0,,0,0,,0,3,0,6,0,0,0,SF,1,0,1,HOU,
112,Matthew Dellavedova,109,.401,272,98,.410,239,337,25,9,129,207,.405,511,57,.864,66,76,14,1867,33,178,569,PG,44,116,162,CLE,.501
113,Luol Deng,251,.513,489,88,.344,256,140,30,29,335,339,.455,745,145,.755,192,74,73,2394,108,122,911,PF,74,81,443,MIA,.514
114,DeMar DeRozan,567,.458,1238,47,.338,139,315,26,21,285,614,.446,1377,555,.850,653,78,78,2804,64,167,1830,SG,81,175,349,TOR,.463
115,Boris Diaw,177,.564,314,25,.362,69,176,33,21,175,202,.527,383,56,.737,76,76,4,1386,58,102,485,PF,26,97,233,SAS,.560
116,Gorgui Dieng,302,.540,559,6,.300,20,143,26,96,428,308,.532,579,205,.827,248,82,39,2220,157,219,827,C,94,140,585,MIN,.537
117,Spencer Dinwiddie,18,.409,44,1,.100,10,22,22,0,13,19,.352,54,19,.576,33,12,0,159,4,20,58,PG,3,7,17,DET,.361
118,Toney Douglas,102,.421,242,81,.399,203,157,29,5,118,183,.411,445,84,.848,99,61,18,1262,25,131,531,PG,70,64,143,NOP,.502
119,Goran Dragic,353,.527,670,64,.312,205,419,29,17,223,417,.477,875,120,.727,165,72,72,2363,54,188,1018,PG,71,185,277,MIA,.513
120,Andre Drummond,550,.522,1054,2,.333,6,67,22,112,803,552,.521,1060,208,.355,586,81,81,2666,395,245,1314,C,119,155,1198,DET,.522
121,Jared Dudley,133,.534,249,100,.420,238,170,30,18,232,233,.478,487,72,.735,98,81,41,2098,54,190,638,PF,75,80,286,WAS,.581
122,Duje Dukan,0,.000,5,2,.400,5,1,24,0,2,2,.200,10,0,,0,1,0,24,2,2,6,SF,1,0,4,SAC,.300
123,Tim Duncan,215,.490,439,0,.000,2,163,39,78,332,215,.488,441,92,.702,131,61,60,1536,115,125,522,C,47,90,447,SAS,.488
124,Mike Dunleavy,38,.427,89,39,.394,99,39,35,10,75,77,.410,188,29,.784,37,31,30,703,8,66,222,SF,14,26,83,CHI,.513
125,Kevin Durant,512,.569,900,186,.387,481,361,27,85,544,698,.505,1381,447,.898,498,72,72,2578,45,137,2029,SF,69,250,589,OKC,.573
126,Cleanthony Early,8,.320,25,4,.267,15,6,24,3,22,12,.300,40,3,.750,4,17,2,154,4,16,31,SF,2,9,26,NYK,.350
127,Jarell Eddie,5,.278,18,15,.319,47,5,24,1,21,20,.308,65,8,1.000,8,26,0,147,2,5,63,SF,5,1,23,WAS,.423
128,Wayne Ellington,122,.416,293,96,.358,268,83,28,5,154,218,.389,561,54,.857,63,76,41,1615,20,82,586,SG,48,45,174,BRK,.474
129,Monta Ellis,349,.472,739,87,.309,282,383,30,37,229,436,.427,1021,162,.786,206,81,81,2734,42,174,1121,SG,150,203,271,IND,.470
130,James Ennis,28,.509,55,26,.448,58,21,25,5,21,54,.478,113,25,.735,34,22,5,329,21,28,159,SF,16,19,42,TOT,.593
131,Tyler Ennis,71,.480,148,13,.333,39,95,21,1,62,84,.449,187,25,.735,34,46,7,654,13,64,206,PG,25,46,75,MIL,.484
132,Jeremy Evans,22,.688,32,4,.250,16,2,28,9,43,26,.542,48,15,.714,21,30,2,251,11,19,71,SF,6,7,54,DAL,.583
133,Tyreke Evans,103,.450,229,33,.388,85,164,26,8,109,136,.433,314,74,.796,93,25,25,765,20,66,379,SG,32,73,129,NOP,.486
134,Festus Ezeli,125,.548,228,0,,0,32,26,50,166,125,.548,228,70,.530,132,46,13,770,91,94,320,C,18,38,257,GSW,.548
135,Kenneth Faried,348,.558,624,1,.500,2,79,26,60,346,349,.558,626,136,.613,222,67,64,1694,235,169,835,PF,32,91,581,DEN,.558
136,Jordan Farmar,26,.473,55,16,.356,45,37,29,2,21,42,.420,100,10,1.000,10,12,10,291,4,22,110,PG,15,18,25,MEM,.500
137,Derrick Favors,418,.518,807,0,.000,4,94,24,91,334,418,.515,811,180,.709,254,62,59,1983,169,150,1016,PF,74,104,503,UTA,.515
138,Cristiano Felicio,40,.588,68,0,.000,4,26,23,13,72,40,.556,72,25,.714,35,31,4,321,30,31,105,C,6,13,102,CHI,.556
139,Raymond Felton,217,.463,469,60,.282,213,284,31,15,222,277,.406,682,149,.847,176,80,31,2192,36,141,763,PG,68,121,258,DAL,.450
140,Evan Fournier,273,.506,539,156,.400,390,213,23,2,192,429,.462,929,199,.836,238,79,71,2566,33,214,1213,SF,96,133,225,ORL,.546
141,Randy Foye,94,.405,232,75,.300,250,161,32,29,132,169,.351,482,61,.824,74,81,8,1642,24,131,474,SG,39,86,156,TOT,.428
142,Tim Frazier,80,.442,181,16,.333,48,162,25,2,84,96,.419,229,53,.716,74,51,2,741,26,73,261,PG,33,65,110,TOT,.454
143,Jimmer Fredette,1,.333,3,1,.500,2,1,26,0,0,2,.400,5,4,.800,5,6,0,18,0,2,9,SG,1,2,0,TOT,.500
144,Channing Frye,61,.545,112,91,.387,235,71,32,28,199,152,.438,347,30,.857,35,70,32,1200,35,127,425,PF-C,29,43,234,TOT,.569
145,Danilo Gallinari,200,.434,461,87,.364,239,135,27,19,229,287,.410,700,375,.868,432,53,53,1839,52,87,1036,SF,42,77,281,DEN,.472
146,Langston Galloway,154,.423,364,77,.344,224,207,24,22,245,231,.393,588,86,.754,114,82,7,2033,43,177,625,PG,77,61,288,NYK,.458
147,Kevin Garnett,54,.474,114,0,.000,1,62,39,10,135,54,.470,115,14,.667,21,38,38,556,15,70,122,PF,28,16,150,MIN,.470
148,Marc Gasol,326,.463,704,2,.667,3,196,31,70,304,328,.464,707,203,.829,245,52,52,1791,58,141,861,C,50,118,362,MEM,.465
149,Pau Gasol,443,.478,926,24,.348,69,294,35,146,638,467,.469,995,229,.792,289,72,72,2291,155,148,1187,C,42,164,793,CHI,.481
150,Rudy Gay,392,.495,792,74,.344,215,120,29,51,353,466,.463,1007,198,.780,254,70,70,2379,103,184,1204,SF,100,139,456,SAC,.500
151,Alonzo Gee,115,.590,195,17,.283,60,72,28,13,185,132,.518,255,44,.667,66,73,38,1632,60,169,325,SF,63,55,245,NOP,.551
152,Paul George,395,.447,883,210,.371,566,329,25,29,484,605,.418,1449,454,.860,528,81,81,2819,79,230,1874,SF,152,265,563,IND,.490
153,Taj Gibson,263,.529,497,0,.000,3,106,30,77,298,263,.526,500,101,.692,146,73,55,1936,206,180,627,PF,47,78,504,CHI,.526
154,Manu Ginobili,127,.496,256,70,.391,179,177,38,11,120,197,.453,435,91,.813,112,58,0,1134,26,99,555,SG,66,99,146,SAS,.533
155,Rudy Gobert,198,.559,354,0,,0,91,23,135,460,198,.559,354,161,.569,283,61,60,1932,208,163,557,C,45,114,668,UTA,.559
156,Drew Gooden,26,.419,62,7,.171,41,13,34,11,57,33,.320,103,9,.643,14,30,0,305,28,40,82,PF,8,13,85,WAS,.354
157,Archie Goodwin,153,.474,323,23,.232,99,118,21,13,115,176,.417,422,130,.674,193,57,13,1114,27,84,505,PG,27,100,142,PHO,.444
158,Aaron Gordon,232,.531,437,42,.296,142,128,20,55,353,274,.473,579,129,.668,193,78,37,1863,154,153,719,PF,59,66,507,ORL,.509
159,Eric Gordon,118,.457,258,113,.384,294,121,27,14,89,231,.418,552,111,.888,125,45,44,1481,10,98,686,SG,43,73,99,NOP,.521
160,Marcin Gortat,433,.567,763,0,.000,1,106,31,96,519,433,.567,764,146,.705,207,75,74,2256,222,193,1012,C,47,121,741,WAS,.567
161,Andrew Goudelock,8,.727,11,1,.111,9,4,27,2,1,9,.450,20,3,.750,4,8,0,50,1,4,22,PG,6,7,2,HOU,.475
162,Jerami Grant,216,.477,453,35,.240,146,135,21,127,262,251,.419,599,212,.658,322,77,52,2066,99,215,749,SF,54,110,361,PHI,.448
163,Jerian Grant,132,.454,291,22,.220,100,177,23,10,120,154,.394,391,96,.780,123,76,6,1265,23,97,426,PG,50,87,143,NYK,.422
164,Danny Green,95,.448,212,116,.332,349,141,28,64,255,211,.376,561,34,.739,46,79,79,2062,48,141,572,SG,79,75,303,SAS,.480
165,Draymond Green,301,.537,561,100,.388,258,598,25,113,635,401,.490,819,229,.696,329,81,81,2808,134,240,1131,PF,119,259,769,GSW,.551
166,Erick Green,4,.500,8,1,.200,5,3,24,0,3,5,.385,13,2,1.000,2,9,0,42,3,4,13,PG,1,0,6,TOT,.423
167,Gerald Green,146,.446,327,84,.323,260,56,30,19,138,230,.392,587,72,.783,92,69,14,1557,25,123,616,SG,38,46,163,MIA,.463
168,JaMychal Green,215,.478,450,15,.333,45,67,25,33,234,230,.465,495,103,.752,137,78,15,1446,139,189,578,PF,46,83,373,MEM,.480
169,Jeff Green,287,.470,611,67,.315,213,138,29,40,258,354,.430,824,164,.745,220,80,41,2253,74,164,939,SF,58,93,332,TOT,.470
170,Blake Griffin,295,.504,585,6,.333,18,170,26,17,243,301,.499,603,141,.727,194,35,35,1170,51,95,749,PF,28,83,294,LAC,.504
171,Jorge Gutierrez,6,.667,9,0,.000,2,17,27,0,7,6,.545,11,10,.909,11,12,0,63,0,3,22,PG,3,6,7,CHO,.545
172,P.J. Hairston,75,.449,167,70,.290,241,38,23,11,149,145,.355,408,50,.781,64,66,52,1313,25,137,410,SF,32,41,174,TOT,.441
173,Jordan Hamilton,36,.507,71,13,.289,45,25,25,3,50,49,.422,116,14,.667,21,11,4,304,12,24,125,SF,8,17,62,NOP,.478
174,Tyler Hansbrough,30,.441,68,2,.667,3,8,30,7,49,32,.451,71,38,.585,65,44,0,343,40,55,104,PF,12,12,89,CHO,.465
175,Tim Hardaway,66,.537,123,48,.338,142,51,23,7,79,114,.430,265,50,.893,56,51,1,864,7,48,326,SG,21,23,86,ATL,.521
176,James Harden,474,.494,960,236,.359,657,612,26,51,438,710,.439,1617,720,.860,837,82,82,3125,63,229,2376,SG,139,374,501,HOU,.512
177,Maurice Harkless,156,.576,271,39,.279,140,67,22,35,179,195,.474,411,69,.622,111,78,14,1457,101,124,498,SF,49,62,280,POR,.522
178,Justin Harper,0,.000,1,4,.444,9,0,26,0,1,4,.400,10,1,.500,2,5,0,35,0,3,13,PF,1,2,1,DET,.600
179,Montrezl Harrell,58,.652,89,0,.000,1,17,22,11,40,58,.644,90,24,.522,46,39,1,379,25,48,140,PF,11,17,65,HOU,.644
180,Devin Harris,115,.532,216,52,.329,158,118,32,13,120,167,.447,374,101,.721,140,64,0,1280,18,124,487,PG,60,66,138,DAL,.516
181,Gary Harris,254,.543,468,105,.354,297,147,21,18,166,359,.469,765,109,.820,133,76,76,2439,54,143,932,SG,97,98,220,DEN,.538
182,Joe Harris,0,,0,1,.250,4,2,24,0,3,1,.250,4,0,,0,5,0,15,0,1,3,SG,0,1,3,CLE,.375
183,Tobias Harris,337,.518,650,80,.335,239,169,23,40,414,417,.469,889,202,.831,243,76,74,2513,96,153,1116,PF,65,108,510,TOT,.514
184,Aaron Harrison,2,.222,9,3,.300,10,2,21,0,11,5,.263,19,5,.417,12,21,0,93,4,10,18,SG,6,4,15,CHO,.342
185,Udonis Haslem,22,.423,52,1,.111,9,14,35,2,65,23,.377,61,12,.750,16,37,0,260,10,25,59,PF,5,5,75,MIA,.385
186,Spencer Hawes,86,.422,204,38,.373,102,109,27,27,193,124,.405,306,54,.831,65,57,6,1035,51,111,340,PF,22,58,244,CHO,.467
187,Chuck Hayes,1,.500,2,0,,0,2,32,0,8,1,.500,2,2,1.000,2,2,0,24,0,6,4,C,0,3,8,HOU,.500
188,Gordon Hayward,378,.477,792,143,.349,410,296,25,27,336,521,.433,1202,393,.824,477,80,80,2893,61,183,1578,SF,95,202,397,UTA,.493
189,Gerald Henderson,184,.468,393,48,.353,136,75,28,19,181,232,.439,529,112,.767,146,72,0,1431,30,87,624,SG,39,68,211,POR,.484
190,John Henson,164,.566,290,0,.000,1,54,25,109,134,164,.564,291,69,.590,117,57,1,960,87,131,397,C,18,64,221,MIL,.564
191,Mario Hezonja,114,.504,226,67,.349,192,109,20,17,148,181,.433,418,49,.907,54,79,9,1413,28,124,478,SF,39,97,176,ORL,.513
192,Roy Hibbert,182,.445,409,0,.000,2,95,29,110,266,182,.443,411,117,.807,145,81,81,1878,132,252,481,C,32,76,398,LAL,.443
193,J.J. Hickson,80,.519,154,0,.000,1,23,27,14,93,80,.516,155,46,.447,103,35,9,436,39,47,206,C,15,25,132,TOT,.516
194,Nene Hilario,209,.549,381,0,.000,3,97,33,26,207,209,.544,384,107,.578,185,57,11,1094,52,156,525,PF,54,76,259,WAS,.544
195,George Hill,198,.466,425,128,.408,314,259,29,17,240,326,.441,739,114,.760,150,74,73,2524,58,149,894,PG,83,101,298,IND,.528
196,Jordan Hill,278,.507,548,0,.000,1,87,28,37,295,278,.506,549,89,.712,125,73,11,1513,156,155,645,C,36,92,451,IND,.506
197,Solomon Hill,69,.515,134,24,.324,74,57,24,11,127,93,.447,208,36,.857,42,59,3,866,39,68,246,SF,37,33,166,IND,.505
198,Darrun Hilliard,33,.407,81,19,.380,50,27,22,1,40,52,.397,131,29,.725,40,38,2,383,5,28,152,SG,9,19,45,DET,.469
199,Kirk Hinrich,25,.373,67,24,.387,62,73,35,2,62,49,.380,129,15,.938,16,46,7,631,8,64,137,PG,15,30,70,TOT,.473
200,Jrue Holiday,323,.478,676,87,.336,259,391,25,22,168,410,.439,935,182,.843,216,65,23,1831,27,148,1089,PG,88,167,195,NOP,.485
201,Justin Holiday,52,.423,123,36,.343,105,56,26,19,78,88,.386,228,27,.730,37,53,5,773,12,61,239,SG,32,39,90,TOT,.465
202,Ryan Hollins,49,.620,79,0,,0,10,31,21,51,49,.620,79,26,.619,42,37,12,460,47,62,124,C,6,24,98,TOT,.620
203,Rondae Hollis-Jefferson,59,.476,124,4,.286,14,43,21,16,115,63,.457,138,37,.712,52,29,17,615,39,61,167,SF,39,26,154,BRK,.471
204,Richaun Holmes,106,.596,178,8,.182,44,33,22,40,73,114,.514,222,51,.689,74,51,1,702,62,92,287,PF,19,32,135,PHI,.532
205,Rodney Hood,247,.472,523,161,.359,449,213,23,16,229,408,.420,972,172,.860,200,79,79,2541,38,202,1149,SG,73,125,267,UTA,.503
206,Al Horford,441,.557,792,88,.344,256,263,29,121,448,529,.505,1048,103,.798,129,82,82,2631,148,163,1249,C,68,107,596,ATL,.547
207,Dwight Howard,372,.626,594,0,.000,6,98,30,113,597,372,.620,600,232,.489,474,71,71,2280,238,219,976,C,69,166,835,HOU,.620
208,Marcelo Huertas,81,.479,169,16,.262,61,182,32,7,72,97,.422,230,27,.931,29,53,0,869,18,76,237,PG,26,80,90,LAL,.457
209,Josh Huestis,1,.167,6,4,.667,6,0,24,2,8,5,.417,12,0,.000,4,5,0,55,2,3,14,PF,1,3,10,OKC,.583
210,Kris Humphries,87,.465,187,34,.315,108,36,30,23,161,121,.410,295,67,.798,84,53,17,835,57,94,343,PF,16,38,218,TOT,.468
211,R.J. Hunter,17,.486,35,19,.302,63,13,22,4,35,36,.367,98,6,.857,7,36,0,315,2,29,97,SG,14,11,37,BOS,.464
212,Serge Ibaka,356,.520,685,60,.326,184,66,26,148,392,416,.479,869,91,.752,121,78,78,2500,141,211,983,PF,38,108,533,OKC,.513
213,Andre Iguodala,122,.570,214,54,.351,154,219,32,19,211,176,.478,368,51,.614,83,65,1,1732,52,102,457,SF,73,79,263,GSW,.552
214,Ersan Ilyasova,184,.458,402,96,.371,259,67,28,33,259,280,.424,661,111,.721,154,74,56,1881,144,171,767,PF,52,71,403,TOT,.496
215,Joe Ingles,43,.531,81,81,.386,210,96,28,4,132,124,.426,291,13,.722,18,81,2,1241,19,98,342,SF,55,65,151,UTA,.565
216,Damien Inglis,10,.417,24,3,.231,13,10,20,3,29,13,.351,37,7,.875,8,20,1,156,2,11,36,SF,6,11,31,MIL,.392
217,Kyrie Irving,310,.502,617,84,.321,262,249,23,18,113,394,.448,879,169,.885,191,53,53,1667,44,107,1041,PG,56,124,157,CLE,.496
218,Jarrett Jack,109,.426,256,31,.304,102,236,32,7,127,140,.391,358,100,.893,112,32,32,1027,9,77,411,PG,34,94,136,BRK,.434
219,Reggie Jackson,422,.464,910,118,.353,334,492,25,11,195,540,.434,1244,291,.864,337,79,79,2424,58,187,1489,PG,59,223,253,DET,.482
220,LeBron James,650,.573,1134,87,.309,282,514,31,49,454,737,.520,1416,359,.731,491,76,76,2709,111,143,1920,SF,104,249,565,CLE,.551
221,Al Jefferson,245,.485,505,0,,0,70,31,41,244,245,.485,505,72,.649,111,47,18,1096,57,117,562,C,30,34,301,CHO,.485
222,Cory Jefferson,9,.429,21,0,.000,1,0,25,1,10,9,.409,22,4,.667,6,8,0,50,6,8,22,PF,0,0,16,PHO,.409
223,Richard Jefferson,77,.554,139,66,.382,173,59,35,14,113,143,.458,312,58,.667,87,74,5,1326,15,129,410,SF,33,43,128,CLE,.564
224,John Jenkins,55,.505,109,16,.314,51,35,24,1,49,71,.444,160,20,.833,24,43,3,480,8,22,178,SG,8,27,57,TOT,.494
225,Brandon Jennings,61,.409,149,51,.329,155,170,26,7,80,112,.368,304,57,.731,78,48,7,868,16,57,332,PG,29,57,96,TOT,.452
226,Jonas Jerebko,75,.421,178,43,.398,108,62,28,24,211,118,.413,286,61,.782,78,78,0,1176,77,137,340,PF,20,52,288,BOS,.488
227,Amir Johnson,239,.624,383,10,.233,43,138,28,83,327,249,.585,426,69,.570,121,79,76,1800,178,214,577,PF,52,94,505,BOS,.596
228,Chris Johnson,45,.474,95,27,.273,99,45,25,20,105,72,.371,194,34,.810,42,70,2,857,27,100,205,SF,32,40,132,UTA,.441
229,James Johnson,94,.540,174,20,.303,66,67,28,33,98,114,.475,240,39,.574,68,57,32,926,28,84,287,PF,29,54,126,TOR,.517
230,Joe Johnson,257,.471,546,120,.383,313,318,34,4,243,377,.439,859,118,.831,142,81,81,2703,49,146,992,SF,61,159,292,TOT,.509
231,Orlando Johnson,7,.292,24,2,.200,10,2,26,3,11,9,.265,34,6,.750,8,7,1,101,4,9,26,SG,3,4,15,TOT,.294
232,Stanley Johnson,162,.410,395,63,.307,205,118,19,12,248,225,.375,600,80,.784,102,73,6,1687,58,178,593,SF,55,114,306,DET,.428
233,Tyler Johnson,91,.529,172,27,.380,71,79,23,14,81,118,.486,243,51,.797,64,36,5,863,28,66,314,SG,24,47,109,MIA,.541
234,Wesley Johnson,105,.510,206,103,.333,309,49,28,56,211,208,.404,515,30,.652,46,80,9,1666,37,173,549,SF,89,54,248,LAC,.504
235,Nikola Jokic,279,.541,516,28,.333,84,189,20,50,379,307,.512,600,154,.811,190,80,55,1733,181,208,796,C,79,104,560,DEN,.535
236,Dahntay Jones,5,.417,12,1,.500,2,2,35,2,4,6,.429,14,0,,0,1,0,42,1,6,13,SF,1,0,5,CLE,.464
237,James Jones,17,.447,38,41,.394,104,14,35,10,42,58,.408,142,21,.808,26,48,0,463,8,50,178,SF,11,13,50,CLE,.553
238,Terrence Jones,141,.490,288,25,.316,79,41,24,39,149,166,.452,367,77,.664,116,50,11,1044,62,86,434,PF,23,49,211,HOU,.486
239,Tyus Jones,40,.388,103,16,.302,53,108,19,3,40,56,.359,156,28,.718,39,37,0,573,7,33,156,PG,31,33,47,MIN,.410
240,DeAndre Jordan,357,.704,507,0,.000,1,90,27,177,792,357,.703,508,266,.430,619,77,77,2598,267,207,980,C,51,107,1059,LAC,.703
241,Cory Joseph,227,.478,475,30,.273,110,250,24,20,171,257,.439,585,133,.764,174,80,4,2046,39,131,677,SG,63,102,210,TOR,.465
242,Chris Kaman,19,.487,39,1,.250,4,11,33,1,17,20,.465,43,3,1.000,3,16,2,112,7,15,44,C,1,8,24,POR,.477
243,Frank Kaminsky,147,.455,323,68,.337,202,98,22,43,266,215,.410,525,108,.730,148,81,3,1708,69,126,606,C,38,58,335,CHO,.474
244,Enes Kanter,404,.579,698,10,.476,21,33,23,33,415,414,.576,719,200,.797,251,82,1,1721,249,166,1038,C,26,115,664,OKC,.583
245,Sergey Karasev,19,.514,37,11,.297,37,35,22,2,50,30,.405,74,26,.929,28,40,5,399,8,27,97,SF,6,22,58,BRK,.480
246,Sasha Kaun,9,.529,17,0,,0,3,30,5,14,9,.529,17,5,.455,11,25,0,95,12,11,23,C,4,7,26,CLE,.529
247,Ryan Kelly,50,.446,112,5,.135,37,20,24,10,100,55,.369,149,37,.685,54,36,0,470,21,39,152,PF,13,18,121,LAL,.386
248,Michael Kidd-Gilchrist,30,.556,54,3,.429,7,9,22,3,33,33,.541,61,20,.690,29,7,7,205,12,9,89,SF,3,8,45,CHO,.566
249,Sean Kilpatrick,84,.538,156,39,.342,114,29,26,2,44,123,.456,270,60,.896,67,31,0,616,12,37,345,SG,12,31,56,TOT,.528
250,Brandon Knight,251,.461,544,120,.342,351,263,24,20,166,371,.415,895,156,.852,183,52,50,1870,36,124,1018,SG,61,177,202,PHO,.482
251,Kyle Korver,110,.502,219,158,.398,397,164,34,35,246,268,.435,616,45,.833,54,80,80,2401,14,161,739,SG,60,98,260,ATL,.563
252,Kosta Koufos,236,.532,444,0,,0,33,26,70,254,236,.532,444,57,.548,104,78,14,1482,169,185,529,C,40,48,423,SAC,.532
253,Jeremy Lamb,174,.529,329,56,.309,181,77,23,30,208,230,.451,510,64,.727,88,66,0,1227,44,105,580,SG,42,50,252,CHO,.506
254,Carl Landry,133,.561,237,6,.462,13,32,32,9,97,139,.556,250,67,.736,91,36,12,569,49,69,351,PF,12,22,146,PHI,.568
255,Shane Larkin,183,.464,394,39,.361,108,342,23,12,152,222,.442,502,83,.776,107,78,17,1751,28,121,566,PG,95,146,180,BRK,.481
256,Joffrey Lauvergne,182,.557,327,13,.245,53,56,24,15,213,195,.513,380,62,.899,69,59,15,1041,77,115,465,C,13,54,290,DEN,.530
257,Zach LaVine,310,.482,643,123,.389,316,251,20,17,201,433,.452,959,161,.793,203,82,33,2294,27,193,1150,SG,69,155,228,MIN,.516
258,Ty Lawson,103,.419,246,36,.333,108,237,28,7,94,139,.393,354,59,.686,86,66,13,1411,26,87,373,PG,53,95,120,TOT,.444
259,Courtney Lee,208,.493,422,82,.378,217,136,30,28,176,290,.454,639,99,.839,118,79,65,2334,29,134,761,SG,85,72,205,TOT,.518
260,David Lee,178,.533,334,0,.000,1,84,32,28,204,178,.531,335,71,.763,93,55,5,903,101,114,427,PF,22,66,305,TOT,.531
261,Alex Len,263,.426,617,1,.143,7,97,22,62,416,264,.423,624,174,.728,239,78,46,1821,178,230,703,C,38,145,594,PHO,.424
262,Kawhi Leonard,422,.528,799,129,.443,291,186,24,71,398,551,.506,1090,292,.874,334,72,72,2380,95,133,1523,SF,128,105,493,SAS,.565
263,Meyers Leonard,109,.527,207,86,.377,228,92,23,18,263,195,.448,435,35,.761,46,61,10,1333,51,183,511,PF,8,77,314,POR,.547
264,Jon Leuer,182,.511,356,42,.382,110,72,26,30,297,224,.481,466,77,.762,101,67,27,1255,76,125,567,PF,38,75,373,PHO,.526
265,Damian Lillard,389,.450,864,229,.375,610,512,25,28,257,618,.419,1474,414,.892,464,75,75,2676,45,165,1879,PG,65,242,302,POR,.497
266,Jeremy Lin,224,.446,502,76,.336,226,235,27,42,211,300,.412,728,238,.815,292,78,13,2048,42,165,914,SG,58,150,253,CHO,.464
267,Shaun Livingston,201,.548,367,2,.167,12,237,30,27,127,203,.536,379,80,.860,93,78,3,1520,42,140,488,PG,57,78,169,GSW,.538
268,Kevon Looney,3,.600,5,1,.500,2,0,19,0,6,4,.571,7,0,,0,5,0,21,4,2,9,PF,0,1,10,GSW,.643
269,Brook Lopez,589,.515,1143,2,.143,14,147,27,124,369,591,.511,1157,317,.787,403,73,73,2457,204,215,1501,C,58,175,573,BRK,.512
270,Robin Lopez,357,.540,661,0,.000,1,114,27,129,334,357,.539,662,128,.795,161,82,82,2219,268,182,842,C,16,133,602,NYK,.539
271,Kevin Love,251,.467,538,158,.360,439,186,27,41,613,409,.419,977,258,.822,314,77,77,2424,149,159,1234,PF,58,142,762,CLE,.499
272,Kyle Lowry,300,.461,651,212,.388,547,494,29,34,310,512,.427,1198,398,.811,491,77,77,2851,55,211,1634,PG,158,225,365,TOR,.516
273,Trey Lyles,142,.461,308,49,.383,128,59,20,18,240,191,.438,436,57,.695,82,80,33,1382,59,114,488,PF,26,65,299,UTA,.494
274,Shelvin Mack,143,.493,290,39,.312,125,187,25,3,115,182,.439,415,45,.738,61,52,27,1058,13,72,448,PG,34,95,128,TOT,.486
275,Ian Mahinmi,264,.589,448,0,,0,104,29,75,369,264,.589,448,132,.587,225,71,71,1816,138,220,660,C,65,100,507,IND,.589
276,Devyn Marble,13,.333,39,8,.250,32,12,23,1,32,21,.296,71,10,.417,24,28,0,249,6,25,60,SG,13,7,38,ORL,.352
277,Boban Marjanovic,105,.603,174,0,,0,21,27,23,121,105,.603,174,87,.763,114,54,4,508,73,54,297,C,12,29,194,SAS,.603
278,Kendall Marshall,27,.391,69,16,.327,49,73,24,2,26,43,.364,118,9,.692,13,30,6,400,2,30,111,PG,16,43,28,PHI,.432
279,Jarell Martin,54,.474,114,0,.000,2,15,21,7,47,54,.466,116,45,.726,62,27,0,380,39,58,153,PF,8,19,86,MEM,.466
280,Kevin Martin,107,.378,283,49,.360,136,58,32,3,96,156,.372,419,153,.890,172,55,13,1095,14,83,514,SG,26,54,110,TOT,.431
281,Wesley Matthews,142,.432,329,189,.360,525,151,29,17,211,331,.388,854,126,.863,146,78,78,2644,27,179,977,SF,78,78,238,DAL,.498
282,O.J. Mayo,67,.421,159,52,.321,162,118,28,8,92,119,.371,321,31,.775,40,41,24,1090,13,126,321,SG,48,72,105,MIL,.452
283,Luc Mbah a Moute,81,.485,167,13,.325,40,30,29,19,111,94,.454,207,30,.526,57,75,61,1274,60,100,231,PF,44,34,171,LAC,.486
284,James Michael McAdoo,44,.537,82,1,.500,2,17,23,8,28,45,.536,84,26,.531,49,41,1,262,30,39,117,PF,10,16,58,GSW,.542
285,Ray McCallum,40,.385,104,15,.357,42,60,24,7,39,55,.377,146,12,.800,15,41,6,475,8,29,137,PG,12,24,47,TOT,.428
286,C.J. McCollum,444,.463,959,197,.417,472,341,24,23,212,641,.448,1431,187,.827,226,80,80,2780,47,187,1666,SG,97,196,259,POR,.517
287,T.J. McConnell,187,.499,375,31,.348,89,367,23,10,207,218,.470,464,26,.634,41,81,17,1606,43,114,493,PG,95,140,250,PHI,.503
288,Chris McCullough,31,.413,75,13,.382,34,9,20,12,43,44,.404,109,11,.478,23,24,4,362,25,39,112,PF,28,15,68,BRK,.463
289,K.J. McDaniels,22,.468,47,7,.280,25,10,22,6,26,29,.403,72,24,.800,30,37,1,235,16,30,89,SF,7,17,42,HOU,.451
290,Doug McDermott,181,.470,385,110,.425,259,59,24,6,158,291,.452,644,72,.857,84,81,4,1861,37,127,764,SF,14,53,195,CHI,.537
291,Mitch McGary,11,.579,19,0,.000,4,3,23,2,14,11,.478,23,4,.400,10,20,0,72,4,10,26,PF,1,7,18,OKC,.478
292,JaVale McGee,77,.579,133,0,.000,1,3,28,26,80,77,.575,134,18,.500,36,34,2,370,53,49,172,C,5,21,133,DAL,.575
293,Ben McLemore,128,.474,270,67,.362,185,79,22,10,114,195,.429,455,74,.718,103,68,53,1443,34,140,531,SG,52,99,148,SAC,.502
294,Jordan McRae,24,.429,56,10,.455,22,25,24,1,16,34,.436,78,21,.750,28,22,1,195,4,17,99,PG,3,15,20,TOT,.500
295,Josh McRoberts,43,.434,99,12,.245,49,81,28,7,83,55,.372,148,28,.700,40,42,1,595,22,68,150,PF,18,30,105,MIA,.412
296,Jodie Meeks,3,.273,11,4,.444,9,3,28,0,4,7,.350,20,4,1.000,4,3,0,43,1,2,22,SG,0,1,5,DET,.450
297,Salah Mejri,49,.636,77,0,.000,1,10,29,36,82,49,.628,78,27,.587,46,34,6,397,41,54,125,C,8,23,123,DAL,.628
298,Jordan Mickey,8,.364,22,0,,0,1,21,11,7,8,.364,22,5,.500,10,16,0,57,6,5,21,PF,0,1,13,BOS,.364
299,Khris Middleton,364,.466,781,143,.396,361,331,24,19,258,507,.444,1142,277,.888,312,79,79,2852,44,204,1434,SG,131,180,302,MIL,.507
300,C.J. Miles,117,.474,247,142,.367,387,63,28,29,150,259,.409,634,93,.750,124,64,24,1464,25,142,753,SF,53,70,175,IND,.521
301,Andre Miller,57,.582,98,2,.250,8,87,39,0,39,59,.557,106,24,.750,32,39,4,461,12,46,144,PG,16,37,51,TOT,.566
302,Mike Miller,3,.300,10,19,.365,52,40,35,4,47,22,.355,62,0,,0,47,2,373,6,53,63,SF,13,17,53,DEN,.508
303,Patty Mills,137,.469,292,123,.384,320,226,27,6,131,260,.425,612,47,.810,58,81,3,1662,27,102,690,PG,59,76,158,SAS,.525
304,Elijah Millsap,10,.370,27,1,.083,12,19,28,3,29,11,.282,39,13,.722,18,20,0,173,6,33,36,SG,7,9,35,UTA,.295
305,Paul Millsap,427,.512,834,74,.319,232,265,30,139,534,501,.470,1066,309,.757,408,81,81,2647,198,237,1385,PF,147,191,732,ATL,.505
306,Nikola Mirotic,113,.430,263,135,.390,346,100,24,46,304,248,.407,609,146,.807,181,66,38,1646,58,151,777,PF,58,102,362,CHI,.518
307,Nazr Mohammed,3,.600,5,0,,0,0,38,0,3,3,.600,5,2,1.000,2,5,0,19,1,4,8,C,0,3,4,OKC,.600
308,Greg Monroe,491,.522,940,0,.000,1,178,25,67,478,491,.522,941,228,.740,308,79,67,2314,218,163,1210,C,72,129,696,MIL,.522
309,Luis Montero,4,.400,10,1,.111,9,1,22,0,4,5,.263,19,3,.750,4,12,0,42,0,1,14,SG,0,4,4,POR,.289
310,E'Twaun Moore,140,.491,285,47,.452,104,99,26,18,114,187,.481,389,22,.629,35,59,22,1263,19,103,443,SG,37,53,133,CHI,.541
311,Eric Moreland,3,.500,6,0,,0,1,24,4,8,3,.500,6,2,.500,4,8,0,48,3,4,8,PF,0,3,11,SAC,.500
312,Marcus Morris,302,.467,647,108,.362,298,201,26,23,313,410,.434,945,203,.749,271,80,80,2856,91,170,1131,SF,67,140,404,DET,.491
313,Markieff Morris,258,.458,563,47,.303,155,124,26,34,279,305,.425,718,108,.735,147,64,45,1629,73,184,765,PF,58,135,352,TOT,.458
314,Anthony Morrow,57,.442,129,79,.387,204,24,30,5,52,136,.408,333,29,.744,39,68,6,926,10,64,380,SG,22,17,62,OKC,.527
315,Donatas Motiejunas,74,.500,148,16,.281,57,41,25,5,72,90,.439,205,34,.642,53,37,22,547,37,69,230,PF,17,44,109,HOU,.478
316,Timofey Mozgov,202,.574,352,1,.143,7,33,29,57,227,203,.565,359,68,.716,95,76,48,1326,110,159,475,C,22,71,337,CLE,.567
317,Emmanuel Mudiay,255,.379,673,74,.319,232,372,19,35,200,329,.364,905,140,.670,209,68,66,2068,32,141,872,PG,65,217,232,DEN,.404
318,Shabazz Muhammad,273,.516,529,44,.289,152,52,23,7,167,317,.465,681,185,.764,242,82,0,1682,100,94,863,SF,24,70,267,MIN,.498
319,Xavier Munford,23,.426,54,9,.391,23,22,23,3,28,32,.416,77,7,.500,14,14,0,244,3,25,80,SG,13,15,31,MEM,.474
320,Mike Muscala,64,.566,113,12,.308,39,34,24,27,79,76,.500,152,31,.795,39,60,0,565,38,72,195,C,13,27,117,ATL,.539
321,Larry Nance,157,.541,290,1,.100,10,44,23,23,211,158,.527,300,32,.681,47,63,22,1266,101,124,349,PF,54,41,312,LAL,.528
322,Shabazz Napier,34,.351,97,34,.327,104,97,24,1,46,68,.338,201,33,.733,45,55,0,600,9,38,203,PG,23,46,55,ORL,.423
323,Gary Neal,110,.489,225,41,.410,100,47,31,1,72,151,.465,325,47,.855,55,40,2,807,11,55,390,SG,20,29,83,WAS,.528
324,Jameer Nelson,70,.429,163,43,.299,144,190,33,5,96,113,.368,307,30,.857,35,39,15,1036,19,100,299,PG,25,66,115,DEN,.438
325,Raul Neto,116,.453,256,64,.395,162,174,23,2,103,180,.431,418,52,.743,70,81,53,1499,17,122,476,PG,62,109,120,UTA,.507
326,Andrew Nicholson,105,.536,196,41,.360,114,25,26,22,167,146,.471,310,51,.785,65,56,0,823,34,69,384,PF,10,41,201,ORL,.537
327,Joakim Noah,51,.386,132,0,.000,1,110,30,29,168,51,.383,133,22,.489,45,29,2,635,87,77,124,C,18,52,255,CHI,.383
328,Nerlens Noel,305,.521,585,1,.500,2,122,21,100,388,306,.521,587,134,.590,227,67,62,1965,154,192,747,C,118,158,542,PHI,.522
329,Lucas Nogueira,27,.659,41,1,.333,3,7,23,12,28,28,.636,44,8,.533,15,29,1,225,18,29,65,C,12,11,46,TOR,.648
330,Steve Novak,1,.333,3,7,.467,15,0,32,0,5,8,.444,18,1,1.000,1,10,0,44,0,3,24,PF,0,1,5,TOT,.639
331,Dirk Nowitzki,372,.483,770,126,.368,342,132,37,52,437,498,.448,1112,250,.893,280,75,75,2364,52,161,1372,PF,52,84,489,DAL,.504
332,Jusuf Nurkic,101,.423,239,0,.000,3,40,21,44,110,101,.417,242,61,.616,99,32,3,547,65,91,263,C,24,55,175,DEN,.417
333,J.J. O'Brien,0,.000,1,0,,0,0,23,0,1,0,.000,1,0,,0,2,0,6,0,1,0,SF,1,0,1,UTA,.000
334,Johnny O'Bryant,85,.409,208,1,1.000,1,32,22,8,111,86,.411,209,27,.675,40,66,4,857,65,100,200,PF,18,31,176,MIL,.414
335,Kyle O'Quinn,124,.498,249,5,.227,22,72,25,49,174,129,.476,271,46,.767,60,65,1,764,76,107,309,PF,20,61,250,NYK,.485
336,Jahlil Okafor,396,.511,775,1,.167,6,65,20,61,251,397,.508,781,133,.686,194,53,48,1591,122,140,928,C,22,124,373,PHI,.509
337,Victor Oladipo,327,.475,688,98,.348,282,282,23,54,297,425,.438,970,205,.830,247,72,52,2379,48,174,1153,SG,116,153,345,ORL,.489
338,Kelly Olynyk,168,.486,346,85,.405,210,105,24,33,209,253,.455,556,96,.750,128,69,8,1395,72,163,687,C,52,74,281,BOS,.531
339,Kelly Oubre,65,.492,132,25,.316,79,13,20,7,108,90,.427,211,31,.633,49,63,9,671,25,100,236,SF,22,34,133,WAS,.486
340,Zaza Pachulia,219,.469,467,0,.000,3,128,31,22,469,219,.466,470,212,.768,276,76,69,2004,249,181,650,C,64,119,718,DAL,.466
341,Kostas Papanikolaou,14,.412,34,10,.313,32,16,25,5,32,24,.364,66,9,.643,14,26,6,294,8,24,67,SF,13,21,40,DEN,.439
342,Jabari Parker,434,.502,864,9,.257,35,130,20,29,272,443,.493,899,175,.768,228,76,72,2408,123,154,1070,PF,69,116,395,MIL,.498
343,Tony Parker,323,.501,645,27,.415,65,379,33,11,159,350,.493,710,130,.760,171,72,72,1980,17,114,857,PG,54,131,176,SAS,.512
344,Chandler Parsons,216,.540,400,104,.414,251,169,27,21,256,320,.492,651,93,.684,136,61,51,1799,29,114,837,SF,46,95,285,DAL,.571
345,Lamar Patterson,16,.516,31,12,.245,49,39,24,2,46,28,.350,80,16,.727,22,35,0,395,4,45,84,SG,9,23,50,ATL,.425
346,Patrick Patterson,98,.490,200,106,.362,293,94,26,32,265,204,.414,493,29,.853,34,79,0,2020,77,128,543,PF,53,65,342,TOR,.521
347,Chris Paul,393,.501,785,122,.371,329,738,30,13,271,515,.462,1114,294,.896,328,74,74,2420,39,185,1446,PG,152,194,310,LAC,.517
348,Adreian Payne,44,.389,113,9,.281,32,29,24,11,91,53,.366,145,17,.654,26,52,2,486,20,77,132,PF,16,36,111,MIN,.397
349,Cameron Payne,78,.467,167,36,.324,111,108,21,6,76,114,.410,278,19,.792,24,57,1,698,9,80,283,PG,36,44,85,OKC,.475
350,Elfrid Payton,288,.451,638,30,.326,92,468,21,20,184,318,.436,730,112,.589,190,73,69,2145,77,159,778,PG,89,177,261,ORL,.456
351,Nikola Pekovic,19,.380,50,0,,0,11,30,0,14,19,.380,50,16,.800,20,12,3,156,7,22,54,C,1,9,21,MIN,.380
352,Kendrick Perkins,40,.533,75,0,,0,31,31,11,103,40,.533,75,11,.440,25,37,5,542,25,64,91,C,11,41,128,NOP,.533
353,Paul Pierce,69,.445,155,75,.310,242,71,38,17,174,144,.363,397,54,.818,66,68,38,1231,12,129,417,SF,33,58,186,LAC,.457
354,Tibor Pleiss,11,.478,23,0,.000,2,2,26,2,9,11,.440,25,2,1.000,2,12,0,82,6,19,24,C,1,8,15,UTA,.440
355,Mason Plumlee,267,.520,513,0,.000,4,226,25,85,427,267,.516,517,215,.642,335,82,82,2084,201,253,749,C,68,154,628,POR,.516
356,Miles Plumlee,140,.601,233,0,,0,16,27,50,138,140,.601,233,34,.576,59,61,14,870,94,73,314,C,21,40,232,MIL,.601
357,Otto Porter,241,.536,450,98,.367,267,120,22,32,294,339,.473,717,95,.754,126,75,73,2276,97,163,871,SF,105,70,391,WAS,.541
358,Bobby Portis,170,.443,384,16,.308,52,52,20,22,214,186,.427,436,48,.727,66,62,4,1102,123,100,436,PF,25,54,337,CHI,.445
359,Kristaps Porzingis,292,.454,643,81,.333,243,94,20,134,394,373,.421,886,201,.838,240,72,72,2047,132,205,1028,PF,53,121,526,NYK,.467
360,Dwight Powell,144,.514,280,2,.125,16,44,24,24,189,146,.493,296,105,.739,142,69,2,992,84,118,399,PF,36,40,273,DAL,.497
361,Norman Powell,61,.436,140,36,.404,89,47,22,10,95,97,.424,229,43,.811,53,49,24,725,16,59,273,SG,29,32,111,TOR,.502
362,Phil Pressey,26,.433,60,4,.222,18,75,24,4,28,30,.385,78,13,.520,25,23,0,283,3,28,77,PG,18,33,31,TOT,.410
363,Ronnie Price,48,.453,106,68,.347,196,147,32,13,74,116,.384,302,31,.756,41,62,18,1211,25,161,331,PG,74,70,99,PHO,.497
364,Pablo Prigioni,27,.519,52,28,.295,95,130,38,1,76,55,.374,147,7,.875,8,59,3,823,38,82,145,PG,53,49,114,LAC,.469
365,Tayshaun Prince,98,.476,206,4,.174,23,73,35,13,115,102,.445,229,13,.684,19,77,44,1462,32,62,221,SF,36,27,147,MIN,.454
366,Julius Randle,348,.436,799,10,.278,36,144,21,29,657,358,.429,835,193,.715,270,81,60,2286,172,242,919,PF,53,149,829,LAL,.435
367,Zach Randolph,425,.482,881,6,.231,26,142,34,13,350,431,.475,907,172,.796,216,68,53,2016,179,146,1040,PF,43,105,529,MEM,.479
368,J.J. Redick,222,.484,459,200,.475,421,106,31,5,129,422,.480,880,182,.888,205,75,75,2097,10,135,1226,SG,42,78,139,LAC,.593
369,Willie Reed,76,.571,133,0,,0,10,25,30,73,76,.571,133,30,.545,55,39,2,426,49,47,182,C,6,16,122,BRK,.571
370,Josh Richardson,70,.446,157,53,.461,115,73,22,25,86,123,.452,272,42,.667,63,52,2,1107,21,107,341,SG,36,35,107,MIA,.550
371,Austin Rivers,164,.495,331,62,.335,185,99,23,9,108,226,.438,516,79,.681,116,67,7,1464,22,137,593,SG,48,61,130,LAC,.498
372,Andre Roberson,104,.608,171,32,.311,103,47,24,42,172,136,.496,274,33,.611,54,70,70,1553,79,133,337,SG,53,35,251,OKC,.555
373,Brian Roberts,59,.480,123,15,.357,42,54,30,2,35,74,.448,165,42,.894,47,51,0,470,6,35,205,PG,10,23,41,TOT,.494
374,Glenn Robinson,51,.447,114,14,.378,37,26,22,9,56,65,.430,151,27,.692,39,45,4,508,12,21,171,SF,17,18,68,IND,.477
375,Nate Robinson,0,,0,0,.000,1,4,31,0,0,0,.000,1,0,,0,2,1,23,0,5,0,PG,1,0,0,NOP,.000
376,Thomas Robinson,130,.448,290,0,.000,1,46,24,36,223,130,.447,291,47,.431,109,71,7,917,136,111,307,PF,39,69,359,BRK,.447
377,Rajon Rondo,293,.479,612,62,.365,170,839,29,10,358,355,.454,782,87,.580,150,72,72,2537,77,175,859,PG,141,278,435,SAC,.494
378,Derrick Rose,403,.449,898,44,.293,150,311,27,14,179,447,.427,1048,142,.793,179,66,66,2097,46,84,1080,PG,44,175,225,CHI,.448
379,Terrence Ross,139,.484,287,131,.386,339,56,24,25,164,270,.431,626,49,.790,62,73,7,1747,21,120,720,SF,54,46,185,TOR,.536
380,Terry Rozier,23,.291,79,6,.222,27,37,21,1,39,29,.274,106,8,.800,10,39,0,311,24,23,72,PG,6,19,63,BOS,.302
381,Ricky Rubio,157,.396,396,62,.326,190,658,25,10,286,219,.374,586,266,.847,314,76,76,2323,40,201,766,PG,162,193,326,MIN,.427
382,Damjan Rudez,8,.667,12,17,.340,50,11,29,1,15,25,.403,62,8,1.000,8,33,0,277,5,33,75,SF,3,13,20,MIN,.540
383,Brandon Rush,46,.447,103,65,.414,157,57,30,23,160,111,.427,260,18,.643,28,72,25,1055,21,57,305,SG,20,33,181,GSW,.552
384,D'Angelo Russell,262,.447,586,130,.351,370,266,19,13,227,392,.410,956,140,.737,190,80,48,2259,47,142,1054,PG,93,196,274,LAL,.478
385,Robert Sacre,31,.413,75,0,,0,14,26,10,40,31,.413,75,25,.658,38,25,1,320,32,43,87,C,4,12,72,LAL,.413
386,JaKarr Sampson,126,.496,254,14,.222,63,46,22,33,144,140,.442,317,80,.656,122,73,40,1160,46,142,374,SF,23,70,190,TOT,.464
387,Dennis Schroder,252,.465,542,77,.322,239,349,22,9,179,329,.421,781,144,.791,182,80,6,1621,25,138,879,PG,70,183,204,ATL,.471
388,Luis Scola,204,.467,437,65,.404,161,66,35,27,276,269,.450,598,61,.726,84,76,76,1636,84,178,664,PF,46,68,360,TOR,.504
389,Mike Scott,114,.523,218,62,.392,158,78,27,17,153,176,.468,376,50,.794,63,75,0,1146,53,102,464,PF,25,42,206,ATL,.551
390,Thabo Sefolosha,146,.589,248,42,.339,124,107,31,37,282,188,.505,372,62,.626,99,75,11,1758,52,109,480,SF,85,68,334,ATL,.562
391,Kevin Seraphin,84,.414,203,0,.000,2,47,26,36,95,84,.410,205,19,.826,23,48,0,526,31,67,187,C,8,43,126,NYK,.410
392,Ramon Sessions,244,.507,481,36,.324,111,239,29,5,178,280,.473,592,214,.756,283,82,5,1667,25,102,810,PG,46,115,203,WAS,.503
393,Iman Shumpert,71,.447,159,43,.295,146,92,25,19,171,114,.374,305,40,.784,51,54,5,1316,32,119,311,SG,54,57,203,CLE,.444
394,Jonathon Simmons,104,.533,195,18,.383,47,58,26,5,80,122,.504,242,69,.750,92,55,2,813,16,103,331,SG,24,53,96,SAS,.541
395,Henry Sims,33,.429,77,0,,0,9,25,14,51,33,.429,77,25,.833,30,14,4,263,21,37,91,C,9,12,72,BRK,.429
396,Kyle Singler,56,.452,124,30,.309,97,24,27,9,91,86,.389,221,29,.659,44,68,2,977,50,120,231,SF,30,32,141,OKC,.457
397,Donald Sloan,116,.462,251,38,.384,99,268,28,4,156,154,.440,350,78,.750,104,61,33,1318,17,73,424,PG,32,80,173,BRK,.494
398,Marcus Smart,123,.427,288,61,.253,241,185,21,18,179,184,.348,529,129,.777,166,61,10,1667,76,183,558,PG,91,80,255,BOS,.405
399,Greg Smith,18,.563,32,0,,0,6,25,1,30,18,.563,32,7,.412,17,18,0,192,12,28,43,PF,4,7,42,MIN,.563
400,Ish Smith,341,.428,797,56,.329,170,502,27,24,262,397,.411,967,122,.693,176,77,53,2239,43,133,972,PG,88,175,305,TOT,.440
401,J.R. Smith,149,.438,340,204,.400,510,130,30,21,174,353,.415,850,45,.634,71,77,77,2362,43,204,955,SG,81,59,217,CLE,.535
402,Jason Smith,240,.493,487,4,.250,16,62,29,65,166,244,.485,503,54,.806,67,76,2,1181,53,163,546,C,33,57,219,ORL,.489
403,Josh Smith,86,.417,206,41,.287,143,90,30,47,141,127,.364,349,37,.552,67,55,7,880,51,118,332,PF,34,77,192,TOT,.423
404,Russ Smith,6,.353,17,1,.200,5,11,24,1,8,7,.318,22,8,.615,13,15,0,66,1,5,23,PG,5,7,9,MEM,.341
405,Tony Snell,70,.380,184,56,.361,155,63,24,17,180,126,.372,339,30,.909,33,64,33,1301,19,100,338,SF,16,52,199,CHI,.454
406,Marreese Speights,173,.439,394,24,.387,62,61,28,34,162,197,.432,456,94,.825,114,72,0,832,77,117,512,C,19,66,239,GSW,.458
407,Tiago Splitter,81,.529,153,0,.000,2,30,31,12,75,81,.523,155,39,.813,48,36,2,579,45,71,201,C,20,24,120,ATL,.523
408,Nik Stauskas,104,.473,220,106,.326,325,138,22,20,160,210,.385,545,91,.771,118,73,35,1809,23,115,617,SG,44,94,183,PHI,.483
409,Lance Stephenson,198,.500,396,30,.385,78,133,25,9,183,228,.481,474,87,.784,111,69,13,1372,40,135,573,SF,43,94,223,TOT,.513
410,Alex Stepheson,9,.333,27,0,,0,2,28,5,9,9,.333,27,4,.333,12,8,0,73,19,12,22,PF,1,0,28,TOT,.333
411,Jarnell Stokes,3,.600,5,0,,0,1,22,0,3,3,.600,5,1,.500,2,7,0,18,1,1,7,C,1,0,4,TOT,.600
412,Amar'e Stoudemire,125,.566,221,0,,0,27,33,41,157,125,.566,221,50,.746,67,52,36,762,65,92,300,C,18,47,222,MIA,.566
413,Rodney Stuckey,163,.453,360,20,.241,83,142,29,8,137,183,.413,443,131,.829,158,58,1,1275,19,77,517,PG,43,76,156,IND,.436
414,Jared Sullinger,322,.458,703,29,.282,103,187,23,47,479,351,.435,806,103,.640,161,81,73,1915,194,209,834,PF,75,102,673,BOS,.453
415,Edy Tavares,11,.579,19,0,,0,3,23,6,14,11,.579,19,3,.375,8,11,0,73,7,8,25,C,1,5,21,ATL,.579
416,Jeff Teague,324,.454,713,110,.400,275,470,27,24,181,434,.439,988,261,.837,312,79,78,2255,33,167,1239,PG,97,218,214,ATL,.495
417,Mirza Teletovic,151,.476,317,181,.393,460,89,30,21,247,332,.427,777,120,.774,155,79,1,1686,55,159,965,PF,32,84,302,PHO,.544
418,Garrett Temple,112,.453,247,89,.345,258,140,29,18,176,201,.398,505,91,.728,125,80,43,1951,36,195,582,SF,69,64,212,WAS,.486
419,Jason Terry,58,.504,115,93,.356,261,103,38,9,65,151,.402,376,27,.818,33,72,7,1258,14,91,422,SG,47,49,79,HOU,.525
420,Isaiah Thomas,424,.462,917,167,.359,465,509,26,9,197,591,.428,1382,474,.871,544,82,79,2644,46,167,1823,PG,91,220,243,BOS,.488
421,Lance Thomas,125,.458,273,44,.404,109,53,27,7,97,169,.442,382,102,.857,119,59,5,1313,34,109,484,PF,22,57,131,NYK,.500
422,Hollis Thompson,121,.420,288,149,.380,392,99,24,24,218,270,.397,680,69,.719,96,77,17,2154,54,187,758,SG,36,76,272,PHI,.507
423,Jason Thompson,47,.505,93,5,.333,15,29,29,20,102,52,.481,108,38,.704,54,47,7,471,32,80,147,C,12,15,134,TOT,.505
424,Klay Thompson,375,.510,736,276,.425,650,166,25,49,271,651,.470,1386,193,.873,221,80,80,2666,35,152,1771,SG,60,138,306,GSW,.569
425,Tristan Thompson,247,.588,420,0,,0,62,24,51,470,247,.588,420,149,.616,242,82,34,2269,268,202,643,PF,38,61,738,CLE,.588
426,Marcus Thornton,125,.460,272,91,.337,270,85,28,4,112,216,.399,542,67,.848,79,61,8,1109,38,90,590,SG,47,51,150,TOT,.482
427,Anthony Tolliver,30,.500,60,98,.360,272,52,30,16,190,128,.386,332,29,.617,47,72,5,1341,39,86,383,PF,26,28,229,DET,.533
428,Axel Toupane,12,.400,30,13,.325,40,15,23,6,23,25,.357,70,13,.765,17,21,0,305,8,40,76,SF,7,6,31,DEN,.450
429,Karl-Anthony Towns,595,.559,1065,30,.341,88,161,20,138,629,625,.542,1153,223,.811,275,82,82,2627,229,245,1503,C,58,183,858,MIN,.555
430,P.J. Tucker,171,.455,376,68,.330,206,177,30,20,347,239,.411,582,106,.746,142,82,80,2540,165,202,652,SF,106,111,512,PHO,.469
431,Evan Turner,323,.482,670,20,.241,83,359,27,28,347,343,.456,753,148,.827,179,81,12,2271,50,139,854,SG,80,169,397,BOS,.469
432,Myles Turner,261,.506,516,3,.214,14,41,19,86,264,264,.498,530,88,.727,121,60,30,1367,68,158,619,C,25,67,332,IND,.501
433,Beno Udrih,71,.461,154,15,.341,44,116,33,1,64,86,.434,198,18,.900,20,44,5,707,8,51,205,PG,14,53,72,TOT,.472
434,Jonas Valanciunas,303,.565,536,0,,0,42,23,80,363,303,.565,536,162,.761,213,60,59,1557,184,158,768,C,25,85,547,TOR,.565
435,Anderson Varejao,53,.431,123,0,.000,1,35,33,10,104,53,.427,124,32,.640,50,53,0,496,37,70,138,C,16,22,141,TOT,.427
436,Greivis Vasquez,27,.415,65,18,.247,73,91,29,0,42,45,.326,138,22,.846,26,23,0,460,5,42,130,PG,10,40,47,MIL,.391
437,Rashad Vaughn,38,.319,119,43,.293,147,39,19,16,77,81,.305,266,12,.800,15,70,6,1001,11,73,217,SG,29,28,88,MIL,.385
438,Charlie Villanueva,78,.503,155,47,.273,172,24,31,15,128,125,.382,327,22,.917,24,62,4,665,24,71,319,PF,18,31,152,DAL,.454
439,Noah Vonleh,106,.457,232,11,.239,46,30,20,26,214,117,.421,278,38,.745,51,78,56,1174,91,152,283,PF,27,50,305,POR,.441
440,Nikola Vucevic,531,.512,1037,2,.222,9,179,25,70,402,533,.510,1046,113,.753,150,65,60,2037,174,173,1181,C,53,123,576,ORL,.511
441,Sasha Vujacic,54,.403,134,52,.364,143,84,31,5,123,106,.383,277,32,.821,39,61,25,908,26,83,296,SG,34,44,149,NYK,.477
442,Dwyane Wade,533,.468,1139,7,.159,44,344,34,42,220,540,.456,1183,322,.793,406,74,73,2258,82,116,1409,SG,79,203,302,MIA,.459
443,Dion Waiters,196,.421,466,86,.358,240,154,24,15,166,282,.399,706,112,.713,157,78,15,2152,36,143,762,SG,81,120,202,OKC,.460
444,Kemba Walker,386,.459,841,182,.371,490,421,25,39,301,568,.427,1331,371,.847,438,81,81,2885,56,111,1689,PG,126,171,357,CHO,.495
445,John Wall,457,.448,1021,115,.351,328,789,25,59,337,572,.424,1349,272,.791,344,77,77,2784,42,159,1531,PG,145,318,379,WAS,.467
446,T.J. Warren,193,.520,371,28,.400,70,44,22,16,90,221,.501,441,45,.703,64,47,4,1070,57,94,515,SF,37,32,147,PHO,.533
447,C.J. Watson,33,.371,89,14,.292,48,88,31,5,56,47,.343,137,34,.872,39,33,2,656,10,49,142,PG,19,25,66,ORL,.394
448,Briante Weber,14,.412,34,0,.000,5,21,23,3,17,14,.359,39,3,.750,4,7,4,169,8,12,31,PG,9,9,25,TOT,.359
449,Sonny Weems,27,.391,69,15,.366,41,49,29,1,46,42,.382,110,8,.533,15,43,0,499,7,47,107,SG-SF,10,41,53,TOT,.450
450,David West,241,.546,441,3,.429,7,143,35,55,237,244,.545,448,63,.788,80,78,19,1404,72,142,554,PF,44,68,309,SAS,.548
451,Russell Westbrook,555,.503,1103,101,.296,341,834,27,20,481,656,.454,1444,465,.812,573,80,80,2750,145,200,1878,PG,163,342,626,OKC,.489
452,Hassan Whiteside,413,.606,682,0,,0,30,26,269,627,413,.606,682,214,.650,329,73,43,2125,238,201,1040,C,44,137,865,MIA,.606
453,Shayne Whittington,5,.556,9,0,.000,2,3,24,1,7,5,.455,11,1,.500,2,7,0,41,5,7,11,PF,1,5,12,IND,.455
454,Andrew Wiggins,537,.486,1104,57,.300,190,164,20,46,186,594,.459,1294,430,.761,565,81,81,2845,105,165,1675,SF,78,182,291,MIN,.481
455,C.J. Wilcox,17,.395,43,9,.391,23,10,25,2,11,26,.394,66,9,.750,12,23,0,167,1,15,70,SG,10,2,12,LAC,.462
456,Alan Williams,10,.417,24,0,,0,5,23,5,24,10,.417,24,9,.643,14,10,0,68,14,15,29,PF,4,6,38,PHO,.417
457,Deron Williams,224,.454,493,97,.344,282,378,31,14,171,321,.414,775,179,.869,206,65,63,2106,19,155,918,PG,61,150,190,DAL,.477
458,Derrick Williams,210,.506,415,44,.293,150,75,24,9,249,254,.450,565,194,.758,256,80,9,1435,47,69,746,SF,29,61,296,NYK,.488
459,Elliot Williams,1,.167,6,1,.250,4,4,26,0,3,2,.200,10,3,.750,4,5,0,45,1,2,8,PG,0,1,4,MEM,.250
460,Lou Williams,173,.464,373,110,.344,320,167,29,19,138,283,.408,693,352,.830,424,67,35,1907,31,107,1028,SG,62,107,169,LAL,.488
461,Marvin Williams,186,.504,369,152,.402,378,110,29,77,394,338,.452,747,120,.833,144,81,81,2338,127,133,948,PF,58,62,521,CHO,.554
462,Mo Williams,96,.480,200,36,.353,102,98,33,5,66,132,.437,302,38,.905,42,41,14,748,6,60,338,PG,14,57,72,CLE,.497
463,Justise Winslow,163,.471,346,32,.276,116,117,19,26,322,195,.422,462,80,.684,117,78,8,2232,81,184,502,SF,68,95,403,MIA,.457
464,Jeff Withey,87,.544,160,0,.000,2,20,25,53,117,87,.537,162,43,.729,59,51,10,658,56,75,217,C,21,28,173,UTA,.537
465,Christian Wood,18,.429,42,4,.364,11,3,20,7,25,22,.415,53,13,.619,21,17,0,145,13,11,61,PF,5,2,38,PHI,.453
466,Metta World Peace,29,.312,93,26,.310,84,27,36,11,70,55,.311,177,40,.702,57,35,5,590,19,67,176,SF,22,15,89,LAL,.384
467,Brandan Wright,35,.673,52,0,,0,6,28,15,29,35,.673,52,13,.542,24,12,2,212,14,21,83,PF,5,10,43,MEM,.673
468,Delon Wright,31,.463,67,5,.385,13,31,23,3,29,36,.450,80,26,.743,35,27,1,229,8,7,103,PG,8,16,37,TOR,.481
469,Tony Wroten,19,.396,48,3,.176,17,20,22,0,19,22,.338,65,20,.541,37,8,3,144,2,11,67,PG,3,29,21,PHI,.362
470,James Young,5,.500,10,6,.231,26,9,20,1,22,11,.306,36,1,.250,4,29,0,199,4,17,29,SG,6,5,26,BOS,.389
471,Joe Young,52,.423,123,10,.217,46,65,23,0,44,62,.367,169,20,.800,25,41,0,384,6,30,154,PG,15,33,50,IND,.396
472,Nick Young,49,.363,135,77,.325,237,34,30,7,83,126,.339,372,63,.829,76,54,2,1033,14,50,392,SG,23,30,97,LAL,.442
473,Thaddeus Young,488,.523,933,7,.233,30,135,27,37,484,495,.514,963,105,.644,163,73,73,2407,176,182,1102,PF,112,136,660,BRK,.518
474,Cody Zeller,230,.539,427,1,.100,10,71,23,63,317,231,.529,437,175,.754,232,73,60,1774,138,204,638,C,57,68,455,CHO,.530
475,Tyler Zeller,138,.476,290,0,,0,29,26,22,116,138,.476,290,88,.815,108,60,3,710,62,97,364,C,10,46,178,BOS,.476
