,Player_Name,2P,2P%,2PA,3P,3P%,3PA,AST,Age,BLK,DRB,FG,FG%,FGA,FT,FT%,FTA,Games,Games_Strated,Minutes_Played,ORB,PF,PTS,Position,STL,TOV,TRB,Team,eFG%
0,Alex Abrines,40,.426,94,94,.381,247,40,23,8,68,134,.393,341,44,.898,49,68,6,1055,18,114,406,SG,37,33,86,OKC,.531
1,Quincy Acy,33,.413,80,37,.411,90,18,26,15,95,70,.412,170,45,.750,60,38,1,558,20,67,222,PF,14,21,115,TOT,.521
2,Steven Adams,374,.572,654,0,.000,1,86,23,78,332,374,.571,655,157,.611,257,80,80,2389,281,195,905,C,89,146,613,OKC,.571
3,Arron Afflalo,123,.457,269,62,.411,151,78,31,6,116,185,.440,420,83,.892,93,61,45,1580,9,104,515,SG,21,42,125,SAC,.514
4,Alexis Ajinca,89,.511,174,0,.000,4,12,28,22,131,89,.500,178,29,.725,40,39,15,584,46,77,207,C,20,31,177,NOP,.500
5,Cole Aldrich,45,.523,86,0,,0,25,28,23,107,45,.523,86,15,.682,22,62,0,531,51,85,105,C,25,17,158,MIN,.523
6,LaMarcus Aldridge,477,.480,993,23,.411,56,139,31,88,351,500,.477,1049,220,.812,271,72,72,2335,172,158,1243,PF,46,98,523,SAS,.488
7,Lavoy Allen,77,.461,167,0,.000,1,57,27,24,114,77,.458,168,23,.697,33,61,5,871,105,78,177,PF,18,29,219,IND,.458
8,Tony Allen,259,.479,541,15,.278,54,98,35,29,225,274,.461,595,80,.615,130,71,66,1914,166,178,643,SG,115,100,391,MEM,.473
9,Al-Farouq Aminu,113,.445,254,70,.330,212,99,26,44,374,183,.393,466,96,.706,136,61,25,1773,77,102,532,SF,60,94,451,POR,.468
10,Chris Andersen,9,.474,19,0,.000,3,5,38,7,22,9,.409,22,10,.714,14,12,0,114,9,20,28,C,5,5,31,CLE,.409
11,Alan Anderson,16,.444,36,14,.318,44,11,34,0,21,30,.375,80,12,.750,16,30,0,308,3,35,86,SF,3,7,24,LAC,.463
12,Justin Anderson,128,.522,245,58,.299,194,66,23,23,176,186,.424,439,102,.791,129,75,10,1228,69,109,532,SF,41,66,245,TOT,.490
13,Kyle Anderson,78,.462,169,15,.375,40,91,23,26,175,93,.445,209,45,.789,57,72,14,1020,33,63,246,SG,51,39,208,SAS,.481
14,Ryan Anderson,119,.446,267,204,.403,506,68,28,14,218,323,.418,773,129,.860,150,72,72,2116,112,142,979,PF,31,55,330,HOU,.550
15,Giannis Antetokounmpo,607,.563,1079,49,.272,180,434,22,151,558,656,.521,1259,471,.770,612,80,80,2845,142,246,1832,SF,131,234,700,MIL,.541
16,Carmelo Anthony,451,.466,968,151,.359,421,213,32,34,376,602,.433,1389,304,.833,365,74,74,2538,62,198,1659,SF,60,153,438,NYK,.488
17,Joel Anthony,10,.625,16,0,,0,3,34,6,23,10,.625,16,5,.625,8,19,0,122,8,11,25,C,2,4,31,SAS,.625
18,Trevor Ariza,135,.556,243,191,.344,555,175,31,20,404,326,.409,798,93,.738,126,80,80,2773,54,133,936,SF,147,73,458,HOU,.528
19,Darrell Arthur,42,.429,98,53,.453,117,42,28,21,87,95,.442,215,19,.864,22,41,7,639,25,76,262,PF,19,36,112,DEN,.565
20,Omer Asik,31,.477,65,0,,0,15,30,10,115,31,.477,65,23,.590,39,31,19,482,48,51,85,C,5,14,163,NOP,.477
21,D.J. Augustin,100,.412,243,95,.347,274,209,29,1,102,195,.377,517,131,.814,161,78,20,1538,15,101,616,PG,31,90,117,ORL,.469
22,Luke Babbitt,26,.366,71,87,.414,210,36,27,11,129,113,.402,281,11,.733,15,68,55,1065,12,118,324,SF,20,25,141,MIA,.557
23,Ron Baker,59,.450,131,23,.267,86,107,23,8,86,82,.378,217,28,.651,43,52,13,857,12,74,215,SG,34,56,98,NYK,.431
24,Wade Baldwin,33,.355,93,3,.136,22,61,20,7,35,36,.313,115,31,.838,37,33,1,405,11,40,106,PG,18,39,46,MEM,.326
25,Leandro Barbosa,137,.466,294,35,.357,98,81,34,8,89,172,.439,392,40,.889,45,67,0,963,15,82,419,SG,31,48,104,PHO,.483
26,J.J. Barea,89,.456,195,53,.358,148,193,32,1,75,142,.414,343,44,.863,51,35,6,771,9,30,381,PG,14,63,84,DAL,.491
27,Harrison Barnes,521,.492,1058,78,.351,222,116,24,15,301,599,.468,1280,242,.861,281,79,79,2803,93,128,1518,PF,65,102,394,DAL,.498
28,Matt Barnes,98,.467,210,87,.331,263,195,36,26,314,185,.391,473,70,.787,89,74,18,1777,70,185,527,SF,48,107,384,TOT,.483
29,Will Barton,208,.483,431,87,.370,235,206,26,28,201,295,.443,666,143,.753,190,60,19,1705,58,110,820,SG,48,97,259,DEN,.508
30,Brandon Bass,106,.579,183,1,.333,3,21,31,11,86,107,.575,186,77,.875,88,52,0,577,43,45,292,PF,14,29,129,LAC,.578
31,Nicolas Batum,258,.453,570,135,.333,405,456,28,29,435,393,.403,975,243,.856,284,77,77,2617,46,109,1164,SG,86,194,481,CHO,.472
32,Jerryd Bayless,9,.333,27,2,.400,5,13,28,0,9,11,.344,32,9,.900,10,3,1,71,3,4,33,PG,0,9,12,PHI,.375
33,Aron Baynes,143,.513,279,0,,0,32,30,39,222,143,.513,279,79,.840,94,75,2,1163,111,166,365,C,17,50,333,DET,.513
34,Kent Bazemore,203,.446,455,92,.346,266,177,27,52,186,295,.409,721,119,.708,168,73,64,1963,45,165,801,SF,91,125,231,ATL,.473
35,Bradley Beal,414,.538,770,223,.404,552,267,23,21,187,637,.482,1322,282,.825,342,77,77,2684,53,169,1779,SG,83,156,240,WAS,.566
36,Malik Beasley,24,.533,45,9,.321,28,11,20,0,12,33,.452,73,8,.800,10,22,1,165,5,10,83,SG,7,8,17,DEN,.514
37,Michael Beasley,198,.545,363,18,.419,43,53,28,27,153,216,.532,406,78,.743,105,56,6,935,40,92,528,PF,27,66,193,MIL,.554
38,Marco Belinelli,162,.488,332,102,.360,283,147,30,9,164,264,.429,615,150,.893,168,74,0,1778,14,90,780,SG,44,70,178,CHO,.512
39,DeAndre' Bembry,46,.575,80,1,.056,18,28,22,5,45,47,.480,98,6,.375,16,38,1,371,14,21,101,SF,8,16,59,ATL,.485
40,Dragan Bender,29,.483,60,28,.277,101,23,19,22,80,57,.354,161,4,.364,11,43,0,574,23,74,146,PF,10,32,103,PHO,.441
41,Anthony Bennett,25,.568,44,13,.271,48,12,23,3,53,38,.413,92,26,.722,36,23,1,264,25,18,115,PF,5,12,78,BRK,.484
42,Ben Bentil,0,.000,2,0,.000,1,0,21,0,2,0,.000,3,0,,0,3,0,10,0,1,0,PF,0,1,2,DAL,.000
43,Davis Bertans,34,.557,61,69,.399,173,46,24,28,76,103,.440,234,28,.824,34,67,6,808,22,75,303,PF,20,32,98,SAS,.588
44,Patrick Beverley,118,.463,255,110,.382,288,281,28,25,298,228,.420,543,73,.768,95,67,67,2058,95,222,639,SG,99,100,393,HOU,.521
45,Bismack Biyombo,179,.528,339,0,,0,74,24,91,410,179,.528,339,125,.534,234,81,27,1793,157,202,483,C,25,95,567,ORL,.528
46,Nemanja Bjelica,95,.531,179,56,.316,177,79,28,20,187,151,.424,356,45,.738,61,65,1,1190,57,154,403,PF,40,59,244,MIN,.503
47,Tarik Black,149,.510,292,1,.500,2,39,25,44,199,150,.510,294,82,.752,109,67,16,1091,144,173,383,C,29,58,343,LAL,.512
48,Eric Bledsoe,345,.477,724,104,.335,310,418,27,31,268,449,.434,1034,388,.847,458,66,66,2176,52,164,1390,PG,91,224,320,PHO,.485
49,Bojan Bogdanovic,232,.512,453,144,.367,392,111,27,7,240,376,.445,845,217,.893,243,81,54,2083,37,146,1113,SF,34,131,277,TOT,.530
50,Andrew Bogut,38,.475,80,0,.000,1,49,32,25,162,38,.469,81,3,.273,11,27,21,583,56,86,79,C,13,43,218,TOT,.469
51,Joel Bolomboy,8,.667,12,1,.250,4,2,23,2,13,9,.563,16,3,.500,6,12,0,53,4,1,22,PF,1,2,17,UTA,.594
52,Devin Booker,459,.447,1026,147,.363,405,268,20,21,203,606,.423,1431,367,.832,441,78,78,2730,46,242,1726,SG,72,241,249,PHO,.475
53,Trevor Booker,280,.546,513,25,.321,78,138,29,28,428,305,.516,591,74,.673,110,71,43,1754,143,152,709,PF,75,127,571,BRK,.537
54,Avery Bradley,251,.504,498,108,.390,277,122,26,11,269,359,.463,775,68,.731,93,55,55,1835,65,141,894,SG,68,88,334,BOS,.533
55,Corey Brewer,120,.522,230,27,.229,118,97,30,20,134,147,.422,348,50,.735,68,82,11,1281,32,133,371,SF,61,55,166,TOT,.461
56,Malcolm Brogdon,212,.480,442,78,.404,193,317,24,12,166,290,.457,635,109,.865,126,75,28,1982,47,140,767,SG,84,113,213,MIL,.518
57,Aaron Brooks,73,.424,172,48,.375,128,125,32,9,51,121,.403,300,32,.800,40,65,0,894,18,93,322,PG,25,66,69,IND,.483
58,Anthony Brown,11,.478,23,7,.259,27,8,24,1,25,18,.360,50,0,,0,11,0,159,8,15,43,SF,5,6,33,TOT,.430
59,Bobby Brown,9,.360,25,14,.400,35,14,32,0,6,23,.383,60,2,1.000,2,25,0,123,0,5,62,PG,1,5,6,HOU,.500
60,Jaylen Brown,146,.507,288,46,.341,135,64,20,18,175,192,.454,423,85,.685,124,78,20,1341,45,142,515,SF,35,68,220,BOS,.508
61,Nicolas Brussino,23,.500,46,29,.305,95,47,23,8,69,52,.369,141,17,.773,22,54,2,521,26,43,150,SF,17,26,95,DAL,.472
62,Reggie Bullock,26,.473,55,28,.384,73,29,25,3,51,54,.422,128,5,.714,7,31,5,467,13,22,141,SF,18,10,64,DET,.531
63,Trey Burke,85,.459,185,31,.443,70,100,24,5,40,116,.455,255,22,.759,29,57,0,703,7,54,285,PG,11,48,47,WAS,.516
64,Alec Burks,74,.430,172,25,.329,76,30,25,5,103,99,.399,248,60,.769,78,42,0,653,17,50,283,SG,18,35,120,UTA,.450
65,Jimmy Butler,479,.477,1004,91,.367,248,417,27,32,341,570,.455,1252,585,.865,676,76,75,2809,129,112,1816,SF,143,159,470,CHI,.492
66,Bruno Caboclo,4,.400,10,2,.333,6,4,21,1,5,6,.375,16,0,,0,9,0,40,5,4,14,SF,2,2,10,TOR,.438
67,Jose Calderon,35,.500,70,20,.313,64,88,35,1,59,55,.410,134,11,.917,12,41,13,539,15,36,141,PG,11,41,74,TOT,.485
68,Kentavious Caldwell-Pope,217,.442,491,153,.350,437,193,23,12,193,370,.399,928,154,.832,185,76,75,2529,55,118,1047,SG,89,86,248,DET,.481
69,Isaiah Canaan,38,.481,79,25,.266,94,37,25,1,44,63,.364,173,30,.909,33,39,0,592,6,35,181,SG,22,21,50,CHI,.436
70,Clint Capela,362,.643,563,0,,0,63,22,79,348,362,.643,563,94,.531,177,65,59,1551,178,179,818,C,34,87,526,HOU,.643
71,DeMarre Carroll,111,.483,230,109,.341,320,74,30,27,212,220,.400,550,89,.761,117,72,72,1882,63,143,638,SF,81,54,275,TOR,.499
72,Vince Carter,81,.418,194,112,.378,296,133,40,36,191,193,.394,490,88,.765,115,73,15,1799,36,163,586,SF,60,50,227,MEM,.508
73,Michael Carter-Williams,97,.401,242,15,.234,64,113,25,23,129,112,.366,306,58,.753,77,45,19,846,24,102,297,PG,38,66,153,CHI,.391
74,Omri Casspi,62,.512,121,15,.349,43,37,28,3,85,77,.470,164,17,.586,29,36,2,643,27,50,186,SF,23,29,112,TOT,.515
75,Willie Cauley-Stein,255,.532,479,0,.000,2,80,23,44,254,255,.530,481,101,.669,151,75,21,1421,85,147,611,C,53,69,339,SAC,.530
76,Tyson Chandler,153,.671,228,0,,0,30,34,24,386,153,.671,228,91,.734,124,47,46,1298,153,126,397,C,33,65,539,PHO,.671
77,Wilson Chandler,323,.527,613,110,.337,326,141,29,30,357,433,.461,939,141,.727,194,71,33,2197,103,172,1117,SF,51,114,460,DEN,.520
78,Marquese Chriss,212,.520,408,72,.321,224,60,19,70,252,284,.449,632,113,.624,181,82,75,1743,96,263,753,PF,67,108,348,PHO,.506
79,Rakeem Christmas,19,.442,43,0,,0,4,25,6,30,19,.442,43,21,.724,29,29,0,219,26,37,59,PF,3,8,56,IND,.442
80,Semaj Christon,65,.406,160,12,.190,63,130,24,7,68,77,.345,223,17,.548,31,64,1,973,19,79,183,PG,28,43,87,OKC,.372
81,Ian Clark,150,.556,270,61,.374,163,90,25,8,99,211,.487,433,44,.759,58,77,0,1137,22,77,527,SG,39,55,121,GSW,.558
82,Jordan Clarkson,360,.503,715,117,.329,356,213,24,8,197,477,.445,1071,134,.798,168,82,19,2397,49,150,1205,SG,88,164,246,LAL,.500
83,Norris Cole,13,.333,39,3,.231,13,14,28,0,11,16,.308,52,8,.800,10,13,0,125,0,18,43,PG,8,7,11,OKC,.337
84,Darren Collison,267,.495,539,73,.417,175,312,29,9,129,340,.476,714,147,.860,171,68,64,2063,23,119,900,PG,67,114,152,SAC,.527
85,Nick Collison,14,.636,22,0,.000,1,12,36,2,22,14,.609,23,5,.625,8,20,0,128,9,17,33,PF,2,4,31,OKC,.609
86,Mike Conley,293,.497,590,171,.408,419,433,29,19,210,464,.460,1009,316,.859,368,69,68,2292,31,126,1415,PG,92,156,241,MEM,.545
87,Pat Connaughton,20,.513,39,17,.515,33,28,24,2,42,37,.514,72,7,.778,9,39,1,316,10,23,98,SG,6,17,52,POR,.632
88,Quinn Cook,22,.550,40,11,.423,26,26,23,0,6,33,.500,66,2,.400,5,14,0,188,1,13,79,PG,4,13,7,TOT,.583
89,DeMarcus Cousins,516,.483,1069,131,.361,363,332,26,93,642,647,.452,1432,517,.772,670,72,72,2465,152,278,1942,C,100,269,794,TOT,.498
90,Robert Covington,155,.484,320,137,.333,412,102,26,69,344,292,.399,732,143,.822,174,67,67,2119,92,203,864,SF,127,131,436,PHI,.492
91,Allen Crabbe,169,.490,345,134,.444,302,94,24,20,207,303,.468,647,105,.847,124,79,7,2254,19,171,845,SG,54,62,226,POR,.572
92,Jamal Crawford,243,.443,548,116,.360,322,214,36,14,112,359,.413,870,174,.857,203,82,1,2157,17,115,1008,SG,61,134,129,LAC,.479
93,Jordan Crawford,68,.553,123,37,.389,95,57,28,2,30,105,.482,218,20,.769,26,19,0,442,4,30,267,SG,11,25,34,NOP,.567
94,Jae Crowder,176,.540,326,157,.398,394,155,26,23,367,333,.463,720,176,.811,217,72,72,2335,48,161,999,SF,73,80,415,BOS,.572
95,Dante Cunningham,103,.579,178,71,.392,181,37,29,28,221,174,.485,359,16,.593,27,66,35,1649,56,100,435,SF,39,28,277,NOP,.584
96,Seth Curry,201,.528,381,137,.425,322,189,26,7,154,338,.481,703,85,.850,100,70,42,2029,25,126,898,PG,79,92,179,DAL,.578
97,Stephen Curry,351,.537,654,324,.411,789,524,28,17,292,675,.468,1443,325,.898,362,79,79,2638,61,183,1999,PG,142,239,353,GSW,.580
98,Troy Daniels,47,.336,140,138,.389,355,46,25,4,78,185,.374,495,43,.796,54,67,3,1183,22,90,551,SG,20,45,100,MEM,.513
99,Anthony Davis,730,.524,1392,40,.299,134,157,23,167,712,770,.505,1526,519,.802,647,75,75,2708,172,168,2099,C,94,181,884,NOP,.518
100,Deyonta Davis,24,.511,47,0,,0,2,20,17,40,24,.511,47,10,.556,18,36,0,238,20,40,58,C,3,8,60,MEM,.511
101,Ed Davis,75,.528,142,0,,0,26,27,22,148,75,.528,142,50,.617,81,46,12,789,96,137,200,PF,15,37,244,POR,.528
102,Dewayne Dedmon,161,.622,259,0,,0,44,27,61,367,161,.622,259,65,.699,93,76,37,1330,129,180,387,C,37,61,496,SAS,.622
103,Sam Dekker,143,.591,242,60,.321,187,76,22,21,190,203,.473,429,38,.559,68,77,2,1419,94,83,504,SF,38,41,284,HOU,.543
104,Malcolm Delaney,119,.428,278,26,.236,110,193,27,1,113,145,.374,388,75,.806,93,73,2,1248,10,112,391,PG,39,95,123,ATL,.407
105,Matthew Dellavedova,129,.404,319,79,.367,215,357,26,0,123,208,.390,534,82,.854,96,76,54,1986,24,153,577,PG,53,133,147,MIL,.463
106,Luol Deng,113,.436,259,51,.309,165,74,31,20,232,164,.387,424,46,.730,63,56,49,1486,63,61,425,SF,48,43,295,LAL,.447
107,DeMar DeRozan,688,.484,1421,33,.266,124,290,27,13,316,721,.467,1545,545,.842,647,74,74,2620,70,134,2020,SG,78,180,386,TOR,.477
108,Cheick Diallo,36,.474,76,0,,0,4,20,7,50,36,.474,76,15,.714,21,17,0,199,23,17,87,PF,4,7,73,NOP,.474
109,Boris Diaw,126,.512,246,20,.247,81,170,34,9,112,146,.446,327,26,.743,35,73,33,1283,46,83,338,PF,18,87,158,UTA,.477
110,Gorgui Dieng,316,.511,618,16,.372,43,158,27,95,459,332,.502,661,136,.814,167,82,82,2653,188,254,816,PF,88,107,647,MIN,.514
111,Spencer Dinwiddie,96,.478,201,38,.376,101,185,23,23,137,134,.444,302,126,.792,159,59,18,1334,27,119,432,PG,44,66,164,BRK,.507
112,Toney Douglas,36,.480,75,7,.167,42,56,30,5,48,43,.368,117,24,.828,29,24,0,394,13,50,117,PG,18,21,61,MEM,.397
113,Goran Dragic,417,.499,835,117,.405,289,423,30,13,217,534,.475,1124,298,.790,377,73,73,2459,62,199,1483,PG,89,212,279,MIA,.527
114,Andre Drummond,481,.532,904,2,.286,7,90,23,89,770,483,.530,911,137,.386,355,81,81,2409,345,237,1105,C,124,152,1115,DET,.531
115,Jared Dudley,80,.559,143,77,.379,203,121,31,16,194,157,.454,346,43,.662,65,64,7,1362,31,154,434,PF,42,73,225,PHO,.565
116,Mike Dunleavy,40,.465,86,53,.396,134,50,36,7,97,93,.423,220,36,.800,45,53,2,841,18,67,275,SF,15,28,115,TOT,.543
117,Kris Dunn,97,.404,240,21,.288,73,188,22,36,142,118,.377,313,36,.610,59,78,7,1333,24,178,293,PG,78,89,166,MIN,.411
118,Kevin Durant,434,.608,714,117,.375,312,300,28,99,474,551,.537,1026,336,.875,384,62,62,2070,39,117,1555,SF,66,138,513,GSW,.594
119,Jarell Eddie,2,.667,3,4,.250,16,0,25,0,6,6,.316,19,8,.889,9,5,0,62,1,1,24,SF,1,1,7,PHO,.421
120,Henry Ellenson,13,.448,29,10,.286,35,7,20,1,33,23,.359,64,4,.500,8,19,2,146,8,6,60,PF,1,14,41,DET,.438
121,Wayne Ellington,82,.509,161,149,.378,394,70,29,4,114,231,.416,555,37,.860,43,62,13,1500,18,70,648,SG,35,30,132,MIA,.550
122,Monta Ellis,204,.483,422,43,.319,135,236,31,27,185,247,.443,557,93,.727,128,74,33,1998,19,149,630,SG,78,135,204,IND,.482
123,Joel Embiid,164,.495,331,36,.367,98,66,22,76,182,200,.466,429,191,.783,244,31,31,786,61,112,627,C,27,117,243,PHI,.508
124,James Ennis,95,.516,184,51,.372,137,64,26,19,190,146,.455,321,86,.782,110,64,28,1501,69,165,429,SF,46,59,259,MEM,.534
125,Tyler Ennis,63,.457,138,27,.386,70,86,22,2,36,90,.433,208,21,.840,25,53,2,588,9,58,228,PG,25,45,45,TOT,.498
126,Tyreke Evans,108,.429,252,42,.356,118,124,27,9,124,150,.405,370,69,.750,92,40,6,788,13,60,411,SF,35,61,137,TOT,.462
127,Dante Exum,111,.519,214,44,.295,149,111,21,12,102,155,.427,363,58,.795,73,66,26,1228,30,146,412,PG,21,80,132,UTA,.488
128,Kenneth Faried,228,.556,410,0,.000,6,55,27,40,279,228,.548,416,131,.693,189,61,34,1296,183,124,587,PF,43,59,462,DEN,.548
129,Jordan Farmar,0,.000,3,4,.444,9,9,30,0,2,4,.333,12,0,,0,2,0,35,1,1,12,PG,2,3,3,SAC,.500
130,Derrick Favors,200,.491,407,3,.300,10,56,25,40,213,203,.487,417,67,.615,109,50,39,1186,92,103,476,PF,45,60,305,UTA,.490
131,Kay Felder,55,.404,136,7,.318,22,58,21,7,38,62,.392,158,35,.714,49,42,0,386,3,38,166,PG,18,30,41,CLE,.415
132,Cristiano Felicio,128,.579,221,0,,0,40,24,17,187,128,.579,221,60,.645,93,66,0,1040,124,110,316,C,25,33,311,CHI,.579
133,Raymond Felton,175,.473,370,46,.319,144,191,32,22,185,221,.430,514,50,.781,64,80,11,1700,33,125,538,PG,66,83,218,LAC,.475
134,Yogi Ferrell,92,.422,218,68,.386,176,172,23,9,91,160,.406,394,74,.831,89,46,29,1197,20,90,462,PG,42,70,111,TOT,.492
135,Dorian Finney-Smith,68,.479,142,56,.293,191,67,23,25,167,124,.372,333,46,.754,61,81,35,1642,55,125,350,PF,52,45,222,DAL,.456
136,Bryn Forbes,19,.413,46,17,.321,53,23,23,0,21,36,.364,99,5,.833,6,36,0,285,2,20,94,SG,1,11,23,SAS,.449
137,Evan Fournier,280,.491,570,128,.356,360,202,24,4,165,408,.439,930,223,.805,277,68,66,2234,44,180,1167,SG,66,141,209,ORL,.508
138,Randy Foye,51,.418,122,67,.330,203,135,33,9,146,118,.363,325,54,.857,63,69,40,1284,9,99,357,SG,35,80,155,BRK,.466
139,Tim Frazier,123,.446,276,40,.313,128,335,26,6,139,163,.403,404,98,.760,129,65,35,1525,34,133,464,PG,56,101,173,NOP,.453
140,Channing Frye,101,.546,185,137,.409,335,45,33,37,253,238,.458,520,63,.851,74,74,15,1398,37,138,676,C,33,53,290,CLE,.589
141,Danilo Gallinari,209,.491,426,126,.389,324,135,28,15,286,335,.447,750,349,.902,387,63,63,2134,39,93,1145,SF,40,82,325,DEN,.531
142,Langston Galloway,87,.367,237,120,.390,308,93,25,6,129,207,.380,545,51,.797,64,74,2,1495,27,96,585,PG,46,46,156,TOT,.490
143,Patricio Garino,0,.000,2,0,.000,5,0,23,0,6,0,.000,7,0,,0,5,0,43,1,4,0,SG,0,3,7,ORL,.000
144,Marc Gasol,428,.480,892,104,.388,268,338,32,99,404,532,.459,1160,278,.837,332,74,74,2531,60,171,1446,C,67,166,464,MEM,.503
145,Pau Gasol,247,.494,500,56,.538,104,150,36,70,394,303,.502,604,130,.707,184,64,39,1627,107,110,792,C,24,81,501,SAS,.548
146,Rudy Gay,159,.483,329,42,.372,113,83,30,26,155,201,.455,442,118,.855,138,30,30,1013,35,79,562,SF,44,74,190,SAC,.502
147,Michael Gbinije,1,.167,6,0,.000,4,2,24,0,1,1,.100,10,2,1.000,2,9,0,32,2,2,4,SG,0,0,3,DET,.100
148,Alonzo Gee,3,.273,11,0,.000,3,6,29,1,11,3,.214,14,5,.556,9,13,0,89,4,14,11,SF,5,4,15,DEN,.214
149,Paul George,427,.501,852,195,.393,496,251,26,27,434,622,.461,1348,336,.898,374,75,75,2689,58,206,1775,SF,119,220,492,IND,.534
150,Marcus Georges-Hunt,1,.200,5,1,.500,2,3,22,0,8,2,.286,7,9,.900,10,5,0,48,1,5,14,SG,1,2,9,ORL,.357
151,Jonathan Gibson,20,.400,50,15,.333,45,26,29,0,21,35,.368,95,21,.724,29,17,0,231,1,21,106,PG,8,21,22,DAL,.447
152,Taj Gibson,362,.520,696,3,.231,13,73,31,65,327,365,.515,709,113,.715,158,78,71,1989,158,163,846,PF,41,105,485,TOT,.517
153,Manu Ginobili,82,.387,212,89,.392,227,183,39,16,129,171,.390,439,86,.804,107,69,0,1291,28,119,517,SG,82,96,157,SAS,.491
154,Rudy Gobert,413,.662,624,0,.000,1,97,24,214,721,413,.661,625,311,.653,476,81,81,2744,314,246,1137,C,49,147,1035,UTA,.661
155,Archie Goodwin,31,.608,51,5,.333,15,24,22,5,21,36,.545,66,33,.786,42,15,0,214,7,8,110,SG,4,14,28,TOT,.583
156,Aaron Gordon,316,.528,598,77,.288,267,150,21,40,289,393,.454,865,156,.719,217,80,72,2298,116,172,1019,SF,65,89,405,ORL,.499
157,Eric Gordon,166,.468,355,246,.372,661,188,28,41,172,412,.406,1016,147,.840,175,75,15,2323,29,150,1217,SG,48,121,201,HOU,.527
158,Marcin Gortat,390,.580,672,0,.000,2,121,32,61,611,390,.579,674,103,.648,159,82,82,2556,238,213,883,C,40,119,849,WAS,.579
159,Treveon Graham,10,.400,25,9,.600,15,6,23,1,17,19,.475,40,10,.667,15,27,1,189,5,18,57,SG,6,3,22,CHO,.588
160,Jerami Grant,109,.514,212,43,.371,116,46,22,79,167,152,.463,328,90,.612,147,80,4,1531,38,149,437,PF,33,44,205,TOT,.529
161,Jerian Grant,79,.473,167,49,.366,134,121,24,8,94,128,.425,301,65,.890,73,63,28,1028,17,93,370,PG,47,44,111,CHI,.507
162,Danny Green,58,.420,138,118,.379,311,124,29,57,193,176,.392,449,27,.844,32,68,68,1807,31,120,497,SG,70,76,224,SAS,.523
163,Draymond Green,191,.494,387,81,.308,263,533,26,106,501,272,.418,650,151,.709,213,76,76,2471,98,217,776,PF,154,184,599,GSW,.481
164,Gerald Green,56,.463,121,39,.351,111,33,31,7,68,95,.409,232,33,.805,41,47,0,538,16,48,262,SF,9,25,84,BOS,.494
165,JaMychal Green,195,.549,355,55,.379,145,84,26,34,377,250,.500,500,134,.802,167,77,75,2101,167,248,689,PF,47,94,544,MEM,.555
166,Jeff Green,167,.458,365,53,.275,193,81,30,13,175,220,.394,558,145,.863,168,69,11,1534,39,103,638,PF,37,75,214,ORL,.442
167,Blake Griffin,441,.514,858,38,.336,113,300,27,22,385,479,.493,971,320,.760,421,61,61,2076,112,157,1316,PF,57,142,497,LAC,.513
168,Justin Hamilton,119,.598,199,55,.306,180,55,26,43,191,174,.459,379,39,.750,52,64,7,1177,71,91,442,C,29,43,262,BRK,.532
169,A.J. Hammons,12,.375,32,5,.500,10,4,24,13,28,17,.405,42,9,.450,20,22,0,163,8,21,48,C,1,10,36,DAL,.464
170,Tim Hardaway,266,.537,495,149,.357,417,182,24,15,189,415,.455,912,164,.766,214,79,30,2154,35,103,1143,SG,55,106,224,ATL,.537
171,James Harden,412,.530,777,262,.347,756,907,27,38,564,674,.440,1533,746,.847,881,81,81,2947,95,215,2356,PG,121,464,659,HOU,.525
172,Maurice Harkless,246,.572,430,68,.351,194,88,23,70,216,314,.503,624,77,.621,124,77,69,2223,125,214,773,SF,85,86,341,POR,.558
173,Justin Harper,3,.600,5,2,.286,7,2,27,0,3,5,.417,12,0,,0,3,0,31,2,2,12,PF,0,4,5,PHI,.500
174,Montrezl Harrell,224,.663,338,1,.143,7,64,23,42,138,225,.652,345,76,.628,121,58,14,1064,81,126,527,C,20,44,219,HOU,.654
175,Devin Harris,78,.476,164,58,.328,177,136,33,7,116,136,.399,341,107,.829,129,65,0,1087,11,101,437,PG,43,57,127,DAL,.484
176,Gary Harris,213,.558,382,107,.420,255,164,22,8,130,320,.502,637,104,.776,134,57,56,1782,48,92,851,SG,71,76,178,DEN,.586
177,Joe Harris,69,.489,141,85,.385,221,54,25,8,131,154,.425,362,35,.714,49,52,11,1138,16,121,428,SG,30,55,147,BRK,.543
178,Manny Harris,3,.231,13,0,.000,2,2,27,0,6,3,.200,15,2,.500,4,4,0,25,3,1,8,SG,0,2,9,DAL,.200
179,Tobias Harris,402,.537,749,109,.347,314,142,24,39,353,511,.481,1063,190,.841,226,82,48,2567,63,133,1321,PF,60,96,416,DET,.532
180,Aaron Harrison,0,.000,2,0,.000,2,3,22,0,3,0,.000,4,1,.500,2,5,0,17,0,2,1,SG,0,0,3,CHO,.000
181,Andrew Harrison,74,.363,204,43,.276,156,198,22,21,113,117,.325,360,148,.763,194,72,18,1474,23,194,425,PG,53,85,136,MEM,.385
182,Udonis Haslem,11,.550,20,0,.000,3,6,36,1,28,11,.478,23,9,.600,15,16,0,130,8,22,31,C,6,8,36,MIA,.478
183,Spencer Hawes,109,.556,196,25,.309,81,81,28,30,153,134,.484,277,44,.846,52,54,1,797,38,77,337,PF,15,49,191,TOT,.529
184,Gordon Hayward,396,.506,782,149,.398,374,252,26,20,345,545,.471,1156,362,.844,429,73,73,2516,49,117,1601,SF,73,140,394,UTA,.536
185,Gerald Henderson,173,.455,380,61,.353,173,112,29,15,151,234,.423,553,133,.806,165,72,41,1667,34,129,662,SG,40,62,185,PHI,.478
186,John Henson,159,.516,308,0,.000,1,57,26,78,203,159,.515,309,74,.692,107,58,39,1123,92,151,392,C,29,52,295,MIL,.515
187,Juan Hernangomez,55,.495,111,46,.407,113,29,21,12,144,101,.451,224,57,.750,76,62,9,842,43,62,305,PF,30,31,187,DEN,.554
188,Willy Hernangomez,242,.538,450,4,.267,15,96,22,36,332,246,.529,465,91,.728,125,72,22,1324,170,150,587,C,41,100,502,NYK,.533
189,Mario Hezonja,74,.398,186,43,.299,144,62,21,15,126,117,.355,330,40,.800,50,65,2,960,20,74,317,SF,30,58,146,ORL,.420
190,Roy Hibbert,80,.544,147,0,,0,21,30,46,98,80,.544,147,61,.813,75,48,13,682,54,100,221,C,8,32,152,TOT,.544
191,Buddy Hield,179,.461,388,148,.391,379,121,23,9,234,327,.426,767,64,.842,76,82,55,1888,35,115,866,SG,38,101,269,TOT,.523
192,Nene Hilario,242,.624,388,3,.333,9,65,34,39,187,245,.617,397,116,.589,197,67,8,1198,95,163,609,C,56,73,282,HOU,.621
193,George Hill,195,.523,373,94,.403,233,204,30,11,144,289,.477,606,157,.801,196,49,49,1544,23,114,829,PG,50,85,167,UTA,.554
194,Jordan Hill,5,.385,13,0,,0,0,29,0,6,5,.385,13,2,1.000,2,7,0,47,8,9,12,C,1,4,14,MIN,.385
195,Solomon Hill,89,.428,208,94,.348,270,141,25,32,256,183,.383,478,103,.805,128,80,71,2374,51,182,563,SF,72,82,307,NOP,.481
196,Darrun Hilliard,35,.438,80,12,.261,46,33,23,2,31,47,.373,126,21,.750,28,39,1,381,2,39,127,SG,11,28,33,DET,.421
197,Jrue Holiday,305,.498,612,100,.356,281,488,26,44,218,405,.454,893,119,.708,168,67,61,2190,46,133,1029,PG,100,194,264,NOP,.510
198,Justin Holiday,136,.513,265,97,.355,273,102,27,31,198,233,.433,538,66,.825,80,82,4,1639,27,109,629,SG,65,66,225,NYK,.523
199,Rondae Hollis-Jefferson,220,.463,475,15,.224,67,154,22,44,356,235,.434,542,190,.751,253,78,50,1761,96,177,675,SF,82,116,452,BRK,.447
200,Richaun Holmes,203,.606,335,27,.351,77,58,23,55,217,230,.558,412,72,.699,103,57,17,1193,94,136,559,C,42,55,311,PHI,.591
201,Rodney Hood,158,.440,359,114,.371,307,96,24,11,186,272,.408,666,90,.783,115,59,55,1593,16,132,748,SG,38,65,202,UTA,.494
202,Al Horford,293,.524,559,86,.355,242,337,30,86,370,379,.473,801,108,.800,135,68,68,2193,95,138,952,C,52,115,465,BOS,.527
203,Danuel House,0,,0,0,,0,0,23,0,1,0,,0,0,,0,1,0,1,0,0,0,SG,0,0,1,WAS,
204,Dwight Howard,388,.635,611,0,.000,2,104,31,92,644,388,.633,613,226,.533,424,74,74,2199,296,203,1002,C,64,170,940,ATL,.633
205,Marcelo Huertas,21,.429,49,4,.211,19,52,33,2,22,25,.368,68,9,.529,17,23,1,237,2,16,63,PG,10,19,24,LAL,.397
206,Josh Huestis,4,.571,7,2,.500,4,3,25,3,5,6,.545,11,0,.000,1,2,0,31,4,0,14,PF,0,0,9,OKC,.636
207,Kris Humphries,68,.425,160,19,.352,54,29,31,21,146,87,.407,214,64,.780,82,56,4,689,60,69,257,PF,15,28,206,ATL,.451
208,R.J. Hunter,0,,0,0,.000,1,0,23,0,1,0,.000,1,0,,0,3,0,9,0,0,0,SG,0,0,1,CHI,.000
209,Serge Ibaka,347,.522,665,124,.391,317,75,27,124,409,471,.480,982,107,.856,125,79,79,2422,129,215,1173,PF,41,105,538,TOT,.543
210,Andre Iguodala,155,.651,238,64,.362,177,261,33,39,253,219,.528,415,72,.706,102,76,0,1998,51,97,574,SF,76,58,304,GSW,.605
211,Ersan Ilyasova,242,.496,488,142,.353,402,141,29,23,366,384,.431,890,161,.778,207,82,52,2142,115,211,1071,PF,58,116,481,TOT,.511
212,Joe Ingles,81,.471,172,123,.441,279,225,29,8,238,204,.452,451,50,.735,68,82,26,1972,23,163,581,SF,96,107,261,UTA,.589
213,Brandon Ingram,221,.443,499,55,.294,187,166,19,36,256,276,.402,686,133,.621,214,79,40,2279,60,158,740,SF,50,116,316,LAL,.442
214,Kyrie Irving,494,.505,979,177,.401,441,418,24,24,178,671,.473,1420,297,.905,328,72,72,2525,52,157,1816,PG,83,180,230,CLE,.535
215,Jarrett Jack,2,1.000,2,0,.000,1,5,33,0,0,2,.667,3,2,1.000,2,2,0,33,0,4,6,PG,2,3,0,NOP,.667
216,Demetrius Jackson,2,.667,3,1,1.000,1,3,22,0,2,3,.750,4,3,.500,6,5,0,17,2,0,10,PG,0,0,4,BOS,.875
217,Pierre Jackson,10,.357,28,3,.273,11,19,25,0,8,13,.333,39,6,.857,7,8,1,84,1,5,35,PG,2,3,9,DAL,.372
218,Reggie Jackson,218,.442,493,66,.359,184,270,26,5,93,284,.419,677,118,.868,136,52,50,1424,21,129,752,PG,35,114,114,DET,.468
219,LeBron James,612,.611,1002,124,.363,342,646,32,44,542,736,.548,1344,358,.674,531,74,74,2794,97,134,1954,SF,92,303,639,CLE,.594
220,Al Jefferson,235,.500,470,0,.000,1,57,32,16,203,235,.499,471,65,.765,85,66,1,931,75,125,535,C,19,33,278,IND,.499
221,Richard Jefferson,91,.580,157,62,.333,186,78,36,10,175,153,.446,343,80,.741,108,79,13,1614,28,153,448,SF,26,52,203,CLE,.536
222,John Jenkins,1,.333,3,1,.500,2,1,25,0,1,2,.400,5,2,1.000,2,4,0,13,0,0,7,SG,0,0,1,PHO,.500
223,Brandon Jennings,113,.399,283,79,.313,252,395,27,4,167,192,.359,535,114,.750,152,81,13,1802,29,116,577,PG,70,128,196,TOT,.433
224,Jonas Jerebko,69,.523,132,45,.346,130,71,29,17,213,114,.435,262,26,.703,37,78,6,1232,59,122,299,PF,25,39,272,BOS,.521
225,Amir Johnson,186,.612,304,27,.409,66,140,29,62,248,213,.576,370,67,.670,100,80,77,1608,118,211,520,PF,51,77,366,BOS,.612
226,Brice Johnson,2,.286,7,0,,0,1,22,1,2,2,.286,7,0,,0,3,0,9,1,0,4,PF,2,1,3,LAC,.286
227,James Johnson,281,.548,513,87,.340,256,276,29,86,310,368,.479,769,152,.707,215,76,5,2085,66,197,975,PF,76,171,376,MIA,.535
228,Joe Johnson,167,.454,368,106,.411,258,144,35,18,210,273,.436,626,63,.818,77,78,14,1843,33,93,715,SF,36,69,243,UTA,.521
229,Stanley Johnson,84,.398,211,45,.292,154,105,20,24,153,129,.353,365,36,.679,53,77,1,1371,36,121,339,SF,56,71,189,DET,.415
230,Tyler Johnson,264,.460,574,93,.372,250,233,24,44,243,357,.433,824,195,.768,254,73,0,2178,50,176,1002,PG,84,90,293,MIA,.490
231,Wesley Johnson,44,.537,82,29,.246,118,23,29,30,155,73,.365,200,11,.647,17,68,3,810,26,83,186,SF,29,18,181,LAC,.438
232,Nikola Jokic,449,.628,715,45,.324,139,359,21,55,506,494,.578,854,188,.825,228,73,59,2038,212,214,1221,C,61,171,718,DEN,.605
233,Dahntay Jones,3,.500,6,0,.000,2,1,36,0,1,3,.375,8,3,.750,4,1,0,12,1,1,9,SF,0,1,2,CLE,.375
234,Damian Jones,8,.500,16,0,,0,0,21,4,14,8,.500,16,3,.300,10,10,0,85,9,15,19,C,1,6,23,GSW,.500
235,Derrick Jones,65,.591,110,3,.273,11,12,19,13,40,68,.562,121,29,.707,41,32,8,545,39,63,168,SF,14,13,79,PHO,.574
236,James Jones,13,.500,26,31,.470,66,14,36,10,34,44,.478,92,13,.650,20,48,2,381,3,37,132,SF,6,10,37,CLE,.647
237,Terrence Jones,212,.508,417,19,.253,75,59,25,54,241,231,.470,492,103,.606,170,54,12,1270,65,67,584,PF,40,48,306,TOT,.489
238,Tyus Jones,49,.454,108,26,.356,73,156,20,5,57,75,.414,181,33,.767,43,60,0,774,10,50,209,PG,48,38,67,MIN,.486
239,DeAndre Jordan,412,.717,575,0,.000,2,96,28,134,816,412,.714,577,205,.482,425,81,81,2570,298,212,1029,C,51,115,1114,LAC,.714
240,Cory Joseph,251,.477,526,48,.356,135,265,25,13,184,299,.452,661,94,.770,122,80,22,2003,51,140,740,PG,66,108,235,TOR,.489
241,Frank Kaminsky,204,.455,448,116,.328,354,162,23,34,279,320,.399,802,118,.756,156,75,16,1954,57,139,874,C,46,76,336,CHO,.471
242,Enes Kanter,397,.568,699,5,.132,38,67,24,38,287,402,.545,737,224,.786,285,72,0,1533,195,154,1033,C,32,123,482,OKC,.549
243,Ryan Kelly,4,.222,18,4,.400,10,8,25,5,17,8,.286,28,5,.833,6,16,0,110,1,5,25,PF,4,4,18,ATL,.357
244,Michael Kidd-Gilchrist,294,.483,609,1,.111,9,114,23,77,409,295,.477,618,152,.784,194,81,81,2349,156,187,743,SF,81,56,565,CHO,.478
245,Sean Kilpatrick,200,.468,427,105,.341,308,157,27,6,258,305,.415,735,204,.843,242,70,24,1754,22,118,919,SG,45,135,280,BRK,.486
246,Brandon Knight,164,.425,386,45,.324,139,130,25,5,93,209,.398,525,132,.857,154,54,5,1140,25,87,595,SG,27,88,118,PHO,.441
247,Kyle Korver,77,.494,156,162,.451,359,110,35,21,179,239,.464,515,38,.905,42,67,22,1753,7,107,678,SG,34,69,186,TOT,.621
248,Kosta Koufos,216,.552,391,0,.000,1,47,27,48,285,216,.551,392,38,.613,62,71,62,1419,118,172,470,C,36,61,403,SAC,.551
249,Mindaugas Kuzminskas,104,.517,201,54,.321,168,69,27,11,79,158,.428,369,55,.809,68,68,5,1016,47,79,425,SF,29,51,126,NYK,.501
250,Skal Labissiere,114,.543,210,3,.375,8,27,20,13,111,117,.537,218,52,.703,74,33,12,612,51,64,289,PF,16,37,162,SAC,.544
251,Jeremy Lamb,185,.536,345,41,.281,146,75,24,23,234,226,.460,491,110,.853,129,62,5,1143,30,98,603,SG,27,40,264,CHO,.502
252,Nicolas Laprovittola,10,.500,20,10,.370,27,28,27,1,9,20,.426,47,9,1.000,9,18,3,174,1,19,59,PG,4,19,10,SAS,.532
253,Joffrey Lauvergne,115,.483,238,33,.337,98,70,25,6,179,148,.440,336,46,.630,73,70,1,980,72,83,375,PF-C,25,56,251,TOT,.490
254,Zach LaVine,206,.515,400,120,.387,310,139,21,10,141,326,.459,710,117,.836,140,47,47,1749,19,104,889,SG,41,85,160,MIN,.544
255,Ty Lawson,203,.502,404,34,.288,118,334,29,6,135,237,.454,522,173,.797,217,69,24,1732,44,119,681,PG,74,129,179,SAC,.487
256,Jake Layman,13,.342,38,13,.255,51,11,22,3,18,26,.292,89,13,.765,17,35,1,249,6,22,78,SF,9,11,24,POR,.365
257,Courtney Lee,213,.490,435,108,.401,269,179,31,24,206,321,.456,704,85,.867,98,77,74,2459,53,141,835,SG,81,69,259,NYK,.533
258,David Lee,248,.590,420,0,,0,124,33,40,292,248,.590,420,80,.708,113,79,10,1477,149,125,576,PF,31,82,441,SAS,.590
259,Alex Len,227,.503,451,3,.250,12,44,23,98,354,230,.497,463,150,.721,208,77,34,1560,156,242,613,C,38,102,510,PHO,.500
260,Kawhi Leonard,489,.529,925,147,.380,387,260,25,55,350,636,.485,1312,469,.880,533,74,74,2474,80,122,1888,SF,133,154,430,SAS,.541
261,Meyers Leonard,72,.436,165,74,.347,213,71,24,28,210,146,.386,378,35,.875,40,74,12,1222,27,172,401,PF,13,35,237,POR,.484
262,Jon Leuer,261,.545,479,49,.293,167,111,27,26,300,310,.480,646,98,.867,113,75,34,1944,102,145,767,PF,31,66,402,DET,.518
263,Caris LeVert,112,.571,196,59,.321,184,110,22,8,165,171,.450,380,67,.720,93,57,26,1237,23,91,468,SF,49,59,188,BRK,.528
264,DeAndre Liggins,38,.396,96,17,.370,46,54,28,14,88,55,.387,142,25,.625,40,62,19,777,20,81,152,SG,47,42,108,TOT,.447
265,Damian Lillard,447,.492,909,214,.370,579,440,26,20,322,661,.444,1488,488,.895,545,75,75,2694,46,152,2024,PG,68,197,368,POR,.516
266,Jeremy Lin,117,.480,244,58,.372,156,184,28,14,124,175,.438,400,115,.816,141,36,33,883,11,79,523,PG,42,86,135,BRK,.510
267,Shaun Livingston,172,.550,313,1,.333,3,139,31,20,123,173,.547,316,42,.700,60,76,3,1345,28,120,389,PG,38,62,151,GSW,.549
268,Shawn Long,54,.600,90,7,.368,19,13,24,9,44,61,.560,109,19,.543,35,18,0,234,41,49,148,C,9,13,85,PHI,.592
269,Kevon Looney,54,.551,98,2,.222,9,29,20,17,80,56,.523,107,21,.618,34,53,4,447,44,64,135,C,15,17,124,GSW,.533
270,Brook Lopez,421,.536,785,134,.346,387,176,28,124,282,555,.474,1172,295,.810,364,75,75,2222,121,192,1539,C,38,184,403,BRK,.531
271,Robin Lopez,382,.494,773,0,.000,2,80,28,117,276,382,.493,775,75,.721,104,81,81,2271,244,151,839,C,18,91,520,CHI,.493
272,Kevin Love,225,.471,478,145,.373,389,116,28,21,518,370,.427,867,257,.871,295,60,60,1885,148,125,1142,PF,53,122,666,CLE,.510
273,Kyle Lowry,233,.518,450,193,.412,468,417,30,19,238,426,.464,918,299,.819,365,60,60,2244,48,170,1344,PG,88,173,286,TOR,.569
274,John Lucas III,1,.333,3,0,.000,1,1,34,0,0,1,.250,4,0,,0,5,0,11,0,0,2,PG,2,0,0,MIN,.250
275,Timothe Luwawu-Cabarrot,95,.475,200,50,.311,161,75,21,10,124,145,.402,361,105,.854,123,69,19,1190,25,154,445,SF,32,73,149,PHI,.471
276,Trey Lyles,94,.400,235,65,.319,204,69,21,20,187,159,.362,439,57,.722,79,71,4,1158,48,97,440,PF,26,64,235,UTA,.436
277,Sheldon Mac,23,.511,45,7,.233,30,15,24,2,30,30,.400,75,23,.852,27,30,3,287,4,17,90,SG,8,5,34,WAS,.447
278,Shelvin Mack,133,.510,261,37,.308,120,154,26,3,105,170,.446,381,53,.688,77,55,9,1205,20,100,430,PG,42,90,125,UTA,.495
279,Ian Mahinmi,65,.586,111,0,,0,19,30,24,103,65,.586,111,43,.573,75,31,0,555,47,90,173,C,33,34,150,WAS,.586
280,Thon Maker,55,.514,107,28,.378,74,23,19,26,74,83,.459,181,32,.653,49,57,34,562,40,84,226,C,10,17,114,MIL,.536
281,Boban Marjanovic,72,.545,132,0,,0,9,28,12,84,72,.545,132,47,.810,58,35,0,293,46,25,191,C,6,10,130,DET,.545
282,Jarell Martin,49,.389,126,9,.360,25,8,22,9,120,58,.384,151,40,.800,50,42,3,558,42,91,165,PF,17,28,162,MEM,.414
283,Wesley Matthews,159,.432,368,174,.363,479,210,30,15,241,333,.393,847,146,.816,179,73,73,2495,18,161,986,SG,77,102,259,DAL,.496
284,Luc Mbah a Moute,148,.552,268,43,.391,110,39,30,35,126,191,.505,378,59,.678,87,80,76,1787,44,122,484,SF,81,46,170,LAC,.562
285,James Michael McAdoo,60,.550,109,2,.250,8,18,24,29,57,62,.530,117,21,.500,42,52,2,457,34,47,147,PF,18,19,91,GSW,.538
286,Patrick McCaw,65,.533,122,41,.333,123,77,21,15,79,106,.433,245,29,.784,37,71,20,1074,21,62,282,SG,32,36,100,GSW,.516
287,C.J. McCollum,507,.506,1002,185,.421,439,285,25,42,229,692,.480,1441,268,.912,294,80,80,2796,60,202,1837,SG,72,172,289,POR,.544
288,T.J. McConnell,225,.492,457,11,.200,55,534,24,10,212,236,.461,512,73,.811,90,81,51,2133,39,139,556,PG,134,159,251,PHI,.472
289,Chris McCullough,15,.600,25,1,.143,7,2,21,2,10,16,.500,32,3,.600,5,16,0,80,9,7,36,PF,2,3,19,TOT,.516
290,K.J. McDaniels,57,.553,103,20,.303,66,13,23,18,67,77,.456,169,32,.842,38,49,0,505,15,49,206,SF,19,29,82,TOT,.515
291,Doug McDermott,145,.502,289,77,.370,208,58,25,5,159,222,.447,497,71,.845,84,66,5,1508,20,79,592,SF,13,38,179,TOT,.524
292,JaVale McGee,208,.658,316,0,.000,3,17,29,67,144,208,.652,319,56,.505,111,77,10,739,100,109,472,C,19,40,244,GSW,.652
293,Rodney McGruder,117,.488,240,73,.332,220,124,25,18,162,190,.413,460,44,.620,71,78,65,1966,94,140,497,SG,46,56,256,MIA,.492
294,Ben McLemore,115,.462,249,65,.382,170,51,23,6,110,180,.430,419,70,.753,93,61,26,1176,19,108,495,SG,29,62,129,SAC,.507
295,Jordan McRae,40,.404,99,18,.353,51,19,25,6,35,58,.387,150,27,.794,34,37,4,384,6,31,161,SG,8,14,41,CLE,.447
296,Josh McRoberts,31,.356,87,13,.419,31,50,29,4,51,44,.373,118,6,.667,9,22,14,381,23,31,107,PF,10,23,74,MIA,.428
297,Jodie Meeks,47,.395,119,56,.409,137,45,29,4,72,103,.402,256,65,.878,74,36,10,738,5,41,327,SG,34,36,77,ORL,.512
298,Salah Mejri,87,.649,134,1,.333,3,14,30,61,211,88,.642,137,36,.590,61,73,11,905,97,152,213,C,32,40,308,DAL,.646
299,Jordan Mickey,15,.455,33,0,.000,1,7,22,6,21,15,.441,34,8,.571,14,25,1,141,13,12,38,PF,3,9,34,BOS,.441
300,Khris Middleton,105,.459,229,45,.433,104,99,25,7,112,150,.450,333,81,.880,92,29,23,889,11,79,426,SF,41,65,123,MIL,.518
301,C.J. Miles,112,.471,238,169,.413,409,48,29,25,199,281,.434,647,84,.903,93,76,29,1776,30,151,815,SF,46,40,229,IND,.565
302,Mike Miller,1,.333,3,8,.400,20,22,36,0,36,9,.391,23,2,1.000,2,20,0,151,2,9,28,SF,2,13,38,DEN,.565
303,Patty Mills,126,.474,266,147,.414,355,280,28,3,117,273,.440,621,66,.825,80,80,8,1754,24,109,759,PG,65,101,141,SAS,.558
304,Elijah Millsap,1,.200,5,0,.000,2,1,29,0,3,1,.143,7,1,.500,2,2,0,23,3,2,3,SG,0,2,6,PHO,.143
305,Paul Millsap,355,.486,731,75,.311,241,252,31,62,422,430,.442,972,311,.768,405,69,67,2343,111,186,1246,PF,90,158,533,ATL,.481
306,Nikola Mirotic,129,.520,248,129,.342,377,75,25,55,323,258,.413,625,99,.773,128,70,15,1679,61,128,744,PF,53,80,384,CHI,.516
307,Greg Monroe,387,.536,722,0,.000,4,187,26,38,365,387,.533,726,177,.741,239,81,0,1823,167,168,951,C,92,140,532,MIL,.533
308,E'Twaun Moore,206,.501,411,77,.370,208,164,27,32,119,283,.457,619,57,.770,74,73,22,1820,33,131,700,SG,50,62,152,NOP,.519
309,Marcus Morris,303,.466,650,118,.331,357,160,27,25,289,421,.418,1007,145,.784,185,79,79,2565,77,168,1105,SF,52,87,366,DET,.477
310,Markieff Morris,335,.483,693,71,.362,196,126,27,42,386,406,.457,889,180,.837,215,76,76,2374,107,254,1063,PF,82,129,493,WAS,.497
311,Anthony Morrow,57,.479,119,41,.308,133,25,31,2,19,98,.389,252,34,.919,37,49,7,714,12,44,271,SG,24,6,31,TOT,.470
312,Donatas Motiejunas,46,.505,91,11,.234,47,32,26,11,75,57,.413,138,25,.510,49,34,0,479,26,55,150,PF,18,31,101,NOP,.453
313,Timofey Mozgov,169,.517,327,0,.000,1,43,30,31,160,169,.515,328,63,.808,78,54,52,1104,104,133,401,C,16,72,264,LAL,.515
314,Emmanuel Mudiay,152,.408,373,56,.315,178,217,20,13,149,208,.377,551,131,.784,167,55,41,1406,29,95,603,PG,41,123,178,DEN,.428
315,Shabazz Muhammad,239,.528,453,49,.338,145,35,24,6,136,288,.482,598,147,.774,190,78,1,1516,84,86,772,SF,22,56,220,MIN,.523
316,Dejounte Murray,41,.441,93,9,.391,23,48,20,6,36,50,.431,116,21,.700,30,38,8,322,6,29,130,PG,8,38,42,SAS,.470
317,Jamal Murray,180,.466,386,115,.334,344,170,19,24,173,295,.404,730,106,.883,120,82,10,1764,41,124,811,SG,51,113,214,DEN,.483
318,Mike Muscala,124,.546,227,46,.418,110,95,25,41,164,170,.504,337,49,.766,64,70,3,1237,76,97,435,C,30,55,240,ATL,.573
319,Larry Nance,180,.554,325,10,.278,36,96,24,39,249,190,.526,361,59,.738,80,63,7,1442,120,149,449,PF,82,56,369,LAL,.540
320,Shabazz Napier,39,.429,91,34,.370,92,67,25,2,53,73,.399,183,38,.776,49,53,2,512,8,38,218,PG,32,41,61,POR,.492
321,Maurice Ndour,38,.481,79,1,.143,7,8,24,8,42,39,.453,86,19,.731,26,32,4,331,22,30,98,PF,15,12,64,NYK,.459
322,Gary Neal,0,.000,5,0,.000,2,1,32,0,1,0,.000,7,4,1.000,4,2,0,18,0,1,4,SG,0,0,1,ATL,.000
323,Jameer Nelson,162,.489,331,106,.388,273,385,34,8,164,268,.444,604,45,.714,63,75,39,2045,28,197,687,PG,54,128,192,DEN,.531
324,Raul Neto,31,.517,60,10,.323,31,34,24,5,26,41,.451,91,8,.889,9,40,0,346,4,48,100,PG,21,15,30,UTA,.505
325,Georges Niang,8,.333,24,1,.083,12,5,23,0,15,9,.250,36,2,1.000,2,23,0,93,2,6,21,PF,3,5,17,IND,.264
326,Andrew Nicholson,38,.452,84,5,.185,27,10,27,6,46,43,.387,111,9,.643,14,38,0,342,15,55,100,PF,16,17,61,TOT,.410
327,Joakim Noah,99,.493,201,0,.000,1,103,31,37,241,99,.490,202,34,.436,78,46,46,1015,162,127,232,C,30,58,403,NYK,.490
328,Nerlens Noel,184,.597,308,0,.000,1,50,22,50,201,184,.595,309,77,.694,111,51,19,1047,93,126,445,C,65,51,294,TOT,.595
329,Lucas Nogueira,100,.694,144,3,.250,12,42,24,89,162,103,.660,156,44,.657,67,57,6,1088,82,137,253,C,52,46,244,TOR,.670
330,Steve Novak,1,1.000,1,1,.167,6,0,33,0,3,2,.286,7,0,,0,8,0,22,0,1,5,PF,0,0,3,MIL,.357
331,Dirk Nowitzki,217,.463,469,79,.378,209,82,38,38,330,296,.437,678,98,.875,112,54,54,1424,23,113,769,PF,30,51,353,DAL,.495
332,Jusuf Nurkic,271,.508,533,0,.000,1,123,22,74,313,271,.507,534,120,.571,210,65,48,1391,154,161,662,C,50,143,467,TOT,.507
333,David Nwaba,46,.605,76,1,.200,5,14,24,7,46,47,.580,81,25,.641,39,20,2,397,17,36,120,SG,13,11,63,LAL,.586
334,Johnny O'Bryant,12,.500,24,3,.500,6,6,23,1,10,15,.500,30,5,.833,6,11,0,80,9,10,38,PF,0,6,19,TOT,.550
335,Kyle O'Quinn,213,.538,396,2,.118,17,117,26,104,282,215,.521,413,64,.771,83,79,8,1229,157,174,496,C,36,76,439,NYK,.523
336,Daniel Ochefu,12,.444,27,0,,0,3,23,0,17,12,.444,27,0,.000,2,19,0,75,5,17,24,C,2,3,22,WAS,.444
337,Jahlil Okafor,242,.514,471,0,,0,58,21,49,159,242,.514,471,106,.671,158,50,33,1134,81,122,590,C,20,91,240,PHI,.514
338,Victor Oladipo,285,.491,580,127,.361,352,176,24,21,252,412,.442,932,116,.753,154,67,67,2222,39,155,1067,SG,78,119,291,OKC,.510
339,Kelly Olynyk,192,.608,316,68,.354,192,148,25,29,288,260,.512,508,90,.732,123,75,6,1538,73,207,678,C,43,96,361,BOS,.579
340,Arinze Onuaku,2,.500,4,0,,0,2,29,1,4,2,.500,4,0,,0,8,0,28,2,3,4,C,0,2,6,ORL,.500
341,Chinanu Onuaku,5,.714,7,0,,0,3,20,1,8,5,.714,7,4,1.000,4,5,1,52,2,6,14,C,3,4,10,HOU,.714
342,Kelly Oubre,132,.520,254,54,.287,188,47,21,17,200,186,.421,442,75,.758,99,79,5,1605,61,195,501,SF,58,50,261,WAS,.482
343,Zaza Pachulia,164,.538,305,0,.000,2,132,32,33,270,164,.534,307,98,.778,126,70,70,1268,140,166,426,C,59,87,410,GSW,.534
344,Georgios Papagiannis,56,.560,100,0,.000,2,20,19,17,62,56,.549,102,12,.857,14,22,0,355,24,44,124,C,3,24,86,SAC,.549
345,Jabari Parker,334,.525,636,65,.365,178,142,21,22,235,399,.490,814,162,.743,218,51,50,1728,79,111,1025,PF,50,93,314,MIL,.530
346,Tony Parker,242,.484,500,23,.333,69,285,34,2,104,265,.466,569,85,.726,117,63,63,1587,9,92,638,PG,34,89,113,SAS,.486
347,Chandler Parsons,50,.388,129,25,.269,93,55,28,5,78,75,.338,222,35,.814,43,34,34,675,6,52,210,SF,20,24,84,MEM,.394
348,Lamar Patterson,2,.222,9,1,.167,6,6,25,0,6,3,.200,15,2,.667,3,5,0,40,1,6,9,SG,1,4,7,ATL,.233
349,Patrick Patterson,60,.458,131,94,.372,253,76,27,23,231,154,.401,384,43,.717,60,65,8,1599,62,120,445,PF,40,38,293,TOR,.523
350,Chris Paul,250,.518,483,124,.411,302,563,31,8,264,374,.476,785,232,.892,260,61,61,1921,40,146,1104,PG,119,147,304,LAC,.555
351,Adreian Payne,20,.513,39,3,.200,15,7,25,7,24,23,.426,54,14,.737,19,18,0,135,9,32,63,PF,8,8,33,MIN,.454
352,Cameron Payne,37,.346,107,27,.314,86,55,22,4,45,64,.332,193,5,.625,8,31,0,462,3,52,160,PG,14,29,48,TOT,.402
353,Elfrid Payton,390,.509,766,40,.274,146,529,22,40,298,430,.471,912,146,.692,211,82,58,2412,89,177,1046,PG,88,178,387,ORL,.493
354,Gary Payton,7,.538,13,1,.111,9,13,24,4,12,8,.364,22,3,.600,5,6,0,99,0,9,20,PG,3,10,12,MIL,.386
355,Paul Pierce,13,.481,27,15,.349,43,10,39,5,47,28,.400,70,10,.769,13,25,7,277,1,40,81,SF,4,16,48,LAC,.507
356,Marshall Plumlee,16,.533,30,0,,0,10,24,4,28,16,.533,30,8,.421,19,21,1,170,23,23,40,C,4,12,51,NYK,.533
357,Mason Plumlee,334,.541,617,0,.000,6,284,26,92,435,334,.536,623,174,.580,300,81,64,2148,170,226,842,C,69,134,605,TOT,.536
358,Miles Plumlee,44,.478,92,0,,0,21,28,13,57,44,.478,92,25,.641,39,45,12,484,38,73,113,C,18,30,95,TOT,.478
359,Jakob Poeltl,67,.583,115,0,,0,12,21,20,87,67,.583,115,31,.544,57,54,4,626,78,113,165,C,17,29,165,TOR,.583
360,Otto Porter,266,.576,462,148,.434,341,121,23,42,396,414,.516,803,99,.832,119,80,80,2605,118,193,1075,SF,116,44,514,WAS,.608
361,Bobby Portis,151,.541,279,32,.333,96,35,21,11,221,183,.488,375,39,.661,59,64,13,1000,75,94,437,PF,16,37,296,CHI,.531
362,Kristaps Porzingis,331,.493,671,112,.357,314,97,21,129,364,443,.450,985,198,.786,252,66,65,2164,111,244,1196,PF,47,118,475,NYK,.507
363,Dwight Powell,173,.571,303,21,.284,74,49,25,39,213,194,.515,377,107,.759,141,77,3,1333,93,135,516,C,61,34,306,DAL,.542
364,Norman Powell,171,.514,333,56,.324,173,82,23,14,143,227,.449,506,126,.792,159,76,18,1368,26,127,636,SG,52,70,169,TOR,.504
365,Alex Poythress,19,.543,35,6,.316,19,5,23,2,18,25,.463,54,8,.800,10,6,1,157,11,14,64,PF,3,3,29,PHI,.519
366,Ronnie Price,1,.143,7,3,.176,17,18,33,1,8,4,.167,24,3,.750,4,14,0,134,3,14,14,PG,11,3,11,PHO,.229
367,Tim Quarterman,8,.500,16,5,.385,13,11,22,3,10,13,.448,29,0,.000,3,16,0,80,4,6,31,SG,2,11,14,POR,.534
368,Chasson Randle,24,.471,51,16,.340,47,34,23,2,26,40,.408,98,41,.953,43,26,0,299,6,39,137,PG,9,19,32,TOT,.490
369,Julius Randle,360,.507,710,17,.270,63,264,22,37,486,377,.488,773,204,.723,282,74,73,2132,150,248,975,PF,49,173,636,LAL,.499
370,Zach Randolph,412,.474,870,21,.223,94,122,35,10,416,433,.449,964,141,.731,193,73,5,1786,182,136,1028,PF,38,99,598,MEM,.460
371,J.J. Redick,195,.462,422,201,.429,468,110,32,13,160,396,.445,890,180,.891,202,78,78,2198,11,125,1173,SG,54,98,171,LAC,.558
372,Willie Reed,161,.573,281,1,.250,4,26,26,47,203,162,.568,285,49,.557,88,71,5,1031,129,137,374,C,18,31,332,MIA,.570
373,Josh Richardson,127,.444,286,75,.330,227,140,23,39,133,202,.394,513,60,.779,77,53,34,1614,35,132,539,SG,60,65,168,MIA,.467
374,Malachi Richardson,20,.500,40,8,.286,28,11,21,1,20,28,.412,68,15,.789,19,22,0,198,3,23,79,SG,5,8,23,SAC,.471
375,Austin Rivers,212,.491,432,111,.371,299,204,24,10,141,323,.442,731,132,.691,191,74,29,2054,20,187,889,SG,48,115,161,LAC,.518
376,Andre Roberson,170,.609,279,45,.245,184,79,25,79,305,215,.464,463,47,.423,111,79,79,2376,98,204,522,SF,94,51,403,OKC,.513
377,Brian Roberts,29,.372,78,17,.386,44,52,31,1,34,46,.377,122,33,.846,39,41,2,416,5,18,142,PG,9,26,39,CHO,.447
378,Glenn Robinson,109,.512,213,49,.392,125,47,23,20,189,158,.467,338,54,.711,76,69,27,1427,57,63,419,SF,41,37,246,IND,.540
379,Thomas Robinson,105,.538,195,0,.000,1,31,25,9,139,105,.536,196,31,.470,66,48,1,560,84,76,241,PF,26,46,223,LAL,.536
380,Sergio Rodriguez,118,.415,284,92,.365,252,344,30,4,136,210,.392,536,18,.667,27,68,30,1518,21,95,530,PG,49,128,157,PHI,.478
381,Rajon Rondo,179,.418,428,50,.376,133,461,30,11,282,229,.408,561,30,.600,50,69,42,1843,73,144,538,PG,99,169,355,CHI,.453
382,Derrick Rose,447,.487,917,13,.217,60,283,28,17,180,460,.471,977,221,.874,253,64,64,2082,66,84,1154,PG,44,147,246,NYK,.477
383,Terrence Ross,184,.518,355,142,.363,391,88,25,33,188,326,.437,746,64,.831,77,78,24,1955,18,143,858,SF,87,68,206,TOT,.532
384,Terry Rozier,94,.405,232,57,.318,179,131,22,11,187,151,.367,411,51,.773,66,74,0,1263,40,69,410,PG,46,47,227,BOS,.437
385,Ricky Rubio,201,.443,454,60,.306,196,682,26,10,237,261,.402,650,254,.891,285,75,75,2469,68,202,836,PG,128,195,305,MIN,.448
386,Damjan Rudez,11,.458,24,20,.313,64,20,30,1,20,31,.352,88,0,,0,45,0,314,5,31,82,SF,12,9,25,ORL,.466
387,Brandon Rush,26,.356,73,44,.386,114,45,31,23,83,70,.374,187,13,.722,18,47,33,1030,16,42,197,SG,22,28,99,MIN,.492
388,D'Angelo Russell,216,.447,483,135,.352,384,303,20,16,190,351,.405,867,147,.782,188,63,60,1811,31,130,984,PG,87,176,221,LAL,.483
389,Domantas Sabonis,141,.438,322,51,.321,159,82,20,32,242,192,.399,481,44,.657,67,81,66,1632,46,200,479,PF,39,83,288,OKC,.452
390,Larry Sanders,1,.250,4,0,,0,0,28,1,1,1,.250,4,2,1.000,2,5,0,13,3,5,4,C,1,2,4,CLE,.250
391,Dario Saric,275,.469,586,106,.311,341,182,22,30,401,381,.411,927,172,.782,220,81,36,2129,112,162,1040,PF,57,183,513,PHI,.468
392,Tomas Satoransky,52,.473,110,9,.243,37,92,25,6,58,61,.415,147,23,.697,33,57,3,719,25,60,154,SG,26,38,83,WAS,.446
393,Dennis Schroder,448,.487,920,100,.340,294,499,23,16,206,548,.451,1214,218,.855,255,79,78,2485,42,149,1414,PG,74,258,248,ATL,.493
394,Luis Scola,54,.535,101,17,.340,50,37,36,4,88,71,.470,151,25,.676,37,36,1,461,51,63,184,PF,14,34,139,BRK,.526
395,Mike Scott,13,.406,32,4,.148,27,17,28,3,27,17,.288,59,7,.875,8,18,0,195,10,12,45,PF,4,8,37,ATL,.322
396,Thabo Sefolosha,133,.484,275,41,.342,120,107,32,31,216,174,.441,395,55,.733,75,62,42,1596,54,97,444,SF,96,58,270,ATL,.492
397,Wayne Selden,18,.600,30,7,.250,28,13,22,1,15,25,.431,58,14,.636,22,14,5,236,1,18,71,SG,6,12,16,TOT,.491
398,Kevin Seraphin,109,.556,196,0,.000,2,23,27,20,101,109,.551,198,14,.636,22,49,3,559,41,66,232,PF,7,29,142,IND,.551
399,Ramon Sessions,79,.393,201,21,.339,62,129,30,3,62,100,.380,263,91,.771,118,50,1,811,11,43,312,PG,27,46,73,CHO,.420
400,Iman Shumpert,107,.469,228,94,.360,261,109,26,27,179,201,.411,489,71,.789,90,76,31,1937,39,150,567,SG,62,78,218,CLE,.507
401,Pascal Siakam,102,.515,198,1,.143,7,17,22,45,121,103,.502,205,22,.688,32,55,38,859,64,109,229,PF,26,33,185,TOR,.505
402,Jonathon Simmons,147,.461,319,30,.294,102,126,27,25,140,177,.420,421,99,.750,132,78,8,1392,20,146,483,SG,47,76,160,SAS,.456
403,Kyle Singler,27,.587,46,7,.189,37,9,28,5,40,34,.410,83,13,.765,17,32,2,385,8,29,88,SF,7,11,48,OKC,.452
404,Marcus Smart,175,.420,417,94,.283,332,364,22,34,227,269,.359,749,203,.812,250,79,24,2399,78,192,835,SG,125,159,305,BOS,.422
405,Ish Smith,301,.467,644,28,.267,105,418,28,33,214,329,.439,749,72,.706,102,81,32,1955,21,127,758,PG,61,112,235,DET,.458
406,J.R. Smith,28,.329,85,95,.351,271,62,31,11,96,123,.346,356,10,.667,15,41,35,1187,17,77,351,SG,40,26,113,CLE,.479
407,Jason Smith,137,.546,251,37,.474,78,37,30,54,194,174,.529,329,35,.686,51,74,3,1068,64,168,420,C,21,58,258,WAS,.585
408,Tony Snell,102,.548,186,144,.406,355,96,25,14,226,246,.455,541,47,.810,58,80,80,2336,22,125,683,SG,55,55,248,MIL,.588
409,Marreese Speights,141,.520,271,103,.372,277,65,29,41,285,244,.445,548,120,.876,137,82,2,1286,88,229,711,C,23,69,373,LAC,.539
410,Tiago Splitter,12,.480,25,2,.333,6,4,32,1,14,14,.452,31,9,.818,11,8,0,76,8,8,39,C,1,6,22,PHI,.484
411,Nik Stauskas,119,.433,275,132,.368,359,188,23,32,205,251,.396,634,122,.813,150,80,27,2188,21,144,756,SG,45,128,226,PHI,.500
412,Lance Stephenson,48,.480,100,6,.300,20,59,26,3,48,54,.450,120,8,.615,13,18,0,361,4,32,122,SG,5,26,52,TOT,.475
413,Jarnell Stokes,1,1.000,1,0,,0,2,23,0,1,1,1.000,1,1,.500,2,2,0,7,1,3,3,C,1,0,2,DEN,1.000
414,Diamond Stone,3,.231,13,0,,0,0,19,1,5,3,.231,13,4,1.000,4,7,0,24,1,5,10,C,0,2,6,LAC,.231
415,Rodney Stuckey,72,.391,184,19,.317,60,84,30,0,78,91,.373,244,80,.748,107,39,0,696,6,44,281,PG,16,53,84,IND,.412
416,Jared Sullinger,12,.414,29,3,.167,18,3,24,1,17,15,.319,47,4,.500,8,11,1,118,10,17,37,PF,4,4,27,TOR,.351
417,Edy Tavares,4,.800,5,0,,0,1,24,6,7,4,.800,5,0,.000,3,2,0,28,4,3,8,C,0,2,11,TOT,.800
418,Isaiah Taylor,1,.200,5,0,.000,2,3,22,1,2,1,.143,7,1,.500,2,4,0,52,1,6,3,PG,1,0,3,HOU,.143
419,Jeff Teague,312,.475,657,90,.357,252,639,28,32,297,402,.442,909,360,.867,415,82,82,2657,33,165,1254,PG,100,216,330,IND,.492
420,Mirza Teletovic,52,.460,113,104,.341,305,48,31,13,151,156,.373,418,35,.778,45,70,2,1133,11,109,451,PF,12,37,162,MIL,.498
421,Garrett Temple,101,.476,212,82,.373,220,168,30,28,152,183,.424,432,58,.784,74,65,21,1728,32,141,506,SG,84,78,184,SAC,.519
422,Jason Terry,32,.444,72,73,.427,171,98,39,20,91,105,.432,243,24,.828,29,74,0,1365,15,95,307,SG,46,36,106,MIL,.582
423,Isaiah Thomas,437,.528,827,245,.379,646,448,27,13,162,682,.463,1473,590,.909,649,76,76,2569,43,167,2199,PG,70,210,205,BOS,.546
424,Lance Thomas,59,.371,159,38,.447,85,35,28,5,110,97,.398,244,43,.843,51,46,15,968,32,85,275,PF,21,25,142,NYK,.475
425,Hollis Thompson,45,.429,105,32,.337,95,35,25,6,93,77,.385,200,19,.655,29,40,9,752,19,69,205,SG,20,11,112,TOT,.465
426,Klay Thompson,376,.516,729,268,.414,647,160,26,40,236,644,.468,1376,186,.853,218,78,78,2649,49,139,1742,SG,66,128,285,GSW,.565
427,Tristan Thompson,262,.604,434,0,.000,3,77,25,84,429,262,.600,437,106,.498,213,78,78,2336,286,176,630,C,39,64,715,CLE,.600
428,Marcus Thornton,56,.431,130,28,.350,80,41,29,3,54,84,.400,210,23,.852,27,33,1,575,22,48,219,SG,19,25,76,WAS,.467
429,Mike Tobey,1,.250,4,0,,0,1,22,0,1,1,.250,4,0,,0,2,0,25,2,2,2,C,0,1,3,CHO,.250
430,Anthony Tolliver,65,.537,121,90,.391,230,77,31,20,186,155,.442,351,61,.744,82,65,9,1477,51,109,461,PF,34,56,237,SAC,.570
431,Axel Toupane,4,.800,5,1,.250,4,0,24,1,1,5,.556,9,0,,0,4,0,47,0,6,11,SF,1,0,1,TOT,.611
432,Karl-Anthony Towns,701,.582,1205,101,.367,275,220,21,103,711,802,.542,1480,356,.832,428,82,82,3030,296,241,2061,C,56,212,1007,MIN,.576
433,P.J. Tucker,129,.451,286,70,.357,196,99,31,19,354,199,.413,482,72,.774,93,81,21,2236,117,196,540,SF,116,66,471,TOT,.485
434,Evan Turner,204,.470,434,31,.263,118,205,28,24,211,235,.426,552,85,.825,103,65,12,1658,36,121,586,SF,53,100,247,POR,.454
435,Myles Turner,404,.536,754,40,.348,115,106,20,172,450,444,.511,869,245,.809,303,81,81,2541,139,262,1173,C,74,105,589,IND,.534
436,Beno Udrih,81,.491,165,11,.344,32,131,34,0,51,92,.467,197,32,.941,34,39,0,560,6,29,227,PG,13,36,57,DET,.495
437,Tyler Ulis,163,.455,358,21,.266,79,226,21,5,75,184,.421,437,55,.775,71,61,15,1123,20,73,444,PG,48,77,95,PHO,.445
438,Jarrod Uthoff,13,.448,29,3,.333,9,9,23,4,14,16,.421,38,5,.714,7,9,0,115,8,8,40,PF,2,3,22,DAL,.461
439,Jonas Valanciunas,390,.557,700,1,.500,2,57,24,63,533,391,.557,702,176,.811,217,80,80,2066,226,216,959,C,37,106,759,TOR,.558
440,Denzel Valentine,29,.363,80,73,.351,208,63,23,7,140,102,.354,288,14,.778,18,57,0,976,11,86,291,SG,30,49,151,CHI,.481
441,Fred VanVleet,28,.341,82,11,.379,29,35,22,3,38,39,.351,111,18,.818,22,37,0,294,4,36,107,PG,16,15,42,TOR,.401
442,Anderson Varejao,5,.357,14,0,,0,10,34,3,15,5,.357,14,8,.727,11,14,1,92,12,16,18,C,3,8,27,GSW,.357
443,Greivis Vasquez,1,.200,5,1,.333,3,5,30,1,2,2,.250,8,2,.667,3,3,0,39,0,6,7,PG,1,1,2,BRK,.313
444,Rashad Vaughn,31,.413,75,26,.321,81,23,20,10,45,57,.365,156,2,.400,5,41,2,458,4,32,142,SG,19,14,49,MIL,.449
445,Noah Vonleh,123,.492,250,7,.350,20,31,21,27,256,130,.481,270,60,.638,94,74,41,1265,131,154,327,PF,30,64,387,POR,.494
446,Nikola Vucevic,460,.481,956,23,.307,75,208,26,74,603,483,.468,1031,107,.669,160,75,55,2163,176,180,1096,C,76,117,779,ORL,.480
447,Sasha Vujacic,19,.306,62,23,.311,74,52,32,2,47,42,.309,136,17,.708,24,42,4,408,12,38,124,SG,13,16,59,NYK,.393
448,Dwyane Wade,369,.456,810,45,.310,145,228,35,41,207,414,.434,955,223,.794,281,60,59,1792,63,112,1096,SG,86,138,270,CHI,.457
449,Dion Waiters,196,.438,448,85,.395,215,200,25,20,135,281,.424,663,82,.646,127,46,43,1384,18,95,729,SG,42,103,153,MIA,.488
450,Kemba Walker,403,.476,847,240,.399,602,434,26,22,263,643,.444,1449,304,.847,359,79,79,2739,45,119,1830,PG,85,168,308,CHO,.527
451,John Wall,558,.480,1163,89,.327,272,831,26,49,267,647,.451,1435,422,.801,527,78,78,2836,59,151,1805,PG,157,322,326,WAS,.482
452,Taurean Waller-Prince,81,.443,183,33,.324,102,55,22,27,132,114,.400,285,74,.787,94,59,10,981,25,96,335,SF,43,61,157,ATL,.458
453,T.J. Warren,377,.527,716,26,.265,98,75,23,39,214,403,.495,814,119,.773,154,66,59,2048,125,175,951,SF,76,57,339,PHO,.511
454,C.J. Watson,64,.448,143,32,.305,105,114,32,2,73,96,.387,248,57,.864,66,62,9,1012,16,84,281,PG,43,47,89,ORL,.452
455,Briante Weber,24,.480,50,1,.100,10,21,24,1,18,25,.417,60,11,.688,16,20,0,205,8,16,62,PG,12,8,26,TOT,.425
456,David West,132,.541,244,3,.375,8,151,36,48,156,135,.536,252,43,.768,56,68,0,854,47,105,316,C,42,78,203,GSW,.542
457,Russell Westbrook,624,.459,1358,200,.343,583,840,28,31,727,824,.425,1941,710,.845,840,81,81,2802,137,190,2558,PG,132,438,864,OKC,.476
458,Okaro White,21,.396,53,12,.353,34,21,24,10,57,33,.379,87,20,.909,22,35,0,471,25,52,98,PF,10,18,82,MIA,.448
459,Isaiah Whitehead,160,.446,359,44,.295,149,192,21,36,152,204,.402,508,91,.805,113,73,26,1643,32,175,543,PG,42,142,184,BRK,.445
460,Hassan Whiteside,542,.557,973,0,,0,57,27,161,795,542,.557,973,225,.628,358,77,77,2513,293,226,1309,C,57,154,1088,MIA,.557
461,Andrew Wiggins,606,.473,1281,103,.356,289,189,21,30,226,709,.452,1570,412,.760,542,82,82,3048,102,183,1933,SF,82,187,328,MIN,.484
462,C.J. Wilcox,5,.313,16,3,.200,15,12,26,1,8,8,.258,31,2,1.000,2,22,0,108,4,8,21,SG,2,6,12,ORL,.306
463,Alan Williams,138,.519,266,0,.000,1,23,24,32,198,138,.517,267,70,.625,112,47,0,708,94,125,346,C,27,37,292,PHO,.517
464,Deron Williams,178,.486,366,85,.363,234,360,32,8,133,263,.438,600,90,.826,109,64,44,1657,14,138,701,PG,31,138,147,TOT,.509
465,Derrick Williams,78,.531,147,30,.309,97,28,25,7,111,108,.443,244,58,.652,89,50,11,804,19,60,304,PF,14,28,130,TOT,.504
466,Lou Williams,265,.480,552,163,.365,446,239,30,20,176,428,.429,998,402,.880,457,81,1,1994,26,92,1421,SG,80,160,202,TOT,.511
467,Marvin Williams,173,.494,350,124,.350,354,106,30,53,411,297,.422,704,131,.873,150,76,76,2295,89,134,849,PF,58,60,500,CHO,.510
468,Reggie Williams,3,.250,12,5,.455,11,4,30,0,4,8,.348,23,6,.857,7,6,0,79,2,2,27,SF,3,0,6,NOP,.457
469,Troy Williams,55,.524,105,18,.290,62,25,22,10,54,73,.437,167,21,.656,32,30,16,557,15,60,185,SF,27,32,69,TOT,.491
470,Kyle Wiltjer,0,.000,1,4,.308,13,2,24,1,6,4,.286,14,1,.500,2,14,0,44,4,4,13,PF,3,5,10,HOU,.429
471,Justise Winslow,73,.384,190,7,.200,35,66,20,6,71,80,.356,225,29,.617,47,18,15,625,23,52,196,SF,26,33,94,MIA,.371
472,Jeff Withey,55,.539,102,0,.000,1,7,26,32,69,55,.534,103,36,.750,48,51,1,432,52,52,146,C,16,14,121,UTA,.534
473,Christian Wood,12,.667,18,0,.000,5,2,21,6,15,12,.522,23,11,.733,15,13,0,107,14,11,35,PF,3,7,29,CHO,.522
474,Metta World Peace,10,.333,30,9,.237,38,11,37,2,15,19,.279,68,10,.625,16,25,2,160,5,18,57,SF,10,7,20,LAL,.346
475,Brandan Wright,83,.619,134,0,.000,1,15,29,20,47,83,.615,135,23,.657,35,28,5,447,31,42,189,PF,11,10,78,MEM,.615
476,Delon Wright,39,.453,86,10,.333,30,57,24,11,32,49,.422,116,42,.764,55,27,0,446,16,31,150,PG,27,25,48,TOR,.466
477,James Young,13,.565,23,12,.343,35,4,21,2,20,25,.431,58,6,.667,9,29,0,220,6,15,68,SG,10,4,26,BOS,.534
478,Joe Young,21,.429,49,5,.217,23,15,24,0,16,26,.361,72,11,.733,15,33,0,135,1,5,68,PG,4,5,17,IND,.396
479,Nick Young,102,.481,212,170,.404,421,58,31,14,113,272,.430,633,77,.856,90,60,60,1556,25,137,791,SG,37,36,138,LAL,.564
480,Thaddeus Young,317,.557,569,45,.381,118,122,28,29,317,362,.527,687,45,.523,86,74,74,2237,131,135,814,PF,113,95,448,IND,.560
481,Cody Zeller,253,.572,442,0,.000,1,99,24,58,270,253,.571,443,133,.679,196,62,58,1725,135,189,639,PF,62,65,405,CHO,.571
482,Tyler Zeller,78,.497,157,0,.000,1,42,27,21,81,78,.494,158,22,.564,39,51,5,525,43,61,178,C,7,20,124,BOS,.494
483,Stephen Zimmerman,10,.323,31,0,,0,4,20,5,24,10,.323,31,3,.600,5,19,0,108,11,17,23,C,2,3,35,ORL,.323
484,Paul Zipser,55,.451,122,33,.333,99,36,22,16,110,88,.398,221,31,.775,40,44,18,843,15,78,240,SF,15,40,125,CHI,.473
485,Ivica Zubac,126,.536,235,0,.000,3,30,19,33,118,126,.529,238,32,.653,49,38,11,609,41,66,284,C,14,30,159,LAL,.529
