,Player_Name,2P,2P%,2PA,3P,3P%,3PA,AST,Age,BLK,DRB,FG,FG%,FGA,FT,FT%,FTA,Games,Games_Strated,Minutes_Played,ORB,PF,PTS,Position,STL,TOV,TRB,Team,eFG%
0,Tariq Abdul-Wahad,27,.474,57,0,.000,1,21,28,3,26,27,.466,58,3,.500,6,14,0,204,14,26,57,SG,6,7,40,DAL,.466
1,Shareef Abdur-Rahim,545,.485,1123,21,.350,60,242,26,38,502,566,.478,1183,455,.841,541,81,81,3087,175,240,1608,PF,87,212,677,ATL,.487
2,Courtney Alexander,174,.388,448,19,.333,57,79,25,6,79,193,.382,505,118,.808,146,66,7,1360,39,125,523,PG,31,68,118,NOH,.401
3,Malik Allen,335,.426,786,0,.000,4,54,24,78,291,335,.424,790,97,.802,121,80,73,2318,134,234,767,PF,37,128,425,MIA,.424
4,Ray Allen,397,.478,830,201,.377,533,334,27,14,287,598,.439,1363,316,.916,345,76,75,2880,94,220,1713,SG,103,198,381,TOT,.512
5,Rafer Alston,88,.429,205,51,.392,130,192,26,15,86,139,.415,335,37,.685,54,47,4,980,21,120,366,PG,38,86,107,TOR,.491
6,John Amaechi,37,.314,118,0,,0,21,32,7,51,37,.314,118,25,.481,52,50,1,474,26,50,99,C,14,34,77,UTA,.314
7,Chris Andersen,114,.401,284,0,.000,1,32,24,60,165,114,.400,285,77,.550,140,59,3,907,109,90,305,C,30,60,274,DEN,.400
8,Derek Anderson,239,.477,501,116,.350,331,325,28,16,211,355,.427,832,231,.859,269,76,76,2556,53,141,1057,PG,90,128,264,POR,.496
9,Kenny Anderson,162,.432,375,1,.143,7,198,32,5,101,163,.427,382,45,.789,57,61,2,1135,31,106,372,PG,58,75,132,TOT,.428
10,Shandon Anderson,196,.494,397,52,.371,140,87,29,20,190,248,.462,537,139,.732,190,82,9,1731,64,177,687,SF,73,114,254,NYK,.510
11,Robert Archibald,6,.300,20,0,,0,3,22,3,11,6,.300,20,7,.389,18,12,0,72,6,9,19,PF,0,7,17,MEM,.300
12,Gilbert Arenas,400,.461,867,109,.348,313,514,21,17,289,509,.431,1180,370,.791,468,82,82,2866,97,260,1497,PG,124,290,386,GSW,.478
13,Brandon Armstrong,8,.381,21,1,.167,6,2,22,1,4,9,.333,27,5,.833,6,17,0,69,0,8,24,SG,3,5,4,NJN,.352
14,Darrell Armstrong,185,.450,411,78,.336,232,323,34,13,204,263,.409,643,165,.878,188,82,23,2350,91,167,769,PG,135,160,295,ORL,.470
15,Carlos Arroyo,47,.461,102,3,.429,7,53,23,1,15,50,.459,109,18,.818,22,44,0,287,11,28,121,PG,12,30,26,UTA,.472
16,Chucky Atkins,82,.368,223,86,.355,242,175,28,4,75,168,.361,465,40,.816,49,65,7,1398,21,108,462,PG,27,77,96,DET,.454
17,Stacey Augmon,79,.427,185,0,.000,7,69,34,9,93,79,.411,192,54,.750,72,70,3,862,26,80,212,SG,27,40,119,NOH,.411
18,Dalibor Bagaric,8,.308,26,0,,0,4,22,3,13,8,.308,26,3,.750,4,10,0,76,7,11,19,C,3,5,20,CHI,.308
19,Vin Baker,99,.488,203,0,.000,4,29,31,30,108,99,.478,207,72,.673,107,52,9,942,90,146,270,C,22,61,198,BOS,.478
20,Brent Barry,146,.514,284,118,.403,293,384,31,15,253,264,.458,577,128,.795,161,75,68,2480,48,199,774,SG,113,142,301,SEA,.560
21,Jon Barry,104,.495,210,87,.407,214,206,33,14,147,191,.450,424,86,.860,100,80,0,1473,33,104,555,SG,63,81,180,DET,.553
22,Maceo Baston,15,.600,25,0,,0,0,27,11,19,15,.600,25,10,.833,12,16,0,106,4,16,40,PF,4,6,23,TOR,.600
23,Mengke Bateer,3,.214,14,1,.333,3,4,27,0,8,4,.235,17,0,.000,2,12,0,46,2,14,9,C,0,6,10,SAS,.265
24,Mike Batiste,179,.464,386,18,.222,81,52,25,16,175,197,.422,467,69,.784,88,75,2,1248,82,120,481,PF,42,69,257,MEM,.441
25,Tony Battie,198,.544,364,1,.200,5,49,26,81,285,199,.539,369,88,.746,118,67,62,1683,148,197,487,C,33,48,433,BOS,.541
26,Shane Battier,189,.535,353,86,.398,216,105,24,88,217,275,.483,569,120,.828,145,78,47,2383,128,207,756,SF,102,68,345,MEM,.559
27,Lonny Baxter,96,.471,204,0,.000,2,16,24,22,100,96,.466,206,70,.680,103,55,0,682,65,135,262,C,9,46,165,CHI,.466
28,Raja Bell,72,.450,160,21,.412,51,57,26,8,98,93,.441,211,23,.676,34,75,32,1173,47,134,230,SG,52,43,145,DAL,.491
29,Jonathan Bender,93,.463,201,19,.358,53,42,22,56,91,112,.441,254,60,.714,84,46,2,819,42,86,303,SF,8,42,133,IND,.478
30,Corey Benjamin,11,.367,30,2,.154,13,10,24,2,21,13,.302,43,12,.750,16,9,0,152,10,20,40,SG,1,6,31,ATL,.326
31,Travis Best,195,.411,474,36,.330,109,255,30,7,121,231,.396,583,105,.854,123,72,52,1807,26,174,603,PG,44,106,147,MIA,.427
32,Mike Bibby,273,.485,563,56,.409,137,285,24,8,113,329,.470,700,161,.861,187,55,55,1835,34,93,875,PG,72,127,147,SAC,.510
33,Chauncey Billups,217,.443,490,149,.392,380,287,26,15,235,366,.421,870,318,.878,362,74,74,2327,38,136,1199,PG,63,134,273,DET,.506
34,Corie Blount,65,.485,134,0,,0,50,34,19,137,65,.485,134,20,.571,35,50,3,836,68,121,150,C,33,43,205,CHI,.485
35,Mark Blount,150,.432,347,0,,0,56,27,68,197,150,.432,347,101,.727,139,81,31,1403,111,187,401,C,42,103,308,TOT,.432
36,Calvin Booth,52,.444,117,0,.000,2,12,26,33,77,52,.437,119,34,.723,47,47,0,575,32,74,138,C,11,22,109,SEA,.437
37,Carlos Boozer,331,.536,617,0,.000,1,106,21,50,407,331,.536,618,148,.771,192,81,54,2049,202,224,810,PF,59,103,609,CLE,.536
38,Ruben Boumtje-Boumtje,0,.000,1,0,,0,1,24,0,0,0,.000,1,0,,0,2,0,5,1,0,0,C,1,0,1,POR,.000
39,Bruce Bowen,122,.488,250,101,.441,229,113,31,42,180,223,.466,479,36,.404,89,82,82,2566,59,195,583,SF,66,72,239,SAS,.571
40,Ryan Bowen,95,.500,190,2,.286,7,54,27,29,79,97,.492,197,27,.659,41,62,31,996,78,82,223,SG,65,43,157,DEN,.497
41,Earl Boykins,170,.439,387,29,.377,77,221,26,4,53,199,.429,464,173,.865,200,68,0,1321,35,75,600,PG,38,73,88,GSW,.460
42,Michael Bradley,150,.487,308,1,.167,6,67,23,32,247,151,.481,314,35,.522,67,67,11,1314,162,125,338,PF,16,76,409,TOR,.482
43,Shawn Bradley,201,.537,374,0,.000,1,54,30,170,325,201,.536,375,141,.806,175,81,39,1731,151,242,543,C,65,67,476,DAL,.536
44,Elton Brand,451,.502,898,0,.000,1,157,23,158,420,451,.502,899,244,.685,356,62,61,2454,283,204,1146,PF,71,161,703,LAC,.502
45,J.R. Bremer,70,.393,178,101,.353,286,164,22,3,127,171,.369,464,85,.766,111,64,41,1503,18,80,528,PG,38,59,145,BOS,.477
46,Jamison Brewer,9,.600,15,0,.000,2,18,22,1,4,9,.529,17,4,.444,9,10,0,80,5,11,22,PG,2,6,9,IND,.529
47,Primoz Brezec,15,.405,37,0,.000,1,4,23,4,10,15,.395,38,12,.600,20,22,1,111,13,16,42,C,2,7,23,IND,.395
48,Damone Brown,11,.333,33,0,.000,2,3,23,0,12,11,.314,35,6,.750,8,5,3,115,3,14,28,PF,1,6,15,TOR,.314
49,Devin Brown,12,.353,34,0,.000,1,7,24,1,10,12,.343,35,6,.750,8,10,2,93,8,14,30,SG,4,9,18,TOT,.343
50,Kedrick Brown,58,.439,132,3,.077,39,20,21,13,95,61,.357,171,20,.625,32,51,5,666,45,68,145,SF,34,23,140,BOS,.365
51,Kwame Brown,224,.449,499,0,.000,3,58,20,80,298,224,.446,502,145,.668,217,80,20,1773,128,159,593,C,50,110,426,WAS,.446
52,P.J. Brown,319,.533,598,0,.000,3,147,33,80,458,319,.531,601,194,.836,232,78,78,2609,243,203,832,PF,67,98,701,NOH,.531
53,Randy Brown,16,.372,43,0,,0,35,34,2,23,16,.372,43,9,.750,12,32,0,262,3,36,41,PG,17,17,26,PHO,.372
54,Tierre Brown,27,.466,58,0,.000,1,39,23,0,22,27,.458,59,11,.786,14,15,0,168,8,9,65,PG,13,22,30,CLE,.458
55,Rick Brunson,19,.432,44,4,.667,6,36,30,3,15,23,.460,50,10,.833,12,17,0,196,4,20,60,PG,10,17,19,CHI,.500
56,Kobe Bryant,744,.465,1600,124,.383,324,481,24,67,458,868,.451,1924,601,.843,713,82,82,3401,106,218,2461,SG,181,288,564,LAL,.483
57,Mark Bryant,5,.263,19,0,,0,4,37,1,12,5,.263,19,3,.750,4,16,0,100,8,18,13,PF,1,7,20,TOT,.263
58,Greg Buckner,170,.496,343,15,.273,55,96,26,16,144,185,.465,398,65,.802,81,75,5,1514,72,203,450,SG,72,62,216,PHI,.484
59,Pat Burke,112,.388,289,1,.143,7,23,29,25,89,113,.382,296,40,.690,58,62,8,783,57,99,267,C,19,47,146,ORL,.383
60,Caron Butler,395,.427,925,34,.318,107,213,22,31,262,429,.416,1032,309,.824,375,78,78,2858,135,230,1201,SF,137,192,397,MIA,.432
61,Rasual Butler,157,.392,401,50,.292,171,93,23,43,157,207,.362,572,76,.731,104,72,28,1514,29,105,540,SG,21,77,186,MIA,.406
62,Jason Caffey,113,.456,248,0,,0,38,29,15,108,113,.456,248,69,.651,106,51,16,894,68,122,295,PF,19,56,176,MIL,.456
63,Marcus Camby,91,.410,222,2,.400,5,47,28,40,133,93,.410,227,33,.660,50,29,9,616,75,69,221,C,20,27,208,DEN,.414
64,Elden Campbell,117,.398,294,0,.000,1,51,34,39,134,117,.397,295,109,.801,136,56,1,869,47,129,343,C,33,50,181,TOT,.397
65,Brian Cardinal,1,.333,3,0,.000,1,1,25,0,2,1,.250,4,2,1.000,2,5,0,15,3,0,4,PF,0,1,5,WAS,.250
66,Anthony Carter,83,.369,225,0,.000,8,203,27,5,71,83,.356,233,33,.660,50,49,26,912,12,70,199,PG,45,81,83,MIA,.356
67,Vince Carter,310,.493,629,45,.344,131,143,26,41,129,355,.467,760,129,.806,160,43,42,1471,59,121,884,SG,48,74,188,TOR,.497
68,Sam Cassell,487,.487,999,59,.362,163,450,33,14,285,546,.470,1162,385,.861,447,78,77,2700,57,216,1536,PG,88,177,342,MIL,.495
69,Kelvin Cato,133,.528,252,0,.000,4,20,28,85,296,133,.520,256,66,.532,124,73,5,1247,132,176,332,C,38,56,428,HOU,.520
70,Tyson Chandler,257,.531,484,0,,0,76,20,106,345,257,.531,484,177,.608,291,75,68,1827,169,220,691,C,37,135,514,CHI,.531
71,Calbert Cheaney,315,.503,626,10,.400,25,163,31,13,211,325,.499,651,40,.580,69,81,74,2351,73,225,700,SG,65,108,284,UTA,.507
72,Chris Childs,5,.357,14,1,.167,6,16,35,1,2,6,.300,20,2,.667,3,12,0,106,3,17,15,PG,8,6,5,NJN,.325
73,Doug Christie,194,.522,372,73,.395,185,376,32,37,281,267,.479,557,141,.810,174,80,80,2710,61,186,748,SG,180,144,342,SAC,.545
74,Keon Clark,226,.506,447,0,.000,4,80,27,150,313,226,.501,451,84,.656,128,80,11,1780,138,227,536,C,38,94,451,SAC,.501
75,Speedy Claxton,67,.500,134,0,.000,11,75,24,7,34,67,.462,145,39,.684,57,30,0,471,22,43,173,PG,22,35,56,SAS,.462
76,Mateen Cleaves,5,.227,22,1,1.000,1,10,25,0,7,6,.261,23,3,.750,4,12,0,55,1,6,16,PG,2,14,8,SAC,.283
77,Derrick Coleman,201,.466,431,22,.328,67,87,35,69,299,223,.448,498,134,.784,171,64,35,1742,151,171,602,C,53,96,450,PHI,.470
78,Bimbo Coles,49,.360,136,7,.219,32,72,34,4,48,56,.333,168,35,.833,42,35,11,691,11,60,154,PG,17,28,59,TOT,.354
79,Jason Collier,17,.472,36,0,,0,1,25,1,17,17,.472,36,2,1.000,2,13,3,104,12,10,36,C,2,2,29,HOU,.472
80,Jarron Collins,38,.447,85,0,.000,1,14,24,6,28,38,.442,86,44,.710,62,22,7,421,32,70,120,C,5,19,60,UTA,.442
81,Jason Collins,140,.419,334,0,.000,4,87,24,44,232,140,.414,338,180,.763,236,81,66,1900,136,252,460,C,47,85,368,NJN,.414
82,Chris Crawford,7,.700,10,1,.333,3,1,27,3,4,8,.615,13,7,.875,8,5,0,38,3,7,24,PF,2,2,7,ATL,.654
83,Jamal Crawford,248,.438,566,86,.355,242,334,22,25,164,334,.413,808,104,.806,129,80,31,1992,21,126,858,PG,77,134,185,CHI,.467
84,Austin Croshere,59,.421,140,27,.391,69,56,27,13,115,86,.411,209,53,.815,65,49,0,633,40,48,252,PF,6,28,155,IND,.476
85,John Crotty,10,.357,28,4,.308,13,29,33,0,14,14,.341,41,9,.600,15,12,0,180,1,16,41,PG,3,9,15,DEN,.390
86,Eddy Curry,335,.585,573,0,,0,37,20,62,237,335,.585,573,179,.624,287,81,48,1571,116,226,849,C,18,137,353,CHI,.585
87,Michael Curry,76,.434,175,16,.296,54,104,34,4,111,92,.402,229,36,.800,45,78,77,1555,16,163,236,SF,44,43,127,DET,.437
88,Erick Dampier,259,.498,520,0,.000,2,58,27,154,295,259,.496,522,155,.698,222,82,82,1978,248,242,673,C,27,112,543,GSW,.496
89,Antonio Daniels,66,.520,127,18,.305,59,85,27,9,61,84,.452,186,65,.855,76,67,2,872,11,43,251,SG,33,32,72,POR,.500
90,Antonio Davis,261,.407,641,0,,0,131,34,62,307,261,.407,641,216,.771,280,53,52,1894,130,150,738,C,23,118,437,TOR,.407
91,Baron Davis,233,.452,515,99,.350,283,320,23,22,130,332,.416,798,93,.710,131,50,47,1889,56,148,856,PG,91,140,186,NOH,.478
92,Dale Davis,237,.541,438,0,,0,94,33,70,331,237,.541,438,105,.633,166,78,78,2282,233,189,579,C,51,71,564,POR,.541
93,Emanual Davis,25,.424,59,7,.241,29,36,34,2,38,32,.364,88,17,.773,22,24,1,340,5,28,88,SG,12,25,43,ATL,.403
94,Hubert Davis,19,.442,43,12,.333,36,29,32,0,30,31,.392,79,5,.833,6,43,1,328,6,23,79,SG,5,11,36,DET,.468
95,Ricky Davis,528,.417,1266,74,.363,204,436,23,36,293,602,.410,1470,348,.748,465,79,76,3131,97,180,1626,SG,125,277,390,CLE,.435
96,Andrew DeClercq,149,.534,279,0,,0,52,29,36,197,149,.534,279,67,.644,104,77,21,1327,142,258,365,C,39,84,339,ORL,.534
97,Tony Delk,113,.441,256,120,.395,304,146,29,10,191,233,.416,560,68,.782,87,67,39,1873,41,124,654,PG,72,69,232,BOS,.523
98,Dan Dickau,48,.440,109,22,.361,61,85,24,2,34,70,.412,170,21,.808,26,50,0,515,9,66,183,PG,14,53,43,ATL,.476
99,Michael Dickerson,6,.462,13,4,.364,11,8,27,1,5,10,.417,24,5,1.000,5,6,1,87,1,16,29,SG,5,6,6,MEM,.500
100,DeSagana Diop,54,.351,154,0,,0,43,21,81,152,54,.351,154,11,.367,30,80,1,943,63,148,119,PF,33,56,215,CLE,.351
101,Vlade Divac,299,.475,630,6,.240,25,274,34,105,417,305,.466,655,179,.713,251,80,80,2384,157,239,795,C,83,152,574,SAC,.470
102,Juan Dixon,79,.422,187,25,.298,84,40,24,3,59,104,.384,271,37,.804,46,42,3,647,13,54,270,PG,26,42,72,WAS,.430
103,Michael Doleac,146,.426,343,0,,0,42,25,16,154,146,.426,343,36,.783,46,75,0,1041,65,150,328,C,16,49,219,NYK,.426
104,Keyon Dooling,78,.411,190,50,.360,139,89,22,6,63,128,.389,329,44,.772,57,55,1,969,9,93,350,SG,24,60,72,LAC,.465
105,Bryce Drew,5,.250,20,3,.429,7,11,28,0,9,8,.296,27,0,,0,13,0,79,4,2,19,PG,2,3,13,NOH,.352
106,Predrag Drobnjak,295,.419,704,30,.353,85,86,27,38,209,325,.412,789,91,.791,115,82,69,1984,111,180,771,C,48,65,320,SEA,.431
107,Chris Dudley,0,.000,1,0,,0,0,37,0,0,0,.000,1,0,,0,3,0,11,2,3,0,C,0,0,2,POR,.000
108,Tim Duncan,708,.517,1370,6,.273,22,316,26,237,784,714,.513,1392,450,.710,634,81,81,3181,259,231,1884,PF,55,248,1043,SAS,.515
109,Mike Dunleavy,116,.434,267,52,.347,150,106,22,19,148,168,.403,417,78,.780,100,82,3,1305,66,120,466,SF,53,86,214,GSW,.465
110,Howard Eisley,131,.450,291,131,.389,337,444,30,9,162,262,.417,628,89,.848,105,82,76,2243,24,222,744,PG,71,149,186,NYK,.521
111,LaPhonso Ellis,73,.471,155,27,.252,107,15,32,15,113,100,.382,262,50,.758,66,55,3,784,44,88,277,PF,15,31,157,MIA,.433
112,Melvin Ely,92,.495,186,0,,0,15,24,32,110,92,.495,186,52,.703,74,52,7,802,64,95,236,C,10,50,174,LAC,.495
113,Evan Eschmeyer,7,.368,19,0,,0,6,27,7,19,7,.368,19,3,.750,4,17,3,135,10,35,17,C,10,6,29,DAL,.368
114,Reggie Evans,66,.471,140,0,,0,34,22,11,278,66,.471,140,80,.519,154,67,60,1365,167,173,212,PF,38,52,445,SEA,.471
115,Danny Ferry,23,.359,64,21,.350,60,21,36,9,55,44,.355,124,10,.769,13,64,1,601,20,55,119,SF,7,27,75,SAS,.440
116,Michael Finley,388,.445,871,119,.370,322,205,29,21,295,507,.425,1193,198,.861,230,69,69,2642,107,105,1331,SF,76,114,402,DAL,.475
117,Derek Fisher,254,.451,563,85,.401,212,298,28,15,199,339,.437,775,100,.800,125,82,82,2829,40,195,863,PG,93,94,239,LAL,.492
118,Marcus Fizer,177,.469,377,1,.167,6,48,24,17,136,178,.465,383,88,.657,134,38,0,809,80,89,445,PF,14,57,216,CHI,.466
119,Alton Ford,3,.333,9,0,,0,1,21,0,6,3,.333,9,1,.333,3,11,0,31,0,7,7,PF,0,2,6,PHO,.333
120,Joseph Forte,10,.313,32,0,.000,3,11,21,0,7,10,.286,35,4,.667,6,17,0,86,4,6,24,SG,4,10,11,SEA,.286
121,Danny Fortson,20,.377,53,0,.000,1,12,26,0,45,20,.370,54,19,.655,29,17,0,223,28,43,59,PF,9,15,73,GSW,.370
122,Greg Foster,46,.390,118,1,.250,4,13,34,9,72,47,.385,122,26,.813,32,29,9,539,30,82,121,C,1,30,102,TOR,.389
123,Jeff Foster,64,.364,176,0,.000,2,51,26,21,161,64,.360,178,34,.540,63,77,2,802,118,103,162,C,28,34,279,IND,.360
124,Tremaine Fowlkes,54,.454,119,2,.222,9,23,26,2,62,56,.438,128,50,.847,59,37,10,573,41,63,164,SF,25,20,103,LAC,.445
125,Rick Fox,157,.460,341,105,.375,280,253,33,14,259,262,.422,621,52,.754,69,76,75,2181,64,215,681,SF,69,121,323,LAL,.506
126,Adonal Foyle,185,.538,344,0,.000,1,37,27,205,314,185,.536,345,70,.673,104,82,0,1787,176,214,440,C,40,73,490,GSW,.536
127,Steve Francis,486,.453,1072,85,.354,240,502,25,41,340,571,.435,1312,476,.800,595,81,81,3318,159,251,1703,PG,141,299,499,HOU,.468
128,Lawrence Funderburke,32,.444,72,0,,0,8,32,11,38,32,.444,72,10,.588,17,27,0,229,17,25,74,PF,1,6,55,SAC,.444
129,Dan Gadzuric,70,.486,144,0,.000,1,9,24,52,131,70,.483,145,29,.518,56,49,30,760,66,125,169,C,22,27,197,MIL,.483
130,Kevin Garnett,723,.513,1410,20,.282,71,495,26,129,858,743,.502,1481,377,.751,502,82,82,3321,244,199,1883,PF,113,229,1102,MIN,.508
131,Pat Garrity,151,.448,337,161,.396,407,121,26,20,234,312,.419,744,83,.830,100,81,53,2584,72,255,868,PF,62,77,306,ORL,.528
132,Pau Gasol,568,.514,1106,1,.100,10,229,22,148,528,569,.510,1116,416,.736,565,82,82,2948,192,220,1555,PF,34,213,720,MEM,.510
133,Devean George,131,.398,329,49,.371,132,92,25,38,195,180,.390,461,83,.790,105,71,7,1613,91,180,492,SF,56,65,286,LAL,.444
134,Kendall Gill,267,.432,618,19,.322,59,156,34,15,197,286,.422,677,123,.764,161,82,34,2068,51,176,714,SG,78,108,248,MIN,.436
135,Manu Ginobili,123,.494,249,51,.345,148,138,25,17,114,174,.438,397,126,.737,171,69,5,1431,47,170,525,SG,96,100,161,SAS,.503
136,Gordan Giricek,265,.478,554,85,.341,249,137,25,8,202,350,.436,803,150,.820,183,76,62,2148,36,159,935,SG-SF,52,145,238,TOT,.489
137,Dion Glover,221,.451,490,56,.354,158,141,24,15,220,277,.427,648,127,.784,162,76,42,1890,62,146,737,SG,71,108,282,ATL,.471
138,Anthony Goldwire,6,.375,16,3,.333,9,4,31,0,6,9,.360,25,4,.571,7,15,0,85,0,6,25,PG,3,6,6,TOT,.420
139,Drew Gooden,341,.468,729,14,.292,48,83,21,35,292,355,.457,777,151,.712,212,70,47,1873,163,172,875,SF-PF,53,150,455,TOT,.466
140,Brian Grant,344,.509,676,0,,0,104,30,47,596,344,.509,676,158,.771,205,82,82,2641,241,300,846,C,63,129,837,MIA,.509
141,Horace Grant,13,.520,25,0,,0,7,37,0,6,13,.520,25,0,,0,5,1,85,2,5,26,PF,3,1,8,ORL,.520
142,Adrian Griffin,140,.447,313,6,.250,24,105,28,6,176,146,.433,337,27,.844,32,74,48,1373,88,157,325,SG,77,47,264,DAL,.442
143,Eddie Griffin,207,.426,486,64,.333,192,86,20,111,323,271,.400,678,58,.617,94,77,66,1890,138,136,664,PF,52,76,461,HOU,.447
144,Tom Gugliotta,60,.458,131,0,.000,1,31,33,5,75,60,.455,132,9,1.000,9,27,11,447,25,35,129,PF,14,31,100,PHO,.455
145,A.J. Guyton,0,.000,3,0,.000,1,2,24,0,0,0,.000,4,0,,0,2,0,9,0,0,0,PG,1,1,0,GSW,.000
146,Marcus Haislip,63,.447,141,3,.250,12,9,22,18,32,66,.431,153,26,.684,38,39,8,441,21,55,161,PF,7,21,53,MIL,.441
147,Darvin Ham,71,.455,156,0,.000,3,38,29,19,80,71,.447,159,38,.481,79,75,1,926,73,127,180,SG,16,65,153,ATL,.447
148,Richard Hamilton,538,.461,1167,32,.269,119,208,24,13,230,570,.443,1286,440,.833,528,82,82,2640,88,249,1612,SG,64,200,318,DET,.456
149,Zendon Hamilton,2,.400,5,0,,0,0,27,0,3,2,.400,5,2,1.000,2,3,0,12,1,2,6,C,1,1,4,TOR,.400
150,Anfernee Hardaway,230,.460,500,26,.356,73,235,31,26,192,256,.447,573,77,.794,97,58,51,1777,66,150,615,SG,66,145,258,PHO,.469
151,Tim Hardaway,7,.389,18,11,.355,31,24,36,0,14,18,.367,49,2,.500,4,10,0,127,1,8,49,PG,9,11,15,IND,.480
152,Matt Harpring,455,.529,860,66,.413,160,133,26,17,324,521,.511,1020,262,.792,331,78,69,2557,190,217,1370,SF,73,160,514,UTA,.543
153,Adam Harrington,6,.261,23,5,.357,14,12,22,1,7,11,.297,37,3,.750,4,19,0,111,1,8,30,SG,2,2,8,TOT,.365
154,Al Harrington,376,.442,850,13,.283,46,125,22,33,352,389,.434,896,211,.770,274,82,37,2467,159,280,1002,SF,71,163,511,IND,.441
155,Junior Harrington,162,.369,439,7,.250,28,277,22,15,206,169,.362,467,73,.652,112,82,51,2003,44,250,418,PG,80,157,250,DEN,.369
156,Othella Harrington,225,.508,443,0,,0,62,29,23,311,225,.508,443,123,.820,150,74,64,1850,165,231,573,PF,12,90,476,NYK,.508
157,Lucious Harris,251,.429,585,47,.346,136,155,32,8,169,298,.413,721,152,.804,189,77,25,1973,63,95,795,SG,53,71,232,NJN,.446
158,Antonio Harvey,2,.400,5,0,,0,0,32,4,5,2,.400,5,0,,0,4,0,32,1,7,4,PF,1,3,6,ATL,.400
159,Donnell Harvey,245,.450,544,1,.143,7,100,22,27,284,246,.446,551,118,.670,176,77,27,1613,125,203,611,SF,48,123,409,DEN,.447
160,Trenton Hassell,131,.372,352,13,.325,40,151,23,61,218,144,.367,392,41,.745,55,82,53,1999,37,197,342,SG,45,83,255,CHI,.384
161,Kirk Haston,2,.143,14,0,.000,3,3,23,5,7,2,.118,17,2,.500,4,12,0,57,0,10,6,SF,0,7,7,NOH,.118
162,Juaquin Hawkins,47,.379,124,10,.417,24,47,29,6,62,57,.385,148,10,.500,20,58,10,685,16,57,134,SG,29,29,78,HOU,.419
163,Brendan Haywood,173,.510,339,0,,0,29,23,119,212,173,.510,339,155,.633,245,81,69,1930,192,225,501,C,32,65,404,WAS,.510
164,Alan Henderson,153,.471,325,0,.000,2,41,30,32,242,153,.468,327,88,.638,138,82,3,1494,156,168,394,C,33,61,398,ATL,.468
165,Nene Hilario,321,.521,616,0,.000,3,149,20,65,283,321,.519,619,197,.578,341,80,53,2258,208,295,839,C,127,181,491,DEN,.519
166,Grant Hill,150,.495,303,1,.250,4,122,30,13,166,151,.492,307,118,.819,144,29,29,843,40,46,421,SF,28,84,206,ORL,.493
167,Tyrone Hill,129,.422,306,0,,0,41,34,26,265,129,.422,306,54,.675,80,56,43,1351,126,172,312,PF,46,68,391,TOT,.422
168,Fred Hoiberg,44,.419,105,5,.238,21,70,30,5,126,49,.389,126,41,.820,50,63,0,784,11,59,144,SG,40,25,137,CHI,.409
169,Robert Horry,133,.445,299,51,.288,177,233,32,61,333,184,.387,476,103,.769,134,80,26,2343,181,247,522,PF,96,112,514,LAL,.440
170,Eddie House,136,.420,324,36,.300,120,87,24,1,84,172,.387,444,31,.861,36,55,7,1025,17,73,411,SG,44,46,101,MIA,.428
171,Allan Houston,474,.467,1015,178,.396,450,220,31,7,205,652,.445,1465,363,.919,395,82,82,3108,26,191,1845,SG,54,178,231,NYK,.506
172,Juwan Howard,565,.449,1257,2,.500,4,234,29,27,404,567,.450,1261,282,.803,351,77,77,2730,181,239,1418,PF,77,189,585,DEN,.450
173,Troy Hudson,312,.452,690,97,.365,266,452,26,7,141,409,.428,956,208,.900,231,79,74,2600,42,160,1123,PG,60,182,183,MIN,.479
174,Nate Huffman,9,.360,25,0,,0,5,27,3,14,9,.360,25,5,.625,8,7,0,76,9,13,23,C,1,3,23,TOR,.360
175,Larry Hughes,317,.479,662,29,.367,79,205,24,24,241,346,.467,741,136,.731,186,67,56,2137,67,149,857,PG,86,136,308,WAS,.487
176,Ryan Humphrey,35,.292,120,0,,0,11,23,18,65,35,.292,120,23,.590,39,48,1,444,34,75,93,PF,9,23,99,TOT,.292
177,Lindsey Hunter,72,.369,195,34,.318,107,71,32,5,44,106,.351,302,34,.723,47,29,0,673,15,50,280,PG,35,57,59,TOR,.407
178,Steven Hunter,56,.544,103,0,,0,6,21,36,55,56,.544,103,18,.409,44,33,5,447,38,56,130,C,9,15,93,ORL,.544
179,Zydrunas Ilgauskas,495,.443,1117,0,.000,5,127,27,152,371,495,.441,1122,400,.781,512,81,81,2432,240,274,1390,C,56,210,611,CLE,.441
180,Allen Iverson*,720,.440,1637,84,.277,303,454,27,13,276,804,.414,1940,570,.774,736,82,82,3485,68,149,2262,SG,225,286,344,PHI,.436
181,Bobby Jackson,251,.505,497,89,.379,235,182,29,3,162,340,.464,732,126,.846,149,59,26,1676,57,126,895,PG,71,106,219,SAC,.525
182,Jermaine Jackson,39,.390,100,1,.100,10,74,26,6,38,40,.364,110,40,.727,55,53,1,559,19,51,121,SG,19,34,57,TOT,.368
183,Jim Jackson,172,.440,391,32,.451,71,118,32,4,178,204,.442,462,47,.855,55,63,0,1309,84,132,487,SF,31,80,262,SAC,.476
184,Marc Jackson,152,.437,348,1,1.000,1,37,28,30,139,153,.438,349,114,.765,149,77,0,1041,86,137,421,C,24,59,225,MIN,.440
185,Mark Jackson,120,.438,274,27,.284,95,375,37,3,142,147,.398,369,61,.763,80,82,0,1467,34,90,382,PG,48,152,176,UTA,.435
186,Stephen Jackson,261,.501,521,95,.320,297,183,24,30,220,356,.435,818,139,.760,183,80,58,2254,66,202,946,SG,125,176,286,SAS,.493
187,Casey Jacobsen,70,.432,162,52,.315,165,73,21,6,54,122,.373,327,72,.686,105,72,0,1147,29,90,368,SF,35,55,83,PHO,.453
188,Jerome James,111,.478,232,0,,0,27,27,82,138,111,.478,232,54,.587,92,51,16,766,78,166,276,C,12,75,216,SEA,.478
189,Mike James,151,.423,357,67,.294,228,246,27,5,123,218,.373,585,104,.732,142,78,8,1722,26,176,607,PG,64,108,149,MIA,.430
190,Antawn Jamison,626,.496,1262,65,.311,209,156,26,45,383,691,.470,1471,375,.789,475,82,82,3226,195,197,1822,SF,76,177,578,GSW,.492
191,Marko Jaric,126,.450,280,53,.319,166,193,24,11,125,179,.401,446,79,.752,105,66,12,1379,35,125,490,SF,97,103,160,LAC,.461
192,Chris Jefferies,57,.407,140,18,.333,54,22,22,16,43,75,.387,194,29,.674,43,51,10,666,16,56,197,SF,19,45,59,TOR,.433
193,Richard Jefferson,450,.507,887,6,.250,24,201,22,44,364,456,.501,911,324,.743,436,80,80,2879,150,216,1242,SF,80,156,514,NJN,.504
194,Jared Jeffries,27,.474,57,3,.500,6,16,21,5,32,30,.476,63,16,.552,29,20,1,292,26,28,79,SF,8,21,58,WAS,.500
195,Anthony Johnson,90,.459,196,13,.371,35,86,28,5,65,103,.446,231,51,.689,74,66,2,842,13,93,270,PG,37,41,78,NJN,.474
196,Avery Johnson,63,.426,148,0,.000,2,64,37,1,21,63,.420,150,30,.769,39,48,0,430,10,26,156,PG,15,29,31,DAL,.420
197,Ervin Johnson,61,.452,135,0,,0,24,35,63,177,61,.452,135,30,.682,44,69,17,1170,117,178,152,C,34,34,294,MIL,.452
198,Joe Johnson,241,.408,591,75,.366,205,210,21,19,207,316,.397,796,96,.774,124,82,34,2255,57,143,803,SG,62,108,264,PHO,.444
199,Ken Johnson,15,.405,37,0,,0,0,24,12,28,15,.405,37,2,.333,6,16,0,156,4,20,32,C,1,6,32,MIA,.405
200,Damon Jones,36,.404,89,44,.364,121,80,26,4,59,80,.381,210,20,.741,27,49,1,709,11,42,224,PG,18,23,70,SAC,.486
201,Eddie Jones,193,.432,447,98,.407,241,173,31,31,191,291,.423,688,189,.822,230,47,47,1789,35,137,869,SG,64,85,226,MIA,.494
202,Fred Jones,7,.412,17,2,.286,7,5,23,1,5,9,.375,24,3,.750,4,19,1,115,4,13,23,SG,6,6,9,IND,.417
203,Jumaine Jones,197,.497,396,111,.354,314,112,23,22,299,308,.434,710,57,.687,83,80,12,2204,106,176,784,SF,67,107,405,CLE,.512
204,Popeye Jones,24,.387,62,0,,0,8,32,1,30,24,.387,62,5,.455,11,26,0,222,29,31,53,PF,5,15,59,DAL,.387
205,Michael Jordan*,663,.450,1472,16,.291,55,311,39,39,426,679,.445,1527,266,.821,324,82,67,3031,71,171,1640,SF,123,173,497,WAS,.450
206,Shawn Kemp,211,.419,504,0,.000,1,55,33,33,304,211,.418,505,115,.742,155,79,55,1633,147,239,537,C,66,102,451,ORL,.418
207,Steve Kerr,61,.462,132,49,.395,124,70,37,3,48,110,.430,256,30,.882,34,75,0,952,12,49,299,PG,27,35,60,SAS,.525
208,Jason Kidd,389,.445,874,126,.341,370,711,29,25,394,515,.414,1244,339,.841,403,80,80,2989,110,127,1495,PG,179,296,504,NJN,.465
209,Andrei Kirilenko,278,.527,528,37,.325,114,138,21,175,273,315,.491,642,296,.800,370,80,11,2213,147,185,963,SF,118,136,420,UTA,.519
210,Kerry Kittles,254,.516,492,78,.356,219,170,28,30,200,332,.467,711,106,.785,135,65,57,1951,52,110,848,SG,101,55,252,NJN,.522
211,Brevin Knight,95,.432,220,2,.250,8,233,27,2,66,97,.425,228,20,.541,37,55,4,928,15,123,216,PG,69,94,81,MEM,.430
212,Travis Knight,25,.391,64,0,.000,1,14,28,9,44,25,.385,65,10,.769,13,32,0,287,18,44,60,C,8,10,62,NYK,.385
213,Toni Kukoc,154,.490,314,95,.361,263,230,34,29,199,249,.432,577,137,.706,194,63,0,1704,67,134,730,PF,81,122,266,MIL,.514
214,Christian Laettner,253,.506,500,2,.125,16,235,33,40,388,255,.494,516,120,.833,144,76,66,2215,114,206,632,PF,82,87,502,WAS,.496
215,Raef LaFrentz,219,.550,398,47,.405,116,54,26,91,205,266,.518,514,60,.682,88,69,43,1611,125,264,639,C,35,46,330,DAL,.563
216,Sean Lampley,56,.448,125,0,.000,4,31,23,3,57,56,.434,129,57,.695,82,35,0,487,26,43,169,SF,7,25,83,MIA,.434
217,Dan Langhi,72,.421,171,9,.290,31,21,25,6,68,81,.401,202,12,.600,20,60,0,541,19,58,183,SF,15,16,87,PHO,.423
218,Voshon Lenard,233,.418,557,92,.365,252,144,29,21,164,325,.402,809,156,.804,194,63,24,1929,48,156,898,SG,59,103,212,TOR,.459
219,Rashard Lewis,444,.476,932,75,.346,217,133,23,35,351,519,.452,1149,283,.820,345,77,77,3044,152,205,1396,SF,99,143,503,SEA,.484
220,Randy Livingston,2,.500,4,0,,0,1,27,0,0,2,.500,4,2,1.000,2,2,0,12,0,0,6,PG,0,0,0,NOH,.500
221,Art Long,26,.361,72,2,.667,3,6,30,11,39,28,.373,75,2,.200,10,26,0,211,21,35,60,SF,5,20,60,TOT,.387
222,Grant Long,27,.403,67,0,.000,3,25,36,1,59,27,.386,70,18,.783,23,41,1,488,24,62,72,PF,9,19,83,BOS,.386
223,Tyronn Lue,188,.474,397,60,.341,176,263,25,1,127,248,.433,573,91,.875,104,75,24,1986,22,151,647,PG,47,77,149,WAS,.485
224,George Lynch,119,.425,280,28,.354,79,104,32,19,214,147,.409,359,41,.554,74,81,32,1497,139,136,363,SG,66,52,353,NOH,.448
225,Todd MacCulloch,123,.517,238,0,,0,20,27,32,130,123,.517,238,53,.671,79,42,35,812,66,107,299,C,19,35,196,PHI,.517
226,Tito Maddox,3,.333,9,0,.000,3,5,21,1,6,3,.250,12,5,.625,8,9,0,35,1,4,11,SG,3,3,7,HOU,.250
227,Mark Madsen,69,.423,163,0,,0,38,27,19,73,69,.423,163,36,.590,61,54,22,781,86,116,174,PF,15,27,159,LAL,.423
228,Corey Maggette,281,.471,596,62,.350,177,123,23,16,245,343,.444,773,325,.802,405,64,57,2006,77,194,1073,SG,55,147,322,LAC,.484
229,Jamaal Magloire,305,.483,632,0,.000,3,88,24,111,464,305,.480,635,231,.717,322,82,82,2443,260,276,841,C,49,158,724,NOH,.480
230,Karl Malone*,592,.464,1275,3,.214,14,379,39,31,515,595,.462,1289,474,.763,621,81,81,2936,113,204,1667,PF,136,210,628,UTA,.463
231,Matt Maloney,3,.300,10,5,.333,15,17,31,0,6,8,.320,25,3,.600,5,14,0,103,1,9,24,PG,4,5,7,ATL,.420
232,Danny Manning,10,.417,24,3,.375,8,7,36,3,11,13,.406,32,5,.833,6,13,0,89,7,11,34,PF,9,7,18,DET,.453
233,Stephon Marbury,582,.472,1234,89,.301,296,654,25,20,210,671,.439,1530,375,.803,467,81,81,3240,53,200,1806,PG,108,263,263,PHO,.468
234,Shawn Marion,521,.473,1102,141,.387,364,198,24,95,574,662,.452,1466,251,.851,295,81,81,3373,199,208,1716,SF,185,157,773,PHO,.500
235,Sean Marks,22,.379,58,0,.000,1,3,27,6,27,22,.373,59,10,.667,15,23,0,223,8,37,54,PF,5,14,35,MIA,.373
236,Donny Marshall,0,.000,2,0,.000,1,0,30,0,3,0,.000,3,0,,0,3,0,6,0,0,0,SF,0,1,3,NJN,.000
237,Donyell Marshall,388,.467,831,33,.379,87,137,29,85,465,421,.459,918,167,.756,221,78,53,2378,234,234,1042,PF,95,135,699,CHI,.477
238,Kenyon Martin,500,.481,1039,9,.209,43,185,25,70,476,509,.470,1082,256,.653,392,77,77,2628,164,294,1283,PF,98,192,640,NJN,.475
239,Jamal Mashburn,551,.430,1280,119,.389,306,462,30,17,432,670,.422,1586,313,.848,369,82,81,3321,66,196,1772,SF,83,230,498,NOH,.460
240,Anthony Mason,191,.487,392,0,.000,1,209,36,12,326,191,.486,393,84,.718,117,65,58,2119,90,147,466,C,32,79,416,MIL,.486
241,Desmond Mason,436,.461,945,21,.292,72,163,25,32,369,457,.449,1017,212,.749,283,80,40,2763,154,210,1147,SF,67,115,523,TOT,.460
242,Roger Mason,5,.385,13,6,.333,18,12,22,0,10,11,.355,31,2,1.000,2,17,0,113,2,20,30,SF,4,5,12,CHI,.452
243,Tony Massenburg,104,.448,232,0,,0,17,35,19,97,104,.448,232,65,.774,84,58,1,792,59,144,273,C,17,50,156,UTA,.448
244,Walter McCarty,82,.482,170,91,.367,248,106,28,28,224,173,.414,418,61,.622,98,82,8,1949,64,188,498,SF,78,67,288,BOS,.523
245,Amal McCaskill,4,.235,17,0,,0,5,29,1,15,4,.235,17,3,.750,4,11,0,70,7,13,11,C,3,2,22,ATL,.235
246,Jelani McCoy,194,.491,395,0,,0,43,25,60,260,194,.491,395,69,.548,126,67,25,1367,95,162,457,C,28,96,355,TOR,.491
247,Tracy McGrady*,656,.481,1365,173,.386,448,411,23,59,367,829,.457,1813,576,.793,726,75,74,2954,121,156,2407,SG,124,195,488,ORL,.505
248,Jeff McInnis,182,.469,388,6,.171,35,170,28,2,75,188,.444,423,50,.746,67,75,1,1311,22,117,432,PG,21,75,97,POR,.452
249,Aaron McKie,249,.449,554,37,.330,112,278,30,9,289,286,.429,666,112,.836,134,80,40,2374,61,177,721,SF,131,109,350,PHI,.457
250,Stanislav Medvedenko,112,.438,256,0,.000,2,18,23,8,75,112,.434,258,31,.721,43,58,10,620,66,118,255,PF,11,37,141,LAL,.434
251,Ron Mercer,241,.415,581,3,.188,16,112,26,14,122,244,.409,597,65,.802,81,72,3,1671,32,123,556,SG,49,54,154,IND,.411
252,Chris Mihm,116,.408,284,0,.000,3,28,23,38,138,116,.404,287,76,.724,105,52,0,809,93,124,308,C,18,48,231,CLE,.404
253,Darius Miles,263,.419,628,0,.000,14,176,21,69,250,263,.410,642,92,.594,155,67,62,2008,113,159,618,SF,67,178,363,CLE,.410
254,Andre Miller,354,.432,820,23,.213,108,537,26,11,232,377,.406,928,311,.795,391,80,80,2913,84,203,1088,PG,99,206,316,LAC,.419
255,Brad Miller,324,.498,651,5,.313,16,193,26,43,418,329,.493,667,292,.818,357,73,72,2270,185,203,955,C,65,118,603,IND,.497
256,Mike Miller,264,.472,559,109,.363,300,170,22,21,295,373,.434,859,156,.839,186,65,52,2186,46,173,1011,SF,42,125,341,TOT,.498
257,Reggie Miller*,168,.527,319,113,.355,318,170,37,4,151,281,.441,637,207,.900,230,70,70,2117,21,89,882,SG,62,66,172,IND,.530
258,Chris Mills,32,.395,81,7,.280,25,22,33,3,31,39,.368,106,16,.889,18,21,0,262,19,29,101,PF,7,10,50,GSW,.401
259,Yao Ming*,400,.498,803,1,.500,2,137,22,147,479,401,.498,805,301,.811,371,82,72,2382,196,230,1104,C,31,173,675,HOU,.499
260,Cuttino Mobley,351,.469,749,112,.352,318,208,27,36,233,463,.434,1067,242,.858,282,73,73,3044,70,185,1280,SG,95,166,303,HOU,.486
261,Nazr Mohammed,67,.421,159,0,,0,6,25,21,82,67,.421,159,26,.634,41,35,0,445,47,79,160,C,16,25,129,ATL,.421
262,Jerome Moiso,89,.520,171,0,,0,22,24,44,119,89,.520,171,27,.659,41,51,1,644,59,87,205,C,19,46,178,NOH,.520
263,Mikki Moore,5,.385,13,0,,0,3,27,4,2,5,.385,13,8,.800,10,8,0,43,6,7,18,C,0,2,8,TOT,.385
264,Terence Morris,75,.521,144,7,.219,32,25,24,17,88,82,.466,176,11,.786,14,49,0,632,40,35,182,SF,8,29,128,HOU,.486
265,Troy Murphy,335,.456,735,3,.214,14,106,22,30,578,338,.451,749,244,.841,290,79,79,2510,228,246,923,PF,65,111,806,GSW,.453
266,Ronald Murray,11,.423,26,0,.000,5,5,23,0,4,11,.355,31,5,.625,8,14,0,62,0,0,27,SG,4,8,4,TOT,.355
267,Tracy Murray,15,.455,33,8,.211,38,12,31,3,18,23,.324,71,7,.778,9,31,0,193,5,22,61,SF,5,14,23,LAL,.380
268,Dikembe Mutombo*,49,.374,131,0,,0,19,36,37,99,49,.374,131,40,.727,55,24,16,514,54,54,138,C,4,34,153,NJN,.374
269,Mamadou N'Diaye,43,.448,96,0,,0,7,27,32,53,43,.448,96,34,.723,47,22,8,364,29,58,120,C,8,21,82,TOR,.448
270,Bostjan Nachbar,9,.429,21,2,.200,10,3,22,2,8,11,.355,31,5,.500,10,14,1,77,3,13,29,SF,2,6,11,HOU,.387
271,Lee Nailon,84,.444,189,0,.000,1,26,27,3,38,84,.442,190,42,.824,51,38,0,405,32,46,210,SF,6,32,70,NYK,.442
272,Eduardo Najera,129,.561,230,0,.000,1,47,26,22,133,129,.558,231,62,.681,91,48,12,1103,90,129,320,SF,40,23,223,DAL,.558
273,Steve Nash,407,.482,845,111,.413,269,598,28,6,171,518,.465,1114,308,.909,339,82,82,2711,63,134,1455,PG,85,192,234,DAL,.515
274,Rasho Nesterovic,400,.526,760,0,.000,2,114,26,116,358,400,.525,762,61,.642,95,77,77,2337,146,256,861,C,39,99,504,MIN,.525
275,Ira Newble,199,.520,383,32,.381,84,99,28,26,185,231,.495,467,70,.778,90,73,45,1931,86,174,564,SF,50,69,271,ATL,.529
276,Moochie Norris,123,.432,285,11,.244,45,196,29,4,122,134,.406,330,78,.684,114,82,3,1375,37,72,357,PG,55,86,159,HOU,.423
277,Dirk Nowitzki,542,.493,1099,148,.379,390,239,24,82,710,690,.463,1489,483,.881,548,80,80,3117,81,206,2011,PF,111,152,791,DAL,.513
278,Jermaine O'Neal,603,.487,1239,7,.333,21,155,24,178,594,610,.484,1260,373,.731,510,77,76,2864,202,277,1600,PF,66,180,796,IND,.487
279,Shaquille O'Neal*,695,.574,1211,0,,0,206,30,159,483,695,.574,1211,451,.622,725,67,66,2535,259,229,1841,C,38,196,742,LAL,.574
280,Charles Oakley,23,.418,55,0,,0,40,39,6,70,23,.418,55,28,.824,34,42,1,514,37,90,74,C,13,21,107,WAS,.418
281,Lamar Odom,226,.469,482,42,.326,129,178,23,41,267,268,.439,611,136,.777,175,49,47,1679,59,181,714,SF,42,140,326,LAC,.473
282,Mehmet Okur,142,.457,311,38,.339,112,71,23,39,218,180,.426,423,96,.733,131,72,9,1366,117,167,494,PF,25,66,335,DET,.470
283,Dean Oliver,6,.261,23,1,.167,6,23,24,0,8,7,.241,29,7,.875,8,15,0,93,8,9,22,PG,7,10,16,GSW,.259
284,Kevin Ollie,197,.453,435,2,.333,6,291,30,5,157,199,.451,441,134,.753,178,82,5,1897,25,122,534,PG,69,72,182,TOT,.454
285,Michael Olowokandi,186,.427,436,0,,0,47,27,79,271,186,.427,436,69,.657,105,36,36,1369,57,110,441,C,18,98,328,LAC,.427
286,Greg Ostertag,169,.518,326,0,,0,55,29,147,323,169,.518,326,100,.510,196,81,74,1926,180,235,438,C,20,104,503,UTA,.518
287,Bo Outlaw,153,.554,276,0,.000,2,112,31,71,234,153,.550,278,72,.621,116,80,20,1800,134,194,378,C,50,76,368,PHO,.550
288,Chris Owens,2,.667,3,0,,0,0,23,0,0,2,.667,3,0,,0,1,0,6,1,0,4,SF,0,1,1,MEM,.667
289,Olumide Oyedeji,10,.435,23,0,,0,5,21,3,40,10,.435,23,7,.636,11,27,3,145,10,30,27,C,5,5,50,ORL,.435
290,Robert Pack,52,.419,124,0,.000,5,81,33,0,40,52,.403,129,41,.745,55,28,4,440,11,35,145,PG,25,40,51,NOH,.403
291,Scott Padgett,125,.431,290,45,.338,133,86,26,24,189,170,.402,423,81,.757,107,82,2,1321,83,148,466,PF,41,70,272,UTA,.455
292,Milt Palacio,154,.439,351,8,.216,37,259,24,16,187,162,.418,388,65,.747,87,80,46,1976,48,168,397,PG,68,131,235,CLE,.428
293,Jannero Pargo,30,.435,69,7,.292,24,39,23,2,28,37,.398,93,4,1.000,4,34,0,342,9,45,85,PG,13,23,37,LAL,.435
294,Smush Parker,98,.445,220,38,.322,118,162,21,12,90,136,.402,338,98,.831,118,66,18,1103,29,106,408,PG,48,133,119,CLE,.459
295,Tony Parker,402,.503,800,82,.337,243,432,20,4,183,484,.464,1043,219,.755,290,82,82,2774,33,174,1269,PG,71,198,216,SAS,.503
296,Cherokee Parks,81,.503,161,1,.500,2,21,30,20,86,82,.503,163,23,.605,38,30,18,648,46,52,188,PF,16,18,132,LAC,.506
297,Ruben Patterson,251,.506,496,3,.150,20,101,27,29,144,254,.492,516,138,.627,220,78,17,1655,120,161,649,SF,73,117,264,POR,.495
298,Gary Payton*,611,.476,1284,54,.297,182,663,34,20,255,665,.454,1466,250,.710,352,80,80,3208,79,181,1634,PG,133,187,334,TOT,.472
299,Anthony Peeler,165,.416,397,87,.410,212,244,33,13,201,252,.414,609,39,.780,50,82,39,2245,40,161,630,SG,72,82,241,MIN,.485
300,Wesley Person,174,.470,370,100,.433,231,112,31,19,168,274,.456,601,79,.814,97,66,44,1941,24,64,727,SG,42,56,192,MEM,.539
301,Morris Peterson,305,.418,729,116,.337,344,188,25,32,266,421,.392,1073,195,.789,247,82,80,2949,97,232,1153,SF,88,128,363,TOR,.446
302,Eric Piatkowski,130,.531,245,80,.398,201,70,32,9,112,210,.471,446,101,.828,122,62,26,1360,44,92,601,SG,33,56,156,LAC,.561
303,Paul Pierce,545,.454,1201,118,.302,391,349,25,62,472,663,.416,1592,604,.802,753,79,79,3096,106,227,2048,SG,139,288,578,BOS,.454
304,Scottie Pippen*,227,.489,464,38,.286,133,285,37,25,221,265,.444,597,121,.818,148,64,58,1911,57,149,689,SF,105,164,278,POR,.476
305,Scot Pollard,40,.460,87,0,,0,6,27,15,60,40,.460,87,23,.605,38,23,0,325,46,50,103,C,13,15,106,SAC,.460
306,James Posey,239,.457,523,70,.306,229,184,26,15,336,309,.411,752,205,.833,246,83,71,2518,90,197,893,SF,106,144,426,TOT,.457
307,Lavor Postell,12,.387,31,2,.286,7,3,24,0,3,14,.368,38,13,.867,15,12,0,98,1,9,43,SG,2,7,4,NYK,.395
308,Vitaly Potapenko,41,.441,93,0,,0,4,27,8,64,41,.441,93,22,.759,29,26,2,403,25,46,104,C,9,25,89,SEA,.441
309,Tayshaun Prince,33,.465,71,20,.426,47,24,22,14,40,53,.449,118,11,.647,17,42,5,435,5,25,137,SF,10,21,45,DET,.534
310,Joel Przybilla,18,.391,46,0,,0,12,23,45,97,18,.391,46,12,.500,24,32,17,546,48,85,48,C,10,19,145,MIL,.391
311,Vladimir Radmanovic,170,.453,375,104,.355,293,97,22,22,247,274,.410,668,72,.706,102,72,16,1910,76,136,724,PF,64,100,323,SEA,.488
312,Igor Rakocevic,17,.370,46,5,.417,12,33,24,0,13,22,.379,58,29,.806,36,42,0,244,4,25,78,PG,4,23,17,MIN,.422
313,Zach Randolph,264,.518,510,0,.000,5,41,21,14,204,264,.513,515,122,.758,161,77,11,1301,139,141,650,PF,42,62,343,POR,.513
314,Theo Ratliff,276,.464,595,0,,0,73,29,262,453,276,.464,595,154,.720,214,81,81,2518,154,271,706,C,56,137,607,ATL,.464
315,Zeljko Rebraca,80,.552,145,0,,0,9,30,17,65,80,.552,145,38,.792,48,30,12,488,27,79,198,C,6,29,92,DET,.552
316,Michael Redd,273,.492,555,182,.438,416,117,23,13,273,455,.469,971,149,.805,185,82,14,2316,98,143,1241,SG,100,74,371,MIL,.562
317,Don Reid,0,.000,3,0,,0,0,29,0,0,0,.000,3,1,.500,2,1,0,10,0,4,1,PF,0,0,0,DET,.000
318,Efthimi Rentzias,16,.314,51,4,.500,8,7,27,2,16,20,.339,59,8,.889,9,35,0,144,10,21,52,C,6,4,26,PHI,.373
319,Glen Rice,95,.468,203,101,.398,254,65,35,5,126,196,.429,457,63,.759,83,62,26,1532,28,99,556,SF,23,55,154,HOU,.539
320,Jason Richardson,353,.427,827,123,.368,334,247,22,23,267,476,.410,1161,207,.764,271,82,82,2698,111,201,1282,SG,90,179,378,GSW,.463
321,Quentin Richardson,142,.408,348,61,.308,198,52,22,10,183,203,.372,546,85,.685,124,59,13,1368,98,92,552,SG,35,64,281,LAC,.428
322,Antoine Rigaudeau,7,.233,30,1,.200,5,6,31,0,4,8,.229,35,0,,0,11,0,91,4,11,17,SG,3,6,8,DAL,.243
323,Clifford Robinson,285,.422,676,87,.336,259,268,36,88,237,372,.398,935,161,.676,238,81,69,2825,81,259,992,PF,87,158,318,DET,.444
324,David Robinson*,197,.469,420,0,,0,61,37,111,345,197,.469,420,152,.710,214,64,64,1676,163,126,546,C,52,83,508,SAS,.469
325,Eddie Robinson,152,.505,301,3,.214,14,66,26,13,124,155,.492,315,51,.810,63,64,18,1355,76,120,364,SF,62,52,200,CHI,.497
326,Glenn Robinson,449,.456,985,90,.342,263,205,30,26,371,539,.432,1248,268,.876,306,69,68,2591,86,183,1436,SF,91,248,457,ATL,.468
327,Rodney Rogers,139,.430,323,44,.333,132,107,31,31,202,183,.402,455,68,.756,90,68,0,1303,61,192,478,PF,50,91,263,NJN,.451
328,Sean Rooks,125,.422,296,0,.000,1,69,33,44,163,125,.421,297,47,.810,58,70,38,1344,53,174,297,C,34,66,216,LAC,.421
329,Jalen Rose,509,.416,1224,133,.370,359,395,30,23,283,642,.406,1583,399,.854,467,82,82,3351,68,271,1816,SF,72,285,351,CHI,.448
330,Malik Rose,287,.459,625,2,.400,5,124,28,40,358,289,.459,630,242,.791,306,79,13,1933,148,206,822,PF,57,170,506,SAS,.460
331,Guy Rucker,0,,0,0,,0,1,25,0,1,0,,0,0,,0,3,0,4,0,1,0,PF,0,0,1,GSW,
332,Kareem Rush,77,.438,176,19,.279,68,68,22,11,68,96,.393,244,16,.696,23,76,0,872,26,71,227,PG,10,63,94,LAL,.432
333,Bryon Russell,62,.373,166,46,.329,140,72,32,7,165,108,.353,306,53,.768,69,70,23,1388,43,130,315,SF,70,55,208,WAS,.428
334,Arvydas Sabonis*,169,.476,355,3,.500,6,142,38,49,247,172,.476,361,129,.787,164,78,1,1209,88,141,476,C,61,75,335,POR,.481
335,John Salmons,38,.447,85,10,.323,31,47,23,6,43,48,.414,116,26,.743,35,64,1,504,16,53,132,PG,17,29,59,PHI,.457
336,Soumaila Samake,10,.417,24,0,,0,4,24,5,13,10,.417,24,2,1.000,2,13,1,77,10,13,22,C,0,2,23,LAL,.417
337,Jamal Sampson,0,.000,2,0,,0,1,19,0,1,0,.000,2,0,,0,5,0,8,1,0,0,PF,1,0,2,MIL,.000
338,Pepe Sanchez,0,.000,5,0,,0,8,25,0,2,0,.000,5,0,,0,9,0,37,4,3,0,PG,5,2,6,DET,.000
339,Jeryl Sasser,51,.313,163,13,.295,44,65,23,12,120,64,.309,207,53,.679,78,75,4,1025,64,91,194,SG,45,39,184,ORL,.341
340,Kenny Satterfield,50,.323,155,5,.179,28,68,21,2,27,55,.301,183,17,.680,25,39,6,502,16,36,132,PG,20,43,43,TOT,.314
341,Predrag Savovic,25,.373,67,4,.154,26,22,26,1,16,29,.312,93,21,.724,29,27,0,256,9,33,83,SG,14,21,25,DEN,.333
342,Brian Scalabrine,54,.415,130,14,.359,39,46,24,18,101,68,.402,169,30,.833,36,59,7,724,40,77,180,PF,16,46,141,NJN,.444
343,Ansu Sesay,41,.383,107,0,,0,23,26,5,39,41,.383,107,12,.571,21,45,4,448,34,62,94,SF,14,25,73,SEA,.383
344,Brian Shaw,63,.414,152,38,.349,109,103,36,13,99,101,.387,261,10,.667,15,72,0,900,20,62,250,PG,32,54,119,LAL,.460
345,Paul Shirley,0,.000,4,0,,0,0,25,0,1,0,.000,4,0,,0,2,0,5,0,0,0,PF,0,0,1,ATL,.000
346,Bobby Simmons,44,.411,107,0,.000,5,20,22,3,44,44,.393,112,32,.914,35,36,2,378,33,51,120,SG,10,8,77,WAS,.393
347,Brian Skinner,182,.550,331,0,,0,19,26,53,230,182,.550,331,97,.602,161,77,9,1381,136,176,461,PF,47,62,366,PHI,.550
348,Reggie Slater,27,.540,50,0,,0,4,32,1,13,27,.540,50,27,.600,45,26,0,141,18,31,81,PF,6,9,31,MIN,.540
349,Tamar Slay,32,.410,78,7,.280,25,14,22,3,23,39,.379,103,7,.700,10,36,0,274,8,31,92,SG,14,20,31,NJN,.413
350,Charles Smith,1,.333,3,0,.000,1,1,27,0,0,1,.250,4,3,.750,4,3,0,13,0,3,5,SG,1,1,0,POR,.250
351,Joe Smith,151,.463,326,0,.000,2,38,27,55,159,151,.460,328,102,.779,131,54,21,1117,111,171,404,SF,14,43,270,MIN,.460
352,Steve Smith,74,.428,173,39,.331,118,70,33,9,78,113,.388,291,95,.833,114,53,18,1032,21,79,360,SG,28,43,99,SAS,.455
353,Eric Snow,354,.462,767,7,.219,32,544,29,11,230,361,.452,799,325,.858,379,82,82,3108,71,235,1054,PG,133,194,301,PHI,.456
354,Latrell Sprewell,320,.417,767,134,.372,360,332,32,22,240,454,.403,1127,173,.794,218,74,73,2859,45,134,1215,SF,102,172,285,NYK,.462
355,Jerry Stackhouse,420,.439,956,71,.290,245,316,28,28,197,491,.409,1201,455,.878,518,70,70,2747,61,130,1508,SG,65,193,258,WAS,.438
356,Vladimir Stepania,185,.433,427,0,,0,24,26,40,343,185,.433,427,71,.530,134,79,6,1594,211,169,441,C,45,69,554,MIA,.433
357,DeShawn Stevenson,110,.404,272,4,.333,12,40,21,8,63,114,.401,284,47,.691,68,61,8,760,22,57,279,SG,22,49,85,UTA,.408
358,Michael Stewart,14,.378,37,0,,0,6,27,15,36,14,.378,37,8,.667,12,47,0,251,19,42,36,PF,2,10,55,CLE,.378
359,John Stockton*,280,.500,560,29,.363,80,629,40,16,150,309,.483,640,237,.826,287,82,82,2275,51,184,884,PG,137,182,201,UTA,.505
360,Peja Stojakovic,342,.545,628,155,.382,406,141,25,5,336,497,.481,1034,231,.875,264,72,72,2450,61,143,1380,SF,72,101,397,SAC,.556
361,Damon Stoudamire,112,.372,301,44,.386,114,204,29,6,115,156,.376,415,53,.791,67,59,27,1315,40,67,409,PG,39,82,155,POR,.429
362,Amar'e Stoudemire,390,.476,820,2,.200,10,78,20,87,471,392,.472,830,320,.661,484,82,71,2570,250,269,1106,PF,62,189,721,PHO,.473
363,Erick Strickland,101,.459,220,62,.388,160,209,29,7,122,163,.429,380,70,.805,87,71,10,1275,23,111,458,SG,38,98,145,IND,.511
364,Mark Strickland,2,.400,5,0,,0,0,32,0,2,2,.400,5,0,,0,4,0,13,5,1,4,SF,0,1,7,DAL,.400
365,Rod Strickland,119,.446,267,1,.091,11,215,36,6,75,120,.432,278,79,.738,107,47,8,956,20,55,320,PG,46,76,95,MIN,.433
366,Bruno Sundov,10,.250,40,4,.250,16,7,22,3,20,14,.250,56,0,.000,2,26,0,138,8,24,32,C,6,9,28,BOS,.286
367,Bob Sura,107,.440,243,28,.329,85,177,29,2,109,135,.412,328,103,.696,148,55,0,1130,58,108,401,SG,45,82,167,GSW,.454
368,Stromile Swift,235,.483,487,0,.000,2,45,23,104,270,235,.481,489,177,.722,245,67,26,1478,114,152,647,PF,55,99,384,MEM,.481
369,Wally Szczerbiak,290,.497,584,61,.421,145,136,25,22,188,351,.481,729,150,.867,173,52,42,1836,53,123,913,SF,44,87,241,MIN,.523
370,Maurice Taylor,231,.433,533,0,.000,2,66,26,22,143,231,.432,535,100,.725,138,67,9,1377,95,151,562,PF,22,100,238,HOU,.432
371,Jason Terry,328,.462,710,160,.371,431,600,25,14,242,488,.428,1141,259,.887,292,81,81,3081,37,175,1395,PG,126,249,279,ATL,.498
372,Etan Thomas,61,.492,124,0,,0,3,24,23,95,61,.492,124,60,.638,94,38,0,513,70,66,182,PF,8,33,165,WAS,.492
373,Kenny Thomas,260,.465,559,0,,0,112,25,28,344,260,.465,559,147,.746,197,66,42,1978,185,169,667,PF,62,116,529,TOT,.465
374,Kurt Thomas,495,.483,1025,2,.667,3,162,30,97,477,497,.483,1028,138,.750,184,81,81,2577,160,344,1134,C,81,138,637,NYK,.484
375,Tim Thomas,315,.474,665,97,.366,265,102,25,49,292,412,.443,930,145,.780,186,80,70,2358,97,257,1066,SF,70,133,389,MIL,.495
376,Jamaal Tinsley,174,.446,390,46,.277,166,548,24,18,202,220,.396,556,80,.714,112,73,69,2237,58,201,566,PG,125,192,260,IND,.437
377,Oscar Torres,9,.391,23,7,.538,13,3,26,2,9,16,.444,36,14,.700,20,17,0,109,3,9,53,SG,4,8,12,GSW,.542
378,Robert Traylor,104,.444,234,1,.333,3,50,25,37,154,105,.443,237,57,.648,88,69,0,851,108,153,268,C,45,53,262,NOH,.445
379,Gary Trent,208,.537,387,0,.000,2,77,28,23,185,208,.535,389,60,.594,101,80,22,1222,106,142,476,SF,32,59,291,MIN,.535
380,Jeff Trepagnier,13,.406,32,4,.500,8,6,23,0,8,17,.425,40,7,1.000,7,8,0,97,8,5,45,SG,8,8,16,DEN,.475
381,Cezary Trybanski,5,.250,20,0,,0,1,23,6,8,5,.250,20,4,.400,10,15,0,86,6,13,14,C,0,8,14,MEM,.250
382,Jake Tsakalidis,61,.452,135,0,,0,13,23,17,77,61,.452,135,39,.672,58,33,27,543,45,80,161,C,6,26,122,PHO,.452
383,Nikoloz Tskitishvili,78,.324,241,37,.243,152,91,19,29,117,115,.293,393,48,.738,65,81,16,1320,64,136,315,SF,31,84,181,DEN,.340
384,Hedo Turkoglu,136,.435,313,29,.372,78,87,23,12,153,165,.422,391,88,.800,110,67,11,1175,35,125,447,SF,25,50,188,SAC,.459
385,Nick Van Exel,224,.432,519,118,.378,312,312,31,4,173,342,.412,831,110,.764,144,73,1,2026,35,86,912,SG,42,123,208,DAL,.483
386,Keith Van Horn,394,.508,776,65,.369,176,93,27,30,365,459,.482,952,193,.804,240,74,73,2337,159,251,1176,PF,63,150,524,PHI,.516
387,Jacque Vaughn,176,.467,377,8,.235,34,232,27,2,92,184,.448,411,97,.776,125,80,48,1686,26,169,473,PG,64,97,118,ORL,.457
388,Jake Voskuhl,92,.564,163,0,,0,36,25,29,128,92,.564,163,64,.667,96,65,1,947,97,172,248,C,18,48,225,PHO,.564
389,Dajuan Wagner,168,.390,431,55,.316,174,130,19,7,62,223,.369,605,128,.800,160,47,24,1385,20,107,629,SG,38,85,82,CLE,.414
390,Antoine Walker,415,.427,972,188,.323,582,373,26,31,464,603,.388,1554,176,.615,286,78,78,3235,99,221,1570,PF,116,260,563,BOS,.449
391,Samaki Walker,115,.421,273,0,.000,1,64,26,55,253,115,.420,274,66,.653,101,67,39,1243,115,143,296,C,20,56,368,LAL,.420
392,Ben Wallace,209,.485,431,1,.167,6,120,28,230,833,210,.481,437,85,.450,189,73,73,2873,293,179,506,C,104,88,1126,DET,.482
393,Gerald Wallace,89,.497,179,1,.250,4,23,20,15,90,90,.492,183,39,.527,74,47,7,571,38,68,220,SF,24,44,128,SAC,.495
394,Rasheed Wallace,405,.515,787,110,.358,307,153,28,77,435,515,.471,1094,200,.735,272,74,74,2684,113,223,1340,PF,70,140,548,POR,.521
395,Charlie Ward,64,.435,147,101,.378,267,306,32,11,152,165,.399,414,41,.774,53,66,6,1465,25,146,472,PG,78,95,177,NYK,.521
396,Earl Watson,139,.463,300,31,.341,91,225,23,14,118,170,.435,391,62,.721,86,79,2,1366,46,138,433,PG,89,88,164,MEM,.474
397,Clarence Weatherspoon,186,.449,414,0,,0,68,32,36,385,186,.449,414,149,.768,194,79,19,2024,214,174,521,PF,69,63,599,NYK,.449
398,Chris Webber,656,.465,1412,5,.238,21,364,29,88,544,661,.461,1433,215,.607,354,67,67,2622,160,204,1542,PF,106,215,704,SAC,.463
399,Bonzi Wells,399,.464,860,38,.292,130,246,26,18,296,437,.441,990,226,.722,313,75,65,2396,98,220,1138,SG,123,215,394,POR,.461
400,Jiri Welsch,18,.254,71,1,.250,4,27,23,2,16,19,.253,75,22,.759,29,37,0,234,12,32,61,SF,8,19,28,GSW,.260
401,David Wesley,315,.437,721,134,.424,316,251,32,9,137,449,.433,1037,185,.781,237,73,73,2710,38,173,1217,SG,109,132,175,NOH,.498
402,Jahidi White,25,.472,53,0,,0,2,26,12,36,25,.472,53,17,.680,25,16,8,230,37,33,67,C,1,9,73,WAS,.472
403,Rodney White,228,.452,504,32,.239,134,121,22,32,170,260,.408,638,98,.784,125,72,19,1563,43,134,650,SG,45,156,213,DEN,.433
404,Chris Whitney,74,.400,185,50,.305,164,145,31,2,64,124,.355,349,57,.826,69,51,21,1052,3,92,355,PG,29,71,67,TOT,.427
405,Chris Wilcox,73,.521,140,0,,0,21,20,12,72,73,.521,140,25,.500,50,46,3,479,32,65,171,PF,7,26,104,LAC,.521
406,Mike Wilks,40,.354,113,10,.286,35,92,23,4,51,50,.338,148,37,.787,47,46,7,688,20,69,147,PG-SG,27,28,71,TOT,.372
407,Aaron Williams,199,.454,438,0,.000,1,88,31,57,194,199,.453,439,102,.785,130,81,0,1597,137,206,500,C,27,85,331,NJN,.453
408,Alvin Williams,348,.458,759,48,.329,146,416,28,21,190,396,.438,905,187,.782,239,78,78,2638,55,170,1027,PG,111,128,245,TOR,.464
409,Brandon Williams,1,.167,6,0,.000,1,0,27,0,0,1,.143,7,0,,0,6,0,19,2,4,2,SF,2,3,2,ATL,.143
410,Eric Williams,217,.467,465,37,.336,110,140,30,19,239,254,.442,575,201,.750,268,82,79,2350,143,234,746,SF,86,97,382,BOS,.474
411,Frank Williams,3,.176,17,6,.375,16,34,22,2,15,9,.273,33,4,.667,6,21,0,167,3,20,28,PG,7,17,18,NYK,.364
412,Jason Williams,190,.418,455,143,.354,404,631,27,10,187,333,.388,859,110,.840,131,76,76,2407,25,130,919,PG,91,168,212,MEM,.471
413,Jay Williams,208,.431,483,65,.322,202,350,21,17,168,273,.399,685,103,.640,161,75,54,1961,27,179,714,PG,86,171,195,CHI,.446
414,Jerome Williams,266,.503,529,1,.167,6,95,29,26,419,267,.499,535,156,.555,281,71,63,2346,231,197,691,PF,116,98,650,TOR,.500
415,Monty Williams,34,.436,78,0,.000,2,26,31,5,33,34,.425,80,24,.750,32,21,2,276,12,33,92,SF,12,17,45,PHI,.425
416,Scott Williams,120,.414,290,0,.000,2,22,34,21,121,120,.411,292,33,.786,42,69,33,872,72,159,273,C,27,32,193,PHO,.411
417,Shammond Williams,135,.425,318,93,.356,261,266,27,6,147,228,.394,579,78,.765,102,78,11,1881,24,140,627,PG,77,114,171,TOT,.474
418,Walt Williams,70,.412,170,64,.374,171,59,32,26,154,134,.393,341,31,.620,50,66,1,1161,53,141,363,SF,42,35,207,DAL,.487
419,Corliss Williamson,372,.456,815,2,.182,11,104,29,27,211,374,.453,826,237,.790,300,82,1,2061,147,238,987,SF,44,126,358,DET,.454
420,Kevin Willis,123,.482,255,0,.000,2,24,40,20,143,123,.479,257,51,.614,83,71,6,840,83,120,297,C,20,60,226,SAS,.479
421,Ruben Wolkowyski,2,.667,3,0,.000,1,1,29,0,1,2,.500,4,1,.250,4,7,0,24,0,3,5,PF,0,1,1,BOS,.500
422,Loren Woods,28,.384,73,1,.333,3,19,24,13,68,29,.382,76,21,.778,27,38,11,353,27,37,80,C,10,23,95,MIN,.388
423,Qyntel Woods,56,.514,109,3,.333,9,12,21,1,38,59,.500,118,7,.350,20,53,0,334,15,36,128,PF,15,23,53,POR,.513
424,Metta World Peace,291,.458,635,71,.336,211,198,23,50,261,362,.428,846,273,.736,371,69,67,2317,101,242,1068,SF,159,145,362,IND,.470
425,Lorenzen Wright,325,.457,711,0,.000,5,80,27,54,358,325,.454,716,147,.659,223,70,49,1982,170,209,797,C,51,110,528,MEM,.454
426,Vincent Yarbrough,147,.420,350,21,.269,78,130,21,33,126,168,.393,428,49,.790,62,59,39,1381,36,145,406,SG,57,81,162,DEN,.417
427,Wang Zhizhi,46,.400,115,16,.340,47,10,25,10,51,62,.383,162,42,.724,58,41,1,412,26,41,182,C,8,31,77,LAC,.432
